A & N ISLANDS,SOUTH ANDAMAN,INSTITUTIONAL,Below 0.5,1,FERRARGUNJ,6,1,0,0,0,0,0,0,0,0
A & N ISLANDS,SOUTH ANDAMAN,INSTITUTIONAL,Below 0.5,2,PORT BLAIR,9,2,2,0,2,0,0,0,0,0
A & N ISLANDS,SOUTH ANDAMAN,INSTITUTIONAL,Below 0.5,3,LITTLE ANDAMAN,0,0,0,0,0,0,0,0,0,0
A & N ISLANDS,SOUTH ANDAMAN,SCHEDULED CASTE,Below 0.5,1,FERRARGUNJ,0,0,0,0,0,0,0,0,0,0
A & N ISLANDS,SOUTH ANDAMAN,SCHEDULED CASTE,Below 0.5,2,PORT BLAIR,0,0,0,0,0,0,0,0,0,0
A & N ISLANDS,SOUTH ANDAMAN,SCHEDULED CASTE,Below 0.5,3,LITTLE ANDAMAN,0,0,0,0,0,0,0,0,0,0
A & N ISLANDS,SOUTH ANDAMAN,OTHERS,Below 0.5,1,FERRARGUNJ,646,142,97,23,120,2,8,2,12,10
A & N ISLANDS,SOUTH ANDAMAN,OTHERS,Below 0.5,2,PORT BLAIR,579,140,74,23,97,11,23,0,34,9
A & N ISLANDS,SOUTH ANDAMAN,OTHERS,Below 0.5,3,LITTLE ANDAMAN,78,15,13,0,13,2,0,0,2,0
A & N ISLANDS,SOUTH ANDAMAN,SCHEDULED TRIBES,Below 0.5,1,FERRARGUNJ,0,0,0,0,0,0,0,0,0,0
A & N ISLANDS,SOUTH ANDAMAN,SCHEDULED TRIBES,Below 0.5,2,PORT BLAIR,0,0,0,0,0,0,0,0,0,0
A & N ISLANDS,SOUTH ANDAMAN,SCHEDULED TRIBES,Below 0.5,3,LITTLE ANDAMAN,0,0,0,0,0,0,0,0,0,0
A & N ISLANDS,SOUTH ANDAMAN,ALL SOCIAL GROUPS,Below 0.5,1,FERRARGUNJ,652,142,97,23,120,2,8,2,12,10
A & N ISLANDS,SOUTH ANDAMAN,ALL SOCIAL GROUPS,Below 0.5,2,PORT BLAIR,588,142,76,23,99,11,23,0,34,9
A & N ISLANDS,SOUTH ANDAMAN,ALL SOCIAL GROUPS,Below 0.5,3,LITTLE ANDAMAN,78,15,13,0,13,2,0,0,2,0
A & N ISLANDS,NORTH & MIDDLE ANDAMANS,INSTITUTIONAL,Below 0.5,1,DIGLIPUR,25,3,2,1,3,0,0,0,0,0
A & N ISLANDS,NORTH & MIDDLE ANDAMANS,INSTITUTIONAL,Below 0.5,2,MAYABUNDER,9,1,1,0,1,0,0,0,0,0
A & N ISLANDS,NORTH & MIDDLE ANDAMANS,INSTITUTIONAL,Below 0.5,3,RANGAT,10,3,2,0,2,0,0,0,0,0
A & N ISLANDS,NORTH & MIDDLE ANDAMANS,SCHEDULED CASTE,Below 0.5,1,DIGLIPUR,0,0,0,0,0,0,0,0,0,0
A & N ISLANDS,NORTH & MIDDLE ANDAMANS,SCHEDULED CASTE,Below 0.5,2,MAYABUNDER,0,0,0,0,0,0,0,0,0,0
A & N ISLANDS,NORTH & MIDDLE ANDAMANS,SCHEDULED CASTE,Below 0.5,3,RANGAT,0,0,0,0,0,0,0,0,0,0
A & N ISLANDS,NORTH & MIDDLE ANDAMANS,OTHERS,Below 0.5,1,DIGLIPUR,627,133,88,10,98,7,6,12,25,12
A & N ISLANDS,NORTH & MIDDLE ANDAMANS,OTHERS,Below 0.5,2,MAYABUNDER,348,75,68,5,73,0,1,1,2,1
A & N ISLANDS,NORTH & MIDDLE ANDAMANS,OTHERS,Below 0.5,3,RANGAT,400,99,71,3,74,8,4,5,17,8
A & N ISLANDS,NORTH & MIDDLE ANDAMANS,SCHEDULED TRIBES,Below 0.5,1,DIGLIPUR,0,0,0,0,0,0,0,0,0,0
A & N ISLANDS,NORTH & MIDDLE ANDAMANS,SCHEDULED TRIBES,Below 0.5,2,MAYABUNDER,0,0,0,0,0,0,0,0,0,0
A & N ISLANDS,NORTH & MIDDLE ANDAMANS,SCHEDULED TRIBES,Below 0.5,3,RANGAT,0,0,0,0,0,0,0,0,0,0
A & N ISLANDS,NORTH & MIDDLE ANDAMANS,ALL SOCIAL GROUPS,Below 0.5,1,DIGLIPUR,652,136,91,10,101,7,6,12,25,12
A & N ISLANDS,NORTH & MIDDLE ANDAMANS,ALL SOCIAL GROUPS,Below 0.5,2,MAYABUNDER,357,76,69,5,74,0,1,1,2,1
A & N ISLANDS,NORTH & MIDDLE ANDAMANS,ALL SOCIAL GROUPS,Below 0.5,3,RANGAT,410,101,74,3,77,8,4,5,17,8
A & N ISLANDS,NICOBAR,INSTITUTIONAL,Below 0.5,1,CAMPBELL BAY,30,3,1,0,1,0,0,0,0,1
A & N ISLANDS,NICOBAR,SCHEDULED CASTE,Below 0.5,1,CAMPBELL BAY,0,0,0,0,0,0,0,0,0,0
A & N ISLANDS,NICOBAR,OTHERS,Below 0.5,1,CAMPBELL BAY,73,12,9,0,9,1,0,1,2,1
A & N ISLANDS,NICOBAR,SCHEDULED TRIBES,Below 0.5,1,CAMPBELL BAY,0,0,0,0,0,0,0,0,0,0
A & N ISLANDS,NICOBAR,ALL SOCIAL GROUPS,Below 0.5,1,CAMPBELL BAY,103,15,10,0,10,1,0,1,2,2
A & N ISLANDS,SOUTH ANDAMAN,INSTITUTIONAL,ALL CLASSES,1,FERRARGUNJ,59,945,714,11,725,18,172,23,213,8
A & N ISLANDS,SOUTH ANDAMAN,INSTITUTIONAL,ALL CLASSES,2,PORT BLAIR,30,103,48,6,54,6,37,0,43,6
A & N ISLANDS,SOUTH ANDAMAN,INSTITUTIONAL,ALL CLASSES,3,LITTLE ANDAMAN,1,10,8,1,9,0,0,0,0,0
A & N ISLANDS,SOUTH ANDAMAN,SCHEDULED CASTE,ALL CLASSES,1,FERRARGUNJ,0,0,0,0,0,0,0,0,0,0
A & N ISLANDS,SOUTH ANDAMAN,SCHEDULED CASTE,ALL CLASSES,2,PORT BLAIR,0,0,0,0,0,0,0,0,0,0
A & N ISLANDS,SOUTH ANDAMAN,SCHEDULED CASTE,ALL CLASSES,3,LITTLE ANDAMAN,0,0,0,0,0,0,0,0,0,0
A & N ISLANDS,SOUTH ANDAMAN,OTHERS,ALL CLASSES,1,FERRARGUNJ,2483,3316,2246,271,2517,116,401,126,643,156
A & N ISLANDS,SOUTH ANDAMAN,OTHERS,ALL CLASSES,2,PORT BLAIR,2087,2582,1557,396,1953,176,380,10,566,63
A & N ISLANDS,SOUTH ANDAMAN,OTHERS,ALL CLASSES,3,LITTLE ANDAMAN,554,970,915,20,935,33,1,0,34,1
A & N ISLANDS,SOUTH ANDAMAN,SCHEDULED TRIBES,ALL CLASSES,1,FERRARGUNJ,0,0,0,0,0,0,0,0,0,0
A & N ISLANDS,SOUTH ANDAMAN,SCHEDULED TRIBES,ALL CLASSES,2,PORT BLAIR,0,0,0,0,0,0,0,0,0,0
A & N ISLANDS,SOUTH ANDAMAN,SCHEDULED TRIBES,ALL CLASSES,3,LITTLE ANDAMAN,0,0,0,0,0,0,0,0,0,0
A & N ISLANDS,SOUTH ANDAMAN,ALL SOCIAL GROUPS,ALL CLASSES,1,FERRARGUNJ,2542,4261,2960,281,3241,134,574,149,857,164
A & N ISLANDS,SOUTH ANDAMAN,ALL SOCIAL GROUPS,ALL CLASSES,2,PORT BLAIR,2117,2685,1605,402,2007,182,418,10,610,68
A & N ISLANDS,SOUTH ANDAMAN,ALL SOCIAL GROUPS,ALL CLASSES,3,LITTLE ANDAMAN,555,980,923,21,944,33,2,0,35,1
A & N ISLANDS,SOUTH ANDAMAN,INSTITUTIONAL,20.0 & ABOVE,1,FERRARGUNJ,9,753,602,0,602,10,137,0,147,4
A & N ISLANDS,SOUTH ANDAMAN,INSTITUTIONAL,20.0 & ABOVE,2,PORT BLAIR,1,40,12,0,12,0,27,0,27,1
A & N ISLANDS,SOUTH ANDAMAN,INSTITUTIONAL,20.0 & ABOVE,3,LITTLE ANDAMAN,0,0,0,0,0,0,0,0,0,0
A & N ISLANDS,SOUTH ANDAMAN,SCHEDULED CASTE,20.0 & ABOVE,1,FERRARGUNJ,0,0,0,0,0,0,0,0,0,0
A & N ISLANDS,SOUTH ANDAMAN,SCHEDULED CASTE,20.0 & ABOVE,2,PORT BLAIR,0,0,0,0,0,0,0,0,0,0
A & N ISLANDS,SOUTH ANDAMAN,SCHEDULED CASTE,20.0 & ABOVE,3,LITTLE ANDAMAN,0,0,0,0,0,0,0,0,0,0
A & N ISLANDS,SOUTH ANDAMAN,OTHERS,20.0 & ABOVE,1,FERRARGUNJ,1,21,19,0,19,1,0,0,1,0
A & N ISLANDS,SOUTH ANDAMAN,OTHERS,20.0 & ABOVE,2,PORT BLAIR,0,0,0,0,0,0,0,0,0,0
A & N ISLANDS,SOUTH ANDAMAN,OTHERS,20.0 & ABOVE,3,LITTLE ANDAMAN,0,0,0,0,0,0,0,0,0,0
A & N ISLANDS,SOUTH ANDAMAN,SCHEDULED TRIBES,20.0 & ABOVE,1,FERRARGUNJ,0,0,0,0,0,0,0,0,0,0
A & N ISLANDS,SOUTH ANDAMAN,SCHEDULED TRIBES,20.0 & ABOVE,2,PORT BLAIR,0,0,0,0,0,0,0,0,0,0
A & N ISLANDS,SOUTH ANDAMAN,SCHEDULED TRIBES,20.0 & ABOVE,3,LITTLE ANDAMAN,0,0,0,0,0,0,0,0,0,0
A & N ISLANDS,SOUTH ANDAMAN,ALL SOCIAL GROUPS,20.0 & ABOVE,1,FERRARGUNJ,10,774,621,0,621,11,137,0,148,5
A & N ISLANDS,SOUTH ANDAMAN,ALL SOCIAL GROUPS,20.0 & ABOVE,2,PORT BLAIR,1,40,12,0,12,0,27,0,27,1
A & N ISLANDS,SOUTH ANDAMAN,ALL SOCIAL GROUPS,20.0 & ABOVE,3,LITTLE ANDAMAN,0,0,0,0,0,0,0,0,0,0
A & N ISLANDS,SOUTH ANDAMAN,INSTITUTIONAL,1.0-2.0,1,FERRARGUNJ,14,19,12,2,14,1,4,0,5,1
A & N ISLANDS,SOUTH ANDAMAN,INSTITUTIONAL,1.0-2.0,2,PORT BLAIR,3,5,1,0,1,1,2,0,3,1
A & N ISLANDS,SOUTH ANDAMAN,INSTITUTIONAL,1.0-2.0,3,LITTLE ANDAMAN,0,0,0,0,0,0,0,0,0,0
A & N ISLANDS,SOUTH ANDAMAN,SCHEDULED CASTE,1.0-2.0,1,FERRARGUNJ,0,0,0,0,0,0,0,0,0,0
A & N ISLANDS,SOUTH ANDAMAN,SCHEDULED CASTE,1.0-2.0,2,PORT BLAIR,0,0,0,0,0,0,0,0,0,0
A & N ISLANDS,SOUTH ANDAMAN,SCHEDULED CASTE,1.0-2.0,3,LITTLE ANDAMAN,0,0,0,0,0,0,0,0,0,0
A & N ISLANDS,SOUTH ANDAMAN,OTHERS,1.0-2.0,1,FERRARGUNJ,812,1152,795,107,902,26,136,38,200,51
A & N ISLANDS,SOUTH ANDAMAN,OTHERS,1.0-2.0,2,PORT BLAIR,441,669,414,106,520,49,82,3,134,14
A & N ISLANDS,SOUTH ANDAMAN,OTHERS,1.0-2.0,3,LITTLE ANDAMAN,47,71,67,2,69,2,0,0,2,0
A & N ISLANDS,SOUTH ANDAMAN,SCHEDULED TRIBES,1.0-2.0,1,FERRARGUNJ,0,0,0,0,0,0,0,0,0,0
A & N ISLANDS,SOUTH ANDAMAN,SCHEDULED TRIBES,1.0-2.0,2,PORT BLAIR,0,0,0,0,0,0,0,0,0,0
A & N ISLANDS,SOUTH ANDAMAN,SCHEDULED TRIBES,1.0-2.0,3,LITTLE ANDAMAN,0,0,0,0,0,0,0,0,0,0
A & N ISLANDS,SOUTH ANDAMAN,ALL SOCIAL GROUPS,1.0-2.0,1,FERRARGUNJ,826,1172,807,109,916,26,141,38,205,52
A & N ISLANDS,SOUTH ANDAMAN,ALL SOCIAL GROUPS,1.0-2.0,2,PORT BLAIR,444,674,415,107,522,50,84,3,137,15
A & N ISLANDS,SOUTH ANDAMAN,ALL SOCIAL GROUPS,1.0-2.0,3,LITTLE ANDAMAN,47,71,67,2,69,2,0,0,2,0
A & N ISLANDS,SOUTH ANDAMAN,INSTITUTIONAL,0.5-1.0,1,FERRARGUNJ,6,5,1,4,5,0,0,0,0,0
A & N ISLANDS,SOUTH ANDAMAN,INSTITUTIONAL,0.5-1.0,2,PORT BLAIR,7,6,2,0,2,1,3,0,4,0
A & N ISLANDS,SOUTH ANDAMAN,INSTITUTIONAL,0.5-1.0,3,LITTLE ANDAMAN,0,0,0,0,0,0,0,0,0,0
A & N ISLANDS,SOUTH ANDAMAN,SCHEDULED CASTE,0.5-1.0,1,FERRARGUNJ,0,0,0,0,0,0,0,0,0,0
A & N ISLANDS,SOUTH ANDAMAN,SCHEDULED CASTE,0.5-1.0,2,PORT BLAIR,0,0,0,0,0,0,0,0,0,0
A & N ISLANDS,SOUTH ANDAMAN,SCHEDULED CASTE,0.5-1.0,3,LITTLE ANDAMAN,0,0,0,0,0,0,0,0,0,0
A & N ISLANDS,SOUTH ANDAMAN,OTHERS,0.5-1.0,1,FERRARGUNJ,374,279,201,34,235,5,20,8,33,12
A & N ISLANDS,SOUTH ANDAMAN,OTHERS,0.5-1.0,2,PORT BLAIR,673,560,295,93,388,37,119,0,156,15
A & N ISLANDS,SOUTH ANDAMAN,OTHERS,0.5-1.0,3,LITTLE ANDAMAN,35,28,27,0,27,1,0,0,1,0
A & N ISLANDS,SOUTH ANDAMAN,SCHEDULED TRIBES,0.5-1.0,1,FERRARGUNJ,0,0,0,0,0,0,0,0,0,0
A & N ISLANDS,SOUTH ANDAMAN,SCHEDULED TRIBES,0.5-1.0,2,PORT BLAIR,0,0,0,0,0,0,0,0,0,0
A & N ISLANDS,SOUTH ANDAMAN,SCHEDULED TRIBES,0.5-1.0,3,LITTLE ANDAMAN,0,0,0,0,0,0,0,0,0,0
A & N ISLANDS,SOUTH ANDAMAN,ALL SOCIAL GROUPS,0.5-1.0,1,FERRARGUNJ,380,284,202,38,240,5,20,8,33,12
A & N ISLANDS,SOUTH ANDAMAN,ALL SOCIAL GROUPS,0.5-1.0,2,PORT BLAIR,680,566,297,93,390,39,122,0,161,15
A & N ISLANDS,SOUTH ANDAMAN,ALL SOCIAL GROUPS,0.5-1.0,3,LITTLE ANDAMAN,35,28,27,0,27,1,0,0,1,0
A & N ISLANDS,SOUTH ANDAMAN,INSTITUTIONAL,3.0-4.0,1,FERRARGUNJ,2,8,1,0,1,0,2,4,6,0
A & N ISLANDS,SOUTH ANDAMAN,INSTITUTIONAL,3.0-4.0,2,PORT BLAIR,0,0,0,0,0,0,0,0,0,0
A & N ISLANDS,SOUTH ANDAMAN,INSTITUTIONAL,3.0-4.0,3,LITTLE ANDAMAN,0,0,0,0,0,0,0,0,0,0
A & N ISLANDS,SOUTH ANDAMAN,SCHEDULED CASTE,3.0-4.0,1,FERRARGUNJ,0,0,0,0,0,0,0,0,0,0
A & N ISLANDS,SOUTH ANDAMAN,SCHEDULED CASTE,3.0-4.0,2,PORT BLAIR,0,0,0,0,0,0,0,0,0,0
A & N ISLANDS,SOUTH ANDAMAN,SCHEDULED CASTE,3.0-4.0,3,LITTLE ANDAMAN,0,0,0,0,0,0,0,0,0,0
A & N ISLANDS,SOUTH ANDAMAN,OTHERS,3.0-4.0,1,FERRARGUNJ,105,364,228,17,245,20,68,13,101,18
A & N ISLANDS,SOUTH ANDAMAN,OTHERS,3.0-4.0,2,PORT BLAIR,84,288,183,47,230,26,23,1,50,9
A & N ISLANDS,SOUTH ANDAMAN,OTHERS,3.0-4.0,3,LITTLE ANDAMAN,1,3,3,0,3,0,0,0,0,0
A & N ISLANDS,SOUTH ANDAMAN,SCHEDULED TRIBES,3.0-4.0,1,FERRARGUNJ,0,0,0,0,0,0,0,0,0,0
A & N ISLANDS,SOUTH ANDAMAN,SCHEDULED TRIBES,3.0-4.0,2,PORT BLAIR,0,0,0,0,0,0,0,0,0,0
A & N ISLANDS,SOUTH ANDAMAN,SCHEDULED TRIBES,3.0-4.0,3,LITTLE ANDAMAN,0,0,0,0,0,0,0,0,0,0
A & N ISLANDS,SOUTH ANDAMAN,ALL SOCIAL GROUPS,3.0-4.0,1,FERRARGUNJ,107,372,230,17,247,20,70,17,107,18
A & N ISLANDS,SOUTH ANDAMAN,ALL SOCIAL GROUPS,3.0-4.0,2,PORT BLAIR,84,288,183,47,230,26,23,1,50,9
A & N ISLANDS,SOUTH ANDAMAN,ALL SOCIAL GROUPS,3.0-4.0,3,LITTLE ANDAMAN,1,3,3,0,3,0,0,0,0,0
A & N ISLANDS,SOUTH ANDAMAN,INSTITUTIONAL,2.0-3.0,1,FERRARGUNJ,12,28,14,5,19,0,5,2,7,1
A & N ISLANDS,SOUTH ANDAMAN,INSTITUTIONAL,2.0-3.0,2,PORT BLAIR,4,10,5,0,5,3,2,0,5,0
A & N ISLANDS,SOUTH ANDAMAN,INSTITUTIONAL,2.0-3.0,3,LITTLE ANDAMAN,0,0,0,0,0,0,0,0,0,0
A & N ISLANDS,SOUTH ANDAMAN,SCHEDULED CASTE,2.0-3.0,1,FERRARGUNJ,0,0,0,0,0,0,0,0,0,0
A & N ISLANDS,SOUTH ANDAMAN,SCHEDULED CASTE,2.0-3.0,2,PORT BLAIR,0,0,0,0,0,0,0,0,0,0
A & N ISLANDS,SOUTH ANDAMAN,SCHEDULED CASTE,2.0-3.0,3,LITTLE ANDAMAN,0,0,0,0,0,0,0,0,0,0
A & N ISLANDS,SOUTH ANDAMAN,OTHERS,2.0-3.0,1,FERRARGUNJ,488,1073,729,73,802,38,135,50,223,49
A & N ISLANDS,SOUTH ANDAMAN,OTHERS,2.0-3.0,2,PORT BLAIR,225,503,314,84,398,39,58,2,99,6
A & N ISLANDS,SOUTH ANDAMAN,OTHERS,2.0-3.0,3,LITTLE ANDAMAN,391,842,794,17,811,28,1,0,29,1
A & N ISLANDS,SOUTH ANDAMAN,SCHEDULED TRIBES,2.0-3.0,1,FERRARGUNJ,0,0,0,0,0,0,0,0,0,0
A & N ISLANDS,SOUTH ANDAMAN,SCHEDULED TRIBES,2.0-3.0,2,PORT BLAIR,0,0,0,0,0,0,0,0,0,0
A & N ISLANDS,SOUTH ANDAMAN,SCHEDULED TRIBES,2.0-3.0,3,LITTLE ANDAMAN,0,0,0,0,0,0,0,0,0,0
A & N ISLANDS,SOUTH ANDAMAN,ALL SOCIAL GROUPS,2.0-3.0,1,FERRARGUNJ,500,1101,742,78,820,38,140,52,230,50
A & N ISLANDS,SOUTH ANDAMAN,ALL SOCIAL GROUPS,2.0-3.0,2,PORT BLAIR,229,513,319,84,403,42,60,2,104,6
A & N ISLANDS,SOUTH ANDAMAN,ALL SOCIAL GROUPS,2.0-3.0,3,LITTLE ANDAMAN,391,842,794,17,811,28,1,0,29,1
A & N ISLANDS,SOUTH ANDAMAN,INSTITUTIONAL,5.0-7.5,1,FERRARGUNJ,0,0,0,0,0,0,0,0,0,0
A & N ISLANDS,SOUTH ANDAMAN,INSTITUTIONAL,5.0-7.5,2,PORT BLAIR,1,5,4,1,5,0,0,0,0,0
A & N ISLANDS,SOUTH ANDAMAN,INSTITUTIONAL,5.0-7.5,3,LITTLE ANDAMAN,0,0,0,0,0,0,0,0,0,0
A & N ISLANDS,SOUTH ANDAMAN,SCHEDULED CASTE,5.0-7.5,1,FERRARGUNJ,0,0,0,0,0,0,0,0,0,0
A & N ISLANDS,SOUTH ANDAMAN,SCHEDULED CASTE,5.0-7.5,2,PORT BLAIR,0,0,0,0,0,0,0,0,0,0
A & N ISLANDS,SOUTH ANDAMAN,SCHEDULED CASTE,5.0-7.5,3,LITTLE ANDAMAN,0,0,0,0,0,0,0,0,0,0
A & N ISLANDS,SOUTH ANDAMAN,OTHERS,5.0-7.5,1,FERRARGUNJ,11,67,46,2,48,8,4,6,18,2
A & N ISLANDS,SOUTH ANDAMAN,OTHERS,5.0-7.5,2,PORT BLAIR,8,49,25,0,25,0,25,0,25,0
A & N ISLANDS,SOUTH ANDAMAN,OTHERS,5.0-7.5,3,LITTLE ANDAMAN,0,0,0,0,0,0,0,0,0,0
A & N ISLANDS,SOUTH ANDAMAN,SCHEDULED TRIBES,5.0-7.5,1,FERRARGUNJ,0,0,0,0,0,0,0,0,0,0
A & N ISLANDS,SOUTH ANDAMAN,SCHEDULED TRIBES,5.0-7.5,2,PORT BLAIR,0,0,0,0,0,0,0,0,0,0
A & N ISLANDS,SOUTH ANDAMAN,SCHEDULED TRIBES,5.0-7.5,3,LITTLE ANDAMAN,0,0,0,0,0,0,0,0,0,0
A & N ISLANDS,SOUTH ANDAMAN,ALL SOCIAL GROUPS,5.0-7.5,1,FERRARGUNJ,11,67,46,2,48,8,4,6,18,2
A & N ISLANDS,SOUTH ANDAMAN,ALL SOCIAL GROUPS,5.0-7.5,2,PORT BLAIR,9,54,28,1,29,0,25,0,25,0
A & N ISLANDS,SOUTH ANDAMAN,ALL SOCIAL GROUPS,5.0-7.5,3,LITTLE ANDAMAN,0,0,0,0,0,0,0,0,0,0
A & N ISLANDS,SOUTH ANDAMAN,INSTITUTIONAL,4.0-5.0,1,FERRARGUNJ,2,8,7,0,7,0,0,0,0,1
A & N ISLANDS,SOUTH ANDAMAN,INSTITUTIONAL,4.0-5.0,2,PORT BLAIR,4,18,14,3,17,0,1,0,1,0
A & N ISLANDS,SOUTH ANDAMAN,INSTITUTIONAL,4.0-5.0,3,LITTLE ANDAMAN,0,0,0,0,0,0,0,0,0,0
A & N ISLANDS,SOUTH ANDAMAN,SCHEDULED CASTE,4.0-5.0,1,FERRARGUNJ,0,0,0,0,0,0,0,0,0,0
A & N ISLANDS,SOUTH ANDAMAN,SCHEDULED CASTE,4.0-5.0,2,PORT BLAIR,0,0,0,0,0,0,0,0,0,0
A & N ISLANDS,SOUTH ANDAMAN,SCHEDULED CASTE,4.0-5.0,3,LITTLE ANDAMAN,0,0,0,0,0,0,0,0,0,0
A & N ISLANDS,SOUTH ANDAMAN,OTHERS,4.0-5.0,1,FERRARGUNJ,41,176,112,13,125,10,19,8,37,14
A & N ISLANDS,SOUTH ANDAMAN,OTHERS,4.0-5.0,2,PORT BLAIR,68,296,198,43,241,13,31,2,46,9
A & N ISLANDS,SOUTH ANDAMAN,OTHERS,4.0-5.0,3,LITTLE ANDAMAN,1,4,4,0,4,0,0,0,0,0
A & N ISLANDS,SOUTH ANDAMAN,SCHEDULED TRIBES,4.0-5.0,1,FERRARGUNJ,0,0,0,0,0,0,0,0,0,0
A & N ISLANDS,SOUTH ANDAMAN,SCHEDULED TRIBES,4.0-5.0,2,PORT BLAIR,0,0,0,0,0,0,0,0,0,0
A & N ISLANDS,SOUTH ANDAMAN,SCHEDULED TRIBES,4.0-5.0,3,LITTLE ANDAMAN,0,0,0,0,0,0,0,0,0,0
A & N ISLANDS,SOUTH ANDAMAN,ALL SOCIAL GROUPS,4.0-5.0,1,FERRARGUNJ,43,184,119,13,132,10,19,8,37,14
A & N ISLANDS,SOUTH ANDAMAN,ALL SOCIAL GROUPS,4.0-5.0,2,PORT BLAIR,72,314,212,46,258,14,32,2,48,9
A & N ISLANDS,SOUTH ANDAMAN,ALL SOCIAL GROUPS,4.0-5.0,3,LITTLE ANDAMAN,1,4,4,0,4,0,0,0,0,0
A & N ISLANDS,SOUTH ANDAMAN,INSTITUTIONAL,10.0-20.0,1,FERRARGUNJ,8,124,77,0,77,6,24,17,47,0
A & N ISLANDS,SOUTH ANDAMAN,INSTITUTIONAL,10.0-20.0,2,PORT BLAIR,1,16,8,1,9,0,3,0,3,3
A & N ISLANDS,SOUTH ANDAMAN,INSTITUTIONAL,10.0-20.0,3,LITTLE ANDAMAN,1,10,8,1,9,0,0,0,0,0
A & N ISLANDS,SOUTH ANDAMAN,SCHEDULED CASTE,10.0-20.0,1,FERRARGUNJ,0,0,0,0,0,0,0,0,0,0
A & N ISLANDS,SOUTH ANDAMAN,SCHEDULED CASTE,10.0-20.0,2,PORT BLAIR,0,0,0,0,0,0,0,0,0,0
A & N ISLANDS,SOUTH ANDAMAN,SCHEDULED CASTE,10.0-20.0,3,LITTLE ANDAMAN,0,0,0,0,0,0,0,0,0,0
A & N ISLANDS,SOUTH ANDAMAN,OTHERS,10.0-20.0,1,FERRARGUNJ,0,0,0,0,0,0,0,0,0,0
A & N ISLANDS,SOUTH ANDAMAN,OTHERS,10.0-20.0,2,PORT BLAIR,1,11,10,0,10,0,0,0,0,0
A & N ISLANDS,SOUTH ANDAMAN,OTHERS,10.0-20.0,3,LITTLE ANDAMAN,0,0,0,0,0,0,0,0,0,0
A & N ISLANDS,SOUTH ANDAMAN,SCHEDULED TRIBES,10.0-20.0,1,FERRARGUNJ,0,0,0,0,0,0,0,0,0,0
A & N ISLANDS,SOUTH ANDAMAN,SCHEDULED TRIBES,10.0-20.0,2,PORT BLAIR,0,0,0,0,0,0,0,0,0,0
A & N ISLANDS,SOUTH ANDAMAN,SCHEDULED TRIBES,10.0-20.0,3,LITTLE ANDAMAN,0,0,0,0,0,0,0,0,0,0
A & N ISLANDS,SOUTH ANDAMAN,ALL SOCIAL GROUPS,10.0-20.0,1,FERRARGUNJ,8,124,77,0,77,6,24,17,47,0
A & N ISLANDS,SOUTH ANDAMAN,ALL SOCIAL GROUPS,10.0-20.0,2,PORT BLAIR,2,26,19,1,20,0,3,0,3,3
A & N ISLANDS,SOUTH ANDAMAN,ALL SOCIAL GROUPS,10.0-20.0,3,LITTLE ANDAMAN,1,10,8,1,9,0,0,0,0,0
A & N ISLANDS,SOUTH ANDAMAN,INSTITUTIONAL,7.5-10.0,1,FERRARGUNJ,0,0,0,0,0,0,0,0,0,0
A & N ISLANDS,SOUTH ANDAMAN,INSTITUTIONAL,7.5-10.0,2,PORT BLAIR,0,0,0,0,0,0,0,0,0,0
A & N ISLANDS,SOUTH ANDAMAN,INSTITUTIONAL,7.5-10.0,3,LITTLE ANDAMAN,0,0,0,0,0,0,0,0,0,0
A & N ISLANDS,SOUTH ANDAMAN,SCHEDULED CASTE,7.5-10.0,1,FERRARGUNJ,0,0,0,0,0,0,0,0,0,0
A & N ISLANDS,SOUTH ANDAMAN,SCHEDULED CASTE,7.5-10.0,2,PORT BLAIR,0,0,0,0,0,0,0,0,0,0
A & N ISLANDS,SOUTH ANDAMAN,SCHEDULED CASTE,7.5-10.0,3,LITTLE ANDAMAN,0,0,0,0,0,0,0,0,0,0
A & N ISLANDS,SOUTH ANDAMAN,OTHERS,7.5-10.0,1,FERRARGUNJ,5,41,19,2,21,7,11,2,20,1
A & N ISLANDS,SOUTH ANDAMAN,OTHERS,7.5-10.0,2,PORT BLAIR,8,66,44,0,44,0,20,1,21,2
A & N ISLANDS,SOUTH ANDAMAN,OTHERS,7.5-10.0,3,LITTLE ANDAMAN,1,8,8,0,8,0,0,0,0,0
A & N ISLANDS,SOUTH ANDAMAN,SCHEDULED TRIBES,7.5-10.0,1,FERRARGUNJ,0,0,0,0,0,0,0,0,0,0
A & N ISLANDS,SOUTH ANDAMAN,SCHEDULED TRIBES,7.5-10.0,2,PORT BLAIR,0,0,0,0,0,0,0,0,0,0
A & N ISLANDS,SOUTH ANDAMAN,SCHEDULED TRIBES,7.5-10.0,3,LITTLE ANDAMAN,0,0,0,0,0,0,0,0,0,0
A & N ISLANDS,SOUTH ANDAMAN,ALL SOCIAL GROUPS,7.5-10.0,1,FERRARGUNJ,5,41,19,2,21,7,11,2,20,1
A & N ISLANDS,SOUTH ANDAMAN,ALL SOCIAL GROUPS,7.5-10.0,2,PORT BLAIR,8,66,44,0,44,0,20,1,21,2
A & N ISLANDS,SOUTH ANDAMAN,ALL SOCIAL GROUPS,7.5-10.0,3,LITTLE ANDAMAN,1,8,8,0,8,0,0,0,0,0
A & N ISLANDS,NORTH & MIDDLE ANDAMANS,INSTITUTIONAL,ALL CLASSES,1,DIGLIPUR,53,139,75,51,126,0,1,2,3,9
A & N ISLANDS,NORTH & MIDDLE ANDAMANS,INSTITUTIONAL,ALL CLASSES,2,MAYABUNDER,22,104,78,14,92,0,1,8,9,4
A & N ISLANDS,NORTH & MIDDLE ANDAMANS,INSTITUTIONAL,ALL CLASSES,3,RANGAT,33,131,58,1,59,13,3,33,49,23
A & N ISLANDS,NORTH & MIDDLE ANDAMANS,SCHEDULED CASTE,ALL CLASSES,1,DIGLIPUR,0,0,0,0,0,0,0,0,0,0
A & N ISLANDS,NORTH & MIDDLE ANDAMANS,SCHEDULED CASTE,ALL CLASSES,2,MAYABUNDER,0,0,0,0,0,0,0,0,0,0
A & N ISLANDS,NORTH & MIDDLE ANDAMANS,SCHEDULED CASTE,ALL CLASSES,3,RANGAT,0,0,0,0,0,0,0,0,0,0
A & N ISLANDS,NORTH & MIDDLE ANDAMANS,OTHERS,ALL CLASSES,1,DIGLIPUR,2701,5601,3368,334,3702,270,509,196,975,925
A & N ISLANDS,NORTH & MIDDLE ANDAMANS,OTHERS,ALL CLASSES,2,MAYABUNDER,1538,2516,2146,196,2342,12,54,19,85,88
A & N ISLANDS,NORTH & MIDDLE ANDAMANS,OTHERS,ALL CLASSES,3,RANGAT,1772,3969,2854,117,2971,336,177,251,764,235
A & N ISLANDS,NORTH & MIDDLE ANDAMANS,SCHEDULED TRIBES,ALL CLASSES,1,DIGLIPUR,0,0,0,0,0,0,0,0,0,0
A & N ISLANDS,NORTH & MIDDLE ANDAMANS,SCHEDULED TRIBES,ALL CLASSES,2,MAYABUNDER,0,0,0,0,0,0,0,0,0,0
A & N ISLANDS,NORTH & MIDDLE ANDAMANS,SCHEDULED TRIBES,ALL CLASSES,3,RANGAT,0,0,0,0,0,0,0,0,0,0
A & N ISLANDS,NORTH & MIDDLE ANDAMANS,ALL SOCIAL GROUPS,ALL CLASSES,1,DIGLIPUR,2754,5740,3444,385,3829,270,510,199,979,934
A & N ISLANDS,NORTH & MIDDLE ANDAMANS,ALL SOCIAL GROUPS,ALL CLASSES,2,MAYABUNDER,1560,2621,2224,210,2434,13,55,27,95,92
A & N ISLANDS,NORTH & MIDDLE ANDAMANS,ALL SOCIAL GROUPS,ALL CLASSES,3,RANGAT,1805,4100,2912,118,3030,349,179,284,812,258
A & N ISLANDS,NORTH & MIDDLE ANDAMANS,INSTITUTIONAL,20.0 & ABOVE,1,DIGLIPUR,1,37,0,37,37,0,0,0,0,0
A & N ISLANDS,NORTH & MIDDLE ANDAMANS,INSTITUTIONAL,20.0 & ABOVE,2,MAYABUNDER,1,57,50,7,57,0,0,0,0,0
A & N ISLANDS,NORTH & MIDDLE ANDAMANS,INSTITUTIONAL,20.0 & ABOVE,3,RANGAT,2,54,5,1,6,8,1,28,37,12
A & N ISLANDS,NORTH & MIDDLE ANDAMANS,SCHEDULED CASTE,20.0 & ABOVE,1,DIGLIPUR,0,0,0,0,0,0,0,0,0,0
A & N ISLANDS,NORTH & MIDDLE ANDAMANS,SCHEDULED CASTE,20.0 & ABOVE,2,MAYABUNDER,0,0,0,0,0,0,0,0,0,0
A & N ISLANDS,NORTH & MIDDLE ANDAMANS,SCHEDULED CASTE,20.0 & ABOVE,3,RANGAT,0,0,0,0,0,0,0,0,0,0
A & N ISLANDS,NORTH & MIDDLE ANDAMANS,OTHERS,20.0 & ABOVE,1,DIGLIPUR,0,0,0,0,0,0,0,0,0,0
A & N ISLANDS,NORTH & MIDDLE ANDAMANS,OTHERS,20.0 & ABOVE,2,MAYABUNDER,0,0,0,0,0,0,0,0,0,0
A & N ISLANDS,NORTH & MIDDLE ANDAMANS,OTHERS,20.0 & ABOVE,3,RANGAT,0,0,0,0,0,0,0,0,0,0
A & N ISLANDS,NORTH & MIDDLE ANDAMANS,SCHEDULED TRIBES,20.0 & ABOVE,1,DIGLIPUR,0,0,0,0,0,0,0,0,0,0
A & N ISLANDS,NORTH & MIDDLE ANDAMANS,SCHEDULED TRIBES,20.0 & ABOVE,2,MAYABUNDER,0,0,0,0,0,0,0,0,0,0
A & N ISLANDS,NORTH & MIDDLE ANDAMANS,SCHEDULED TRIBES,20.0 & ABOVE,3,RANGAT,0,0,0,0,0,0,0,0,0,0
A & N ISLANDS,NORTH & MIDDLE ANDAMANS,ALL SOCIAL GROUPS,20.0 & ABOVE,1,DIGLIPUR,1,37,0,37,37,0,0,0,0,0
A & N ISLANDS,NORTH & MIDDLE ANDAMANS,ALL SOCIAL GROUPS,20.0 & ABOVE,2,MAYABUNDER,1,57,50,7,57,0,0,0,0,0
A & N ISLANDS,NORTH & MIDDLE ANDAMANS,ALL SOCIAL GROUPS,20.0 & ABOVE,3,RANGAT,2,54,5,1,6,8,1,28,37,12
A & N ISLANDS,NORTH & MIDDLE ANDAMANS,INSTITUTIONAL,1.0-2.0,1,DIGLIPUR,6,8,7,1,8,0,0,0,0,0
A & N ISLANDS,NORTH & MIDDLE ANDAMANS,INSTITUTIONAL,1.0-2.0,2,MAYABUNDER,3,3,3,0,3,0,0,0,0,0
A & N ISLANDS,NORTH & MIDDLE ANDAMANS,INSTITUTIONAL,1.0-2.0,3,RANGAT,6,8,7,0,7,0,0,0,0,1
A & N ISLANDS,NORTH & MIDDLE ANDAMANS,SCHEDULED CASTE,1.0-2.0,1,DIGLIPUR,0,0,0,0,0,0,0,0,0,0
A & N ISLANDS,NORTH & MIDDLE ANDAMANS,SCHEDULED CASTE,1.0-2.0,2,MAYABUNDER,0,0,0,0,0,0,0,0,0,0
A & N ISLANDS,NORTH & MIDDLE ANDAMANS,SCHEDULED CASTE,1.0-2.0,3,RANGAT,0,0,0,0,0,0,0,0,0,0
A & N ISLANDS,NORTH & MIDDLE ANDAMANS,OTHERS,1.0-2.0,1,DIGLIPUR,470,642,441,49,490,22,73,15,110,41
A & N ISLANDS,NORTH & MIDDLE ANDAMANS,OTHERS,1.0-2.0,2,MAYABUNDER,327,474,403,43,446,2,12,4,18,10
A & N ISLANDS,NORTH & MIDDLE ANDAMANS,OTHERS,1.0-2.0,3,RANGAT,253,362,269,9,278,16,16,27,59,25
A & N ISLANDS,NORTH & MIDDLE ANDAMANS,SCHEDULED TRIBES,1.0-2.0,1,DIGLIPUR,0,0,0,0,0,0,0,0,0,0
A & N ISLANDS,NORTH & MIDDLE ANDAMANS,SCHEDULED TRIBES,1.0-2.0,2,MAYABUNDER,0,0,0,0,0,0,0,0,0,0
A & N ISLANDS,NORTH & MIDDLE ANDAMANS,SCHEDULED TRIBES,1.0-2.0,3,RANGAT,0,0,0,0,0,0,0,0,0,0
A & N ISLANDS,NORTH & MIDDLE ANDAMANS,ALL SOCIAL GROUPS,1.0-2.0,1,DIGLIPUR,476,650,449,50,499,22,73,15,110,41
A & N ISLANDS,NORTH & MIDDLE ANDAMANS,ALL SOCIAL GROUPS,1.0-2.0,2,MAYABUNDER,330,478,406,43,449,2,12,4,18,10
A & N ISLANDS,NORTH & MIDDLE ANDAMANS,ALL SOCIAL GROUPS,1.0-2.0,3,RANGAT,259,370,276,9,285,17,16,27,60,26
A & N ISLANDS,NORTH & MIDDLE ANDAMANS,INSTITUTIONAL,0.5-1.0,1,DIGLIPUR,4,2,2,0,2,0,0,0,0,0
A & N ISLANDS,NORTH & MIDDLE ANDAMANS,INSTITUTIONAL,0.5-1.0,2,MAYABUNDER,2,1,1,0,1,0,0,0,0,0
A & N ISLANDS,NORTH & MIDDLE ANDAMANS,INSTITUTIONAL,0.5-1.0,3,RANGAT,5,3,1,0,1,0,0,1,1,1
A & N ISLANDS,NORTH & MIDDLE ANDAMANS,SCHEDULED CASTE,0.5-1.0,1,DIGLIPUR,0,0,0,0,0,0,0,0,0,0
A & N ISLANDS,NORTH & MIDDLE ANDAMANS,SCHEDULED CASTE,0.5-1.0,2,MAYABUNDER,0,0,0,0,0,0,0,0,0,0
A & N ISLANDS,NORTH & MIDDLE ANDAMANS,SCHEDULED CASTE,0.5-1.0,3,RANGAT,0,0,0,0,0,0,0,0,0,0
A & N ISLANDS,NORTH & MIDDLE ANDAMANS,OTHERS,0.5-1.0,1,DIGLIPUR,279,206,132,16,148,12,19,8,39,19
A & N ISLANDS,NORTH & MIDDLE ANDAMANS,OTHERS,0.5-1.0,2,MAYABUNDER,196,153,133,12,145,1,2,1,4,4
A & N ISLANDS,NORTH & MIDDLE ANDAMANS,OTHERS,0.5-1.0,3,RANGAT,183,135,99,5,104,8,5,13,26,6
A & N ISLANDS,NORTH & MIDDLE ANDAMANS,SCHEDULED TRIBES,0.5-1.0,1,DIGLIPUR,0,0,0,0,0,0,0,0,0,0
A & N ISLANDS,NORTH & MIDDLE ANDAMANS,SCHEDULED TRIBES,0.5-1.0,2,MAYABUNDER,0,0,0,0,0,0,0,0,0,0
A & N ISLANDS,NORTH & MIDDLE ANDAMANS,SCHEDULED TRIBES,0.5-1.0,3,RANGAT,0,0,0,0,0,0,0,0,0,0
A & N ISLANDS,NORTH & MIDDLE ANDAMANS,ALL SOCIAL GROUPS,0.5-1.0,1,DIGLIPUR,283,208,134,16,150,12,19,8,39,19
A & N ISLANDS,NORTH & MIDDLE ANDAMANS,ALL SOCIAL GROUPS,0.5-1.0,2,MAYABUNDER,198,154,134,12,146,1,2,1,4,5
A & N ISLANDS,NORTH & MIDDLE ANDAMANS,ALL SOCIAL GROUPS,0.5-1.0,3,RANGAT,188,139,100,5,105,8,5,15,28,7
A & N ISLANDS,NORTH & MIDDLE ANDAMANS,INSTITUTIONAL,3.0-4.0,1,DIGLIPUR,3,10,6,4,10,0,0,0,0,0
A & N ISLANDS,NORTH & MIDDLE ANDAMANS,INSTITUTIONAL,3.0-4.0,2,MAYABUNDER,2,7,3,1,4,0,0,0,0,3
A & N ISLANDS,NORTH & MIDDLE ANDAMANS,INSTITUTIONAL,3.0-4.0,3,RANGAT,4,13,6,0,6,3,1,2,6,2
A & N ISLANDS,NORTH & MIDDLE ANDAMANS,SCHEDULED CASTE,3.0-4.0,1,DIGLIPUR,0,0,0,0,0,0,0,0,0,0
A & N ISLANDS,NORTH & MIDDLE ANDAMANS,SCHEDULED CASTE,3.0-4.0,2,MAYABUNDER,0,0,0,0,0,0,0,0,0,0
A & N ISLANDS,NORTH & MIDDLE ANDAMANS,SCHEDULED CASTE,3.0-4.0,3,RANGAT,0,0,0,0,0,0,0,0,0,0
A & N ISLANDS,NORTH & MIDDLE ANDAMANS,OTHERS,3.0-4.0,1,DIGLIPUR,375,1393,825,68,893,65,96,38,199,303
A & N ISLANDS,NORTH & MIDDLE ANDAMANS,OTHERS,3.0-4.0,2,MAYABUNDER,93,345,282,30,312,3,12,2,17,15
A & N ISLANDS,NORTH & MIDDLE ANDAMANS,OTHERS,3.0-4.0,3,RANGAT,258,964,660,24,684,97,51,70,218,61
A & N ISLANDS,NORTH & MIDDLE ANDAMANS,SCHEDULED TRIBES,3.0-4.0,1,DIGLIPUR,0,0,0,0,0,0,0,0,0,0
A & N ISLANDS,NORTH & MIDDLE ANDAMANS,SCHEDULED TRIBES,3.0-4.0,2,MAYABUNDER,0,0,0,0,0,0,0,0,0,0
A & N ISLANDS,NORTH & MIDDLE ANDAMANS,SCHEDULED TRIBES,3.0-4.0,3,RANGAT,0,0,0,0,0,0,0,0,0,0
A & N ISLANDS,NORTH & MIDDLE ANDAMANS,ALL SOCIAL GROUPS,3.0-4.0,1,DIGLIPUR,378,1403,831,71,902,65,96,38,199,303
A & N ISLANDS,NORTH & MIDDLE ANDAMANS,ALL SOCIAL GROUPS,3.0-4.0,2,MAYABUNDER,95,352,286,31,317,3,12,2,17,18
A & N ISLANDS,NORTH & MIDDLE ANDAMANS,ALL SOCIAL GROUPS,3.0-4.0,3,RANGAT,262,977,666,24,690,100,52,72,224,63
A & N ISLANDS,NORTH & MIDDLE ANDAMANS,INSTITUTIONAL,2.0-3.0,1,DIGLIPUR,5,11,11,0,11,0,0,0,0,0
A & N ISLANDS,NORTH & MIDDLE ANDAMANS,INSTITUTIONAL,2.0-3.0,2,MAYABUNDER,2,4,4,0,4,0,0,0,0,0
A & N ISLANDS,NORTH & MIDDLE ANDAMANS,INSTITUTIONAL,2.0-3.0,3,RANGAT,1,2,2,0,2,0,0,0,0,0
A & N ISLANDS,NORTH & MIDDLE ANDAMANS,SCHEDULED CASTE,2.0-3.0,1,DIGLIPUR,0,0,0,0,0,0,0,0,0,0
A & N ISLANDS,NORTH & MIDDLE ANDAMANS,SCHEDULED CASTE,2.0-3.0,2,MAYABUNDER,0,0,0,0,0,0,0,0,0,0
A & N ISLANDS,NORTH & MIDDLE ANDAMANS,SCHEDULED CASTE,2.0-3.0,3,RANGAT,0,0,0,0,0,0,0,0,0,0
A & N ISLANDS,NORTH & MIDDLE ANDAMANS,OTHERS,2.0-3.0,1,DIGLIPUR,343,756,484,70,554,25,92,20,137,64
A & N ISLANDS,NORTH & MIDDLE ANDAMANS,OTHERS,2.0-3.0,2,MAYABUNDER,448,945,849,58,907,0,18,6,24,12
A & N ISLANDS,NORTH & MIDDLE ANDAMANS,OTHERS,2.0-3.0,3,RANGAT,225,500,403,10,413,22,19,22,63,23
A & N ISLANDS,NORTH & MIDDLE ANDAMANS,SCHEDULED TRIBES,2.0-3.0,1,DIGLIPUR,0,0,0,0,0,0,0,0,0,0
A & N ISLANDS,NORTH & MIDDLE ANDAMANS,SCHEDULED TRIBES,2.0-3.0,2,MAYABUNDER,0,0,0,0,0,0,0,0,0,0
A & N ISLANDS,NORTH & MIDDLE ANDAMANS,SCHEDULED TRIBES,2.0-3.0,3,RANGAT,0,0,0,0,0,0,0,0,0,0
A & N ISLANDS,NORTH & MIDDLE ANDAMANS,ALL SOCIAL GROUPS,2.0-3.0,1,DIGLIPUR,348,767,496,70,566,25,92,20,137,64
A & N ISLANDS,NORTH & MIDDLE ANDAMANS,ALL SOCIAL GROUPS,2.0-3.0,2,MAYABUNDER,450,949,853,58,911,0,18,6,24,12
A & N ISLANDS,NORTH & MIDDLE ANDAMANS,ALL SOCIAL GROUPS,2.0-3.0,3,RANGAT,226,502,405,10,415,22,19,22,63,23
A & N ISLANDS,NORTH & MIDDLE ANDAMANS,INSTITUTIONAL,5.0-7.5,1,DIGLIPUR,4,23,16,0,16,0,1,2,3,5
A & N ISLANDS,NORTH & MIDDLE ANDAMANS,INSTITUTIONAL,5.0-7.5,2,MAYABUNDER,0,0,0,0,0,0,0,0,0,0
A & N ISLANDS,NORTH & MIDDLE ANDAMANS,INSTITUTIONAL,5.0-7.5,3,RANGAT,2,14,4,0,4,0,0,2,2,7
A & N ISLANDS,NORTH & MIDDLE ANDAMANS,SCHEDULED CASTE,5.0-7.5,1,DIGLIPUR,0,0,0,0,0,0,0,0,0,0
A & N ISLANDS,NORTH & MIDDLE ANDAMANS,SCHEDULED CASTE,5.0-7.5,2,MAYABUNDER,0,0,0,0,0,0,0,0,0,0
A & N ISLANDS,NORTH & MIDDLE ANDAMANS,SCHEDULED CASTE,5.0-7.5,3,RANGAT,0,0,0,0,0,0,0,0,0,0
A & N ISLANDS,NORTH & MIDDLE ANDAMANS,OTHERS,5.0-7.5,1,DIGLIPUR,4,22,16,2,18,0,1,0,1,3
A & N ISLANDS,NORTH & MIDDLE ANDAMANS,OTHERS,5.0-7.5,2,MAYABUNDER,7,39,29,5,34,0,2,3,5,0
A & N ISLANDS,NORTH & MIDDLE ANDAMANS,OTHERS,5.0-7.5,3,RANGAT,12,68,47,3,50,4,2,5,11,7
A & N ISLANDS,NORTH & MIDDLE ANDAMANS,SCHEDULED TRIBES,5.0-7.5,1,DIGLIPUR,0,0,0,0,0,0,0,0,0,0
A & N ISLANDS,NORTH & MIDDLE ANDAMANS,SCHEDULED TRIBES,5.0-7.5,2,MAYABUNDER,0,0,0,0,0,0,0,0,0,0
A & N ISLANDS,NORTH & MIDDLE ANDAMANS,SCHEDULED TRIBES,5.0-7.5,3,RANGAT,0,0,0,0,0,0,0,0,0,0
A & N ISLANDS,NORTH & MIDDLE ANDAMANS,ALL SOCIAL GROUPS,5.0-7.5,1,DIGLIPUR,8,46,31,2,33,0,2,2,4,8
A & N ISLANDS,NORTH & MIDDLE ANDAMANS,ALL SOCIAL GROUPS,5.0-7.5,2,MAYABUNDER,7,39,29,5,34,0,2,3,5,0
A & N ISLANDS,NORTH & MIDDLE ANDAMANS,ALL SOCIAL GROUPS,5.0-7.5,3,RANGAT,14,81,51,3,54,4,2,8,14,13
A & N ISLANDS,NORTH & MIDDLE ANDAMANS,INSTITUTIONAL,4.0-5.0,1,DIGLIPUR,2,8,0,8,8,0,0,0,0,0
A & N ISLANDS,NORTH & MIDDLE ANDAMANS,INSTITUTIONAL,4.0-5.0,2,MAYABUNDER,1,5,4,0,4,0,1,0,1,0
A & N ISLANDS,NORTH & MIDDLE ANDAMANS,INSTITUTIONAL,4.0-5.0,3,RANGAT,0,0,0,0,0,0,0,0,0,0
A & N ISLANDS,NORTH & MIDDLE ANDAMANS,SCHEDULED CASTE,4.0-5.0,1,DIGLIPUR,0,0,0,0,0,0,0,0,0,0
A & N ISLANDS,NORTH & MIDDLE ANDAMANS,SCHEDULED CASTE,4.0-5.0,2,MAYABUNDER,0,0,0,0,0,0,0,0,0,0
A & N ISLANDS,NORTH & MIDDLE ANDAMANS,SCHEDULED CASTE,4.0-5.0,3,RANGAT,0,0,0,0,0,0,0,0,0,0
A & N ISLANDS,NORTH & MIDDLE ANDAMANS,OTHERS,4.0-5.0,1,DIGLIPUR,602,2441,1379,119,1498,139,222,104,465,479
A & N ISLANDS,NORTH & MIDDLE ANDAMANS,OTHERS,4.0-5.0,2,MAYABUNDER,118,477,379,38,417,6,5,3,14,45
A & N ISLANDS,NORTH & MIDDLE ANDAMANS,OTHERS,4.0-5.0,3,RANGAT,440,1834,1300,62,1362,180,80,107,367,105
A & N ISLANDS,NORTH & MIDDLE ANDAMANS,SCHEDULED TRIBES,4.0-5.0,1,DIGLIPUR,0,0,0,0,0,0,0,0,0,0
A & N ISLANDS,NORTH & MIDDLE ANDAMANS,SCHEDULED TRIBES,4.0-5.0,2,MAYABUNDER,0,0,0,0,0,0,0,0,0,0
A & N ISLANDS,NORTH & MIDDLE ANDAMANS,SCHEDULED TRIBES,4.0-5.0,3,RANGAT,0,0,0,0,0,0,0,0,0,0
A & N ISLANDS,NORTH & MIDDLE ANDAMANS,ALL SOCIAL GROUPS,4.0-5.0,1,DIGLIPUR,604,2449,1379,127,1506,139,222,104,465,479
A & N ISLANDS,NORTH & MIDDLE ANDAMANS,ALL SOCIAL GROUPS,4.0-5.0,2,MAYABUNDER,119,482,383,38,421,6,6,3,15,45
A & N ISLANDS,NORTH & MIDDLE ANDAMANS,ALL SOCIAL GROUPS,4.0-5.0,3,RANGAT,440,1834,1300,62,1362,180,80,107,367,105
A & N ISLANDS,NORTH & MIDDLE ANDAMANS,INSTITUTIONAL,10.0-20.0,1,DIGLIPUR,2,27,27,0,27,0,0,1,1,0
A & N ISLANDS,NORTH & MIDDLE ANDAMANS,INSTITUTIONAL,10.0-20.0,2,MAYABUNDER,2,26,12,6,18,0,0,7,7,0
A & N ISLANDS,NORTH & MIDDLE ANDAMANS,INSTITUTIONAL,10.0-20.0,3,RANGAT,2,23,21,0,21,2,0,0,2,0
A & N ISLANDS,NORTH & MIDDLE ANDAMANS,SCHEDULED CASTE,10.0-20.0,1,DIGLIPUR,0,0,0,0,0,0,0,0,0,0
A & N ISLANDS,NORTH & MIDDLE ANDAMANS,SCHEDULED CASTE,10.0-20.0,2,MAYABUNDER,0,0,0,0,0,0,0,0,0,0
A & N ISLANDS,NORTH & MIDDLE ANDAMANS,SCHEDULED CASTE,10.0-20.0,3,RANGAT,0,0,0,0,0,0,0,0,0,0
A & N ISLANDS,NORTH & MIDDLE ANDAMANS,OTHERS,10.0-20.0,1,DIGLIPUR,0,0,0,0,0,0,0,0,0,0
A & N ISLANDS,NORTH & MIDDLE ANDAMANS,OTHERS,10.0-20.0,2,MAYABUNDER,0,0,0,0,0,0,0,0,0,0
A & N ISLANDS,NORTH & MIDDLE ANDAMANS,OTHERS,10.0-20.0,3,RANGAT,0,0,0,0,0,0,0,0,0,0
A & N ISLANDS,NORTH & MIDDLE ANDAMANS,SCHEDULED TRIBES,10.0-20.0,1,DIGLIPUR,0,0,0,0,0,0,0,0,0,0
A & N ISLANDS,NORTH & MIDDLE ANDAMANS,SCHEDULED TRIBES,10.0-20.0,2,MAYABUNDER,0,0,0,0,0,0,0,0,0,0
A & N ISLANDS,NORTH & MIDDLE ANDAMANS,SCHEDULED TRIBES,10.0-20.0,3,RANGAT,0,0,0,0,0,0,0,0,0,0
A & N ISLANDS,NORTH & MIDDLE ANDAMANS,ALL SOCIAL GROUPS,10.0-20.0,1,DIGLIPUR,2,27,27,0,27,0,0,1,1,0
A & N ISLANDS,NORTH & MIDDLE ANDAMANS,ALL SOCIAL GROUPS,10.0-20.0,2,MAYABUNDER,2,26,12,6,18,0,0,7,7,0
A & N ISLANDS,NORTH & MIDDLE ANDAMANS,ALL SOCIAL GROUPS,10.0-20.0,3,RANGAT,2,23,21,0,21,2,0,0,2,0
A & N ISLANDS,NORTH & MIDDLE ANDAMANS,INSTITUTIONAL,7.5-10.0,1,DIGLIPUR,1,8,4,0,4,0,0,0,0,4
A & N ISLANDS,NORTH & MIDDLE ANDAMANS,INSTITUTIONAL,7.5-10.0,2,MAYABUNDER,0,0,0,0,0,0,0,0,0,0
A & N ISLANDS,NORTH & MIDDLE ANDAMANS,INSTITUTIONAL,7.5-10.0,3,RANGAT,1,10,9,0,9,0,0,0,0,0
A & N ISLANDS,NORTH & MIDDLE ANDAMANS,SCHEDULED CASTE,7.5-10.0,1,DIGLIPUR,0,0,0,0,0,0,0,0,0,0
A & N ISLANDS,NORTH & MIDDLE ANDAMANS,SCHEDULED CASTE,7.5-10.0,2,MAYABUNDER,0,0,0,0,0,0,0,0,0,0
A & N ISLANDS,NORTH & MIDDLE ANDAMANS,SCHEDULED CASTE,7.5-10.0,3,RANGAT,0,0,0,0,0,0,0,0,0,0
A & N ISLANDS,NORTH & MIDDLE ANDAMANS,OTHERS,7.5-10.0,1,DIGLIPUR,1,8,3,1,4,0,0,0,0,4
A & N ISLANDS,NORTH & MIDDLE ANDAMANS,OTHERS,7.5-10.0,2,MAYABUNDER,1,8,2,4,6,0,2,0,2,0
A & N ISLANDS,NORTH & MIDDLE ANDAMANS,OTHERS,7.5-10.0,3,RANGAT,1,8,4,1,5,0,0,1,1,1
A & N ISLANDS,NORTH & MIDDLE ANDAMANS,SCHEDULED TRIBES,7.5-10.0,1,DIGLIPUR,0,0,0,0,0,0,0,0,0,0
A & N ISLANDS,NORTH & MIDDLE ANDAMANS,SCHEDULED TRIBES,7.5-10.0,2,MAYABUNDER,0,0,0,0,0,0,0,0,0,0
A & N ISLANDS,NORTH & MIDDLE ANDAMANS,SCHEDULED TRIBES,7.5-10.0,3,RANGAT,0,0,0,0,0,0,0,0,0,0
A & N ISLANDS,NORTH & MIDDLE ANDAMANS,ALL SOCIAL GROUPS,7.5-10.0,1,DIGLIPUR,2,16,6,1,7,0,0,0,0,8
A & N ISLANDS,NORTH & MIDDLE ANDAMANS,ALL SOCIAL GROUPS,7.5-10.0,2,MAYABUNDER,1,8,2,4,6,0,2,0,2,0
A & N ISLANDS,NORTH & MIDDLE ANDAMANS,ALL SOCIAL GROUPS,7.5-10.0,3,RANGAT,2,18,14,1,15,1,0,1,2,1
A & N ISLANDS,NICOBAR,INSTITUTIONAL,ALL CLASSES,1,CAMPBELL BAY,42,50,6,12,18,15,2,13,30,3
A & N ISLANDS,NICOBAR,SCHEDULED CASTE,ALL CLASSES,1,CAMPBELL BAY,0,0,0,0,0,0,0,0,0,0
A & N ISLANDS,NICOBAR,OTHERS,ALL CLASSES,1,CAMPBELL BAY,428,1419,457,6,463,516,10,409,935,21
A & N ISLANDS,NICOBAR,SCHEDULED TRIBES,ALL CLASSES,1,CAMPBELL BAY,0,0,0,0,0,0,0,0,0,0
A & N ISLANDS,NICOBAR,ALL SOCIAL GROUPS,ALL CLASSES,1,CAMPBELL BAY,470,1469,463,18,481,531,11,422,964,24
A & N ISLANDS,NICOBAR,INSTITUTIONAL,20.0 & ABOVE,1,CAMPBELL BAY,0,0,0,0,0,0,0,0,0,0
A & N ISLANDS,NICOBAR,SCHEDULED CASTE,20.0 & ABOVE,1,CAMPBELL BAY,0,0,0,0,0,0,0,0,0,0
A & N ISLANDS,NICOBAR,OTHERS,20.0 & ABOVE,1,CAMPBELL BAY,0,0,0,0,0,0,0,0,0,0
A & N ISLANDS,NICOBAR,SCHEDULED TRIBES,20.0 & ABOVE,1,CAMPBELL BAY,0,0,0,0,0,0,0,0,0,0
A & N ISLANDS,NICOBAR,ALL SOCIAL GROUPS,20.0 & ABOVE,1,CAMPBELL BAY,0,0,0,0,0,0,0,0,0,0
A & N ISLANDS,NICOBAR,INSTITUTIONAL,1.0-2.0,1,CAMPBELL BAY,3,5,0,4,4,0,0,0,0,0
A & N ISLANDS,NICOBAR,SCHEDULED CASTE,1.0-2.0,1,CAMPBELL BAY,0,0,0,0,0,0,0,0,0,0
A & N ISLANDS,NICOBAR,OTHERS,1.0-2.0,1,CAMPBELL BAY,30,44,26,0,26,9,0,9,18,0
A & N ISLANDS,NICOBAR,SCHEDULED TRIBES,1.0-2.0,1,CAMPBELL BAY,0,0,0,0,0,0,0,0,0,0
A & N ISLANDS,NICOBAR,ALL SOCIAL GROUPS,1.0-2.0,1,CAMPBELL BAY,33,49,26,4,30,9,0,9,18,0
A & N ISLANDS,NICOBAR,INSTITUTIONAL,0.5-1.0,1,CAMPBELL BAY,3,2,2,0,2,0,0,0,0,0
A & N ISLANDS,NICOBAR,SCHEDULED CASTE,0.5-1.0,1,CAMPBELL BAY,0,0,0,0,0,0,0,0,0,0
A & N ISLANDS,NICOBAR,OTHERS,0.5-1.0,1,CAMPBELL BAY,19,13,7,0,7,3,0,2,5,0
A & N ISLANDS,NICOBAR,SCHEDULED TRIBES,0.5-1.0,1,CAMPBELL BAY,0,0,0,0,0,0,0,0,0,0
A & N ISLANDS,NICOBAR,ALL SOCIAL GROUPS,0.5-1.0,1,CAMPBELL BAY,22,15,10,0,10,3,0,2,5,0
A & N ISLANDS,NICOBAR,INSTITUTIONAL,3.0-4.0,1,CAMPBELL BAY,1,3,0,1,1,1,1,0,2,0
A & N ISLANDS,NICOBAR,SCHEDULED CASTE,3.0-4.0,1,CAMPBELL BAY,0,0,0,0,0,0,0,0,0,0
A & N ISLANDS,NICOBAR,OTHERS,3.0-4.0,1,CAMPBELL BAY,21,67,21,0,21,26,0,19,45,1
A & N ISLANDS,NICOBAR,SCHEDULED TRIBES,3.0-4.0,1,CAMPBELL BAY,0,0,0,0,0,0,0,0,0,0
A & N ISLANDS,NICOBAR,ALL SOCIAL GROUPS,3.0-4.0,1,CAMPBELL BAY,22,71,21,1,22,27,1,19,47,1
A & N ISLANDS,NICOBAR,INSTITUTIONAL,2.0-3.0,1,CAMPBELL BAY,2,5,0,4,4,1,0,0,1,0
A & N ISLANDS,NICOBAR,SCHEDULED CASTE,2.0-3.0,1,CAMPBELL BAY,0,0,0,0,0,0,0,0,0,0
A & N ISLANDS,NICOBAR,OTHERS,2.0-3.0,1,CAMPBELL BAY,42,97,49,1,50,26,3,18,47,1
A & N ISLANDS,NICOBAR,SCHEDULED TRIBES,2.0-3.0,1,CAMPBELL BAY,0,0,0,0,0,0,0,0,0,0
A & N ISLANDS,NICOBAR,ALL SOCIAL GROUPS,2.0-3.0,1,CAMPBELL BAY,44,103,49,5,54,26,4,18,48,1
A & N ISLANDS,NICOBAR,INSTITUTIONAL,5.0-7.5,1,CAMPBELL BAY,0,0,0,0,0,0,0,0,0,0
A & N ISLANDS,NICOBAR,SCHEDULED CASTE,5.0-7.5,1,CAMPBELL BAY,0,0,0,0,0,0,0,0,0,0
A & N ISLANDS,NICOBAR,OTHERS,5.0-7.5,1,CAMPBELL BAY,70,408,116,1,117,140,6,138,284,8
A & N ISLANDS,NICOBAR,SCHEDULED TRIBES,5.0-7.5,1,CAMPBELL BAY,0,0,0,0,0,0,0,0,0,0
A & N ISLANDS,NICOBAR,ALL SOCIAL GROUPS,5.0-7.5,1,CAMPBELL BAY,70,408,116,1,117,140,6,138,284,8
A & N ISLANDS,NICOBAR,INSTITUTIONAL,4.0-5.0,1,CAMPBELL BAY,1,5,1,3,4,0,0,0,0,0
A & N ISLANDS,NICOBAR,SCHEDULED CASTE,4.0-5.0,1,CAMPBELL BAY,0,0,0,0,0,0,0,0,0,0
A & N ISLANDS,NICOBAR,OTHERS,4.0-5.0,1,CAMPBELL BAY,171,759,224,4,228,304,0,217,521,10
A & N ISLANDS,NICOBAR,SCHEDULED TRIBES,4.0-5.0,1,CAMPBELL BAY,0,0,0,0,0,0,0,0,0,0
A & N ISLANDS,NICOBAR,ALL SOCIAL GROUPS,4.0-5.0,1,CAMPBELL BAY,172,764,224,7,231,305,0,217,522,10
A & N ISLANDS,NICOBAR,INSTITUTIONAL,10.0-20.0,1,CAMPBELL BAY,1,18,1,0,1,8,0,8,16,0
A & N ISLANDS,NICOBAR,SCHEDULED CASTE,10.0-20.0,1,CAMPBELL BAY,0,0,0,0,0,0,0,0,0,0
A & N ISLANDS,NICOBAR,OTHERS,10.0-20.0,1,CAMPBELL BAY,0,0,0,0,0,0,0,0,0,0
A & N ISLANDS,NICOBAR,SCHEDULED TRIBES,10.0-20.0,1,CAMPBELL BAY,0,0,0,0,0,0,0,0,0,0
A & N ISLANDS,NICOBAR,ALL SOCIAL GROUPS,10.0-20.0,1,CAMPBELL BAY,1,18,1,0,1,8,0,8,16,0
A & N ISLANDS,NICOBAR,INSTITUTIONAL,7.5-10.0,1,CAMPBELL BAY,1,10,1,0,1,4,0,4,8,2
A & N ISLANDS,NICOBAR,SCHEDULED CASTE,7.5-10.0,1,CAMPBELL BAY,0,0,0,0,0,0,0,0,0,0
A & N ISLANDS,NICOBAR,OTHERS,7.5-10.0,1,CAMPBELL BAY,2,18,4,0,4,7,0,7,14,0
A & N ISLANDS,NICOBAR,SCHEDULED TRIBES,7.5-10.0,1,CAMPBELL BAY,0,0,0,0,0,0,0,0,0,0
A & N ISLANDS,NICOBAR,ALL SOCIAL GROUPS,7.5-10.0,1,CAMPBELL BAY,3,28,5,0,5,11,0,11,22,2
ANDHRA PRADESH,KADAPA,INSTITUTIONAL,ALL CLASSES,1,KONDAPURAM,0,0,0,0,0,0,0,0,0,0
ANDHRA PRADESH,KADAPA,INSTITUTIONAL,ALL CLASSES,2,MYLAVARAM,0,0,0,0,0,0,0,0,0,0
ANDHRA PRADESH,KADAPA,INSTITUTIONAL,ALL CLASSES,3,PEDDAMUDIUM,0,0,0,0,0,0,0,0,0,0
ANDHRA PRADESH,KADAPA,INSTITUTIONAL,ALL CLASSES,4,RAJUPALEM,0,0,0,0,0,0,0,0,0,0
ANDHRA PRADESH,KADAPA,INSTITUTIONAL,ALL CLASSES,5,DUVVUR,0,0,0,0,0,0,0,0,0,0
ANDHRA PRADESH,KADAPA,INSTITUTIONAL,ALL CLASSES,6,S.MYDUKUR,1,282,141,141,282,0,0,0,0,0
ANDHRA PRADESH,KADAPA,INSTITUTIONAL,ALL CLASSES,7,BRAHMAMGARIMATTAM,3,6,3,3,6,0,0,0,0,0
ANDHRA PRADESH,KADAPA,INSTITUTIONAL,ALL CLASSES,8,SRI AVADHUTHA KASINAYANA,0,0,0,0,0,0,0,0,0,0
ANDHRA PRADESH,KADAPA,INSTITUTIONAL,ALL CLASSES,9,KALASAPADU,0,0,0,0,0,0,0,0,0,0
ANDHRA PRADESH,KADAPA,INSTITUTIONAL,ALL CLASSES,10,PORUMAMILLA,3,39,19,19,38,0,0,0,0,0
ANDHRA PRADESH,KADAPA,INSTITUTIONAL,ALL CLASSES,11,B.KODUR,0,0,0,0,0,0,0,0,0,0
ANDHRA PRADESH,KADAPA,INSTITUTIONAL,ALL CLASSES,12,BADVEL,1,174,87,87,174,0,0,0,0,0
ANDHRA PRADESH,KADAPA,INSTITUTIONAL,ALL CLASSES,13,GOPAVARAM,0,0,0,0,0,0,0,0,0,0
ANDHRA PRADESH,KADAPA,INSTITUTIONAL,ALL CLASSES,14,KHAJIPET,1,65,33,33,66,0,0,0,0,0
ANDHRA PRADESH,KADAPA,INSTITUTIONAL,ALL CLASSES,15,CHAPAD,0,0,0,0,0,0,0,0,0,0
ANDHRA PRADESH,KADAPA,INSTITUTIONAL,ALL CLASSES,16,PRODDATUR,4,20,18,3,21,0,0,0,0,0
ANDHRA PRADESH,KADAPA,INSTITUTIONAL,ALL CLASSES,17,JAMMALAMADUGU,0,0,0,0,0,0,0,0,0,0
ANDHRA PRADESH,KADAPA,INSTITUTIONAL,ALL CLASSES,18,MUDDANUR,0,0,0,0,0,0,0,0,0,0
ANDHRA PRADESH,KADAPA,INSTITUTIONAL,ALL CLASSES,19,SIMHADRIPURAM,0,0,0,0,0,0,0,0,0,0
ANDHRA PRADESH,KADAPA,INSTITUTIONAL,ALL CLASSES,20,LINGALA,1,3,2,2,4,0,0,0,0,0
ANDHRA PRADESH,KADAPA,INSTITUTIONAL,ALL CLASSES,21,PULIVENDLA,0,0,0,0,0,0,0,0,0,0
ANDHRA PRADESH,KADAPA,INSTITUTIONAL,ALL CLASSES,22,VEMULA,0,0,0,0,0,0,0,0,0,0
ANDHRA PRADESH,KADAPA,INSTITUTIONAL,ALL CLASSES,23,THONDUR,0,0,0,0,0,0,0,0,0,0
ANDHRA PRADESH,KADAPA,INSTITUTIONAL,ALL CLASSES,24,VEERAPUNAYUNIPALLE,0,0,0,0,0,0,0,0,0,0
ANDHRA PRADESH,KADAPA,INSTITUTIONAL,ALL CLASSES,25,YERRAGUNTLA,1,1,1,0,1,0,0,0,0,0
ANDHRA PRADESH,KADAPA,INSTITUTIONAL,ALL CLASSES,26,KAMALAPURAM,0,0,0,0,0,0,0,0,0,0
ANDHRA PRADESH,KADAPA,INSTITUTIONAL,ALL CLASSES,27,VALLUR,0,0,0,0,0,0,0,0,0,0
ANDHRA PRADESH,KADAPA,INSTITUTIONAL,ALL CLASSES,28,CHENNUR,0,0,0,0,0,0,0,0,0,0
ANDHRA PRADESH,KADAPA,INSTITUTIONAL,ALL CLASSES,29,ATLUR,0,0,0,0,0,0,0,0,0,0
ANDHRA PRADESH,KADAPA,INSTITUTIONAL,ALL CLASSES,30,VONTIMITTA,0,0,0,0,0,0,0,0,0,0
ANDHRA PRADESH,KADAPA,INSTITUTIONAL,ALL CLASSES,31,SIDHOUT,0,0,0,0,0,0,0,0,0,0
ANDHRA PRADESH,KADAPA,INSTITUTIONAL,ALL CLASSES,32,CUDDAPAH,0,0,0,0,0,0,0,0,0,0
ANDHRA PRADESH,KADAPA,INSTITUTIONAL,ALL CLASSES,33,CHINTHAKOMMADINNE,3,29,13,16,29,0,0,0,0,0
ANDHRA PRADESH,KADAPA,INSTITUTIONAL,ALL CLASSES,34,PENDLIMARRI,0,0,0,0,0,0,0,0,0,0
ANDHRA PRADESH,KADAPA,INSTITUTIONAL,ALL CLASSES,35,VEMPALLE,0,0,0,0,0,0,0,0,0,0
ANDHRA PRADESH,KADAPA,INSTITUTIONAL,ALL CLASSES,36,CHAKRAYAPET,0,0,0,0,0,0,0,0,0,0
ANDHRA PRADESH,KADAPA,INSTITUTIONAL,ALL CLASSES,37,GALIVEEDU,0,0,0,0,0,0,0,0,0,0
ANDHRA PRADESH,KADAPA,INSTITUTIONAL,ALL CLASSES,38,CHINNAMANDEM,0,0,0,0,0,0,0,0,0,0
ANDHRA PRADESH,KADAPA,INSTITUTIONAL,ALL CLASSES,39,SAMBEPALLE,0,0,0,0,0,0,0,0,0,0
ANDHRA PRADESH,KADAPA,INSTITUTIONAL,ALL CLASSES,40,T SUNDUPALLE,0,0,0,0,0,0,0,0,0,0
ANDHRA PRADESH,KADAPA,INSTITUTIONAL,ALL CLASSES,41,RAYACHOTI,0,0,0,0,0,0,0,0,0,0
ANDHRA PRADESH,KADAPA,INSTITUTIONAL,ALL CLASSES,42,LAKKIREDDIPALLE,0,0,0,0,0,0,0,0,0,0
ANDHRA PRADESH,KADAPA,INSTITUTIONAL,ALL CLASSES,43,RAMAPURAM,0,0,0,0,0,0,0,0,0,0
ANDHRA PRADESH,KADAPA,INSTITUTIONAL,ALL CLASSES,44,VEERABALLE,0,0,0,0,0,0,0,0,0,0
ANDHRA PRADESH,KADAPA,INSTITUTIONAL,ALL CLASSES,45,NANDALUR,0,0,0,0,0,0,0,0,0,0
ANDHRA PRADESH,KADAPA,INSTITUTIONAL,ALL CLASSES,46,PENAGALUR,0,0,0,0,0,0,0,0,0,0
ANDHRA PRADESH,KADAPA,INSTITUTIONAL,ALL CLASSES,47,CHITVEL,0,0,0,0,0,0,0,0,0,0
ANDHRA PRADESH,KADAPA,INSTITUTIONAL,ALL CLASSES,48,RAJAMPET,0,0,0,0,0,0,0,0,0,0
ANDHRA PRADESH,KADAPA,INSTITUTIONAL,ALL CLASSES,49,PULLAMPETA,0,0,0,0,0,0,0,0,0,0
ANDHRA PRADESH,KADAPA,INSTITUTIONAL,ALL CLASSES,50,OBULAVARIPALLE,0,0,0,0,0,0,0,0,0,0
ANDHRA PRADESH,KADAPA,INSTITUTIONAL,ALL CLASSES,51,KODUR,0,0,0,0,0,0,0,0,0,0
ANDHRA PRADESH,KADAPA,SCHEDULED CASTE,ALL CLASSES,1,KONDAPURAM,638,671,492,178,670,0,1,0,1,0
ANDHRA PRADESH,KADAPA,SCHEDULED CASTE,ALL CLASSES,2,MYLAVARAM,1204,1061,1003,51,1054,0,7,0,7,0
ANDHRA PRADESH,KADAPA,SCHEDULED CASTE,ALL CLASSES,3,PEDDAMUDIUM,272,398,334,52,386,0,11,0,11,0
ANDHRA PRADESH,KADAPA,SCHEDULED CASTE,ALL CLASSES,4,RAJUPALEM,726,541,473,68,541,0,0,0,0,0
ANDHRA PRADESH,KADAPA,SCHEDULED CASTE,ALL CLASSES,5,DUVVUR,879,577,565,12,577,0,0,0,0,0
ANDHRA PRADESH,KADAPA,SCHEDULED CASTE,ALL CLASSES,6,S.MYDUKUR,1363,962,874,88,962,0,0,0,0,0
ANDHRA PRADESH,KADAPA,SCHEDULED CASTE,ALL CLASSES,7,BRAHMAMGARIMATTAM,2280,1698,576,1122,1698,0,0,0,0,0
ANDHRA PRADESH,KADAPA,SCHEDULED CASTE,ALL CLASSES,8,SRI AVADHUTHA KASINAYANA,1177,1029,631,398,1029,0,0,0,0,0
ANDHRA PRADESH,KADAPA,SCHEDULED CASTE,ALL CLASSES,9,KALASAPADU,906,679,628,50,678,0,0,0,0,0
ANDHRA PRADESH,KADAPA,SCHEDULED CASTE,ALL CLASSES,10,PORUMAMILLA,1531,1433,838,595,1433,0,0,0,0,0
ANDHRA PRADESH,KADAPA,SCHEDULED CASTE,ALL CLASSES,11,B.KODUR,885,646,298,21,319,0,0,0,0,327
ANDHRA PRADESH,KADAPA,SCHEDULED CASTE,ALL CLASSES,12,BADVEL,1410,954,367,458,825,0,106,0,106,24
ANDHRA PRADESH,KADAPA,SCHEDULED CASTE,ALL CLASSES,13,GOPAVARAM,1149,913,451,416,867,0,9,8,17,30
ANDHRA PRADESH,KADAPA,SCHEDULED CASTE,ALL CLASSES,14,KHAJIPET,1511,799,669,130,799,0,0,0,0,0
ANDHRA PRADESH,KADAPA,SCHEDULED CASTE,ALL CLASSES,15,CHAPAD,186,90,83,6,89,0,0,0,0,1
ANDHRA PRADESH,KADAPA,SCHEDULED CASTE,ALL CLASSES,16,PRODDATUR,392,232,198,34,232,0,0,0,0,0
ANDHRA PRADESH,KADAPA,SCHEDULED CASTE,ALL CLASSES,17,JAMMALAMADUGU,148,74,71,3,74,0,0,0,0,0
ANDHRA PRADESH,KADAPA,SCHEDULED CASTE,ALL CLASSES,18,MUDDANUR,721,715,578,135,713,0,2,0,2,0
ANDHRA PRADESH,KADAPA,SCHEDULED CASTE,ALL CLASSES,19,SIMHADRIPURAM,434,547,345,202,547,0,0,0,0,0
ANDHRA PRADESH,KADAPA,SCHEDULED CASTE,ALL CLASSES,20,LINGALA,458,596,580,16,596,0,0,0,0,0
ANDHRA PRADESH,KADAPA,SCHEDULED CASTE,ALL CLASSES,21,PULIVENDLA,269,248,242,6,248,0,0,0,0,0
ANDHRA PRADESH,KADAPA,SCHEDULED CASTE,ALL CLASSES,22,VEMULA,637,768,664,105,769,0,0,0,0,0
ANDHRA PRADESH,KADAPA,SCHEDULED CASTE,ALL CLASSES,23,THONDUR,611,663,245,418,663,0,0,0,0,0
ANDHRA PRADESH,KADAPA,SCHEDULED CASTE,ALL CLASSES,24,VEERAPUNAYUNIPALLE,599,677,555,122,677,0,0,0,0,0
ANDHRA PRADESH,KADAPA,SCHEDULED CASTE,ALL CLASSES,25,YERRAGUNTLA,227,182,128,55,183,0,0,0,0,0
ANDHRA PRADESH,KADAPA,SCHEDULED CASTE,ALL CLASSES,26,KAMALAPURAM,673,424,319,105,424,0,0,0,0,0
ANDHRA PRADESH,KADAPA,SCHEDULED CASTE,ALL CLASSES,27,VALLUR,858,564,341,223,564,0,0,0,0,0
ANDHRA PRADESH,KADAPA,SCHEDULED CASTE,ALL CLASSES,28,CHENNUR,339,154,134,20,154,0,0,0,0,0
ANDHRA PRADESH,KADAPA,SCHEDULED CASTE,ALL CLASSES,29,ATLUR,1075,721,198,521,719,0,0,0,0,2
ANDHRA PRADESH,KADAPA,SCHEDULED CASTE,ALL CLASSES,30,VONTIMITTA,757,473,287,126,413,0,60,0,60,0
ANDHRA PRADESH,KADAPA,SCHEDULED CASTE,ALL CLASSES,31,SIDHOUT,840,513,194,203,397,0,21,35,56,60
ANDHRA PRADESH,KADAPA,SCHEDULED CASTE,ALL CLASSES,32,CUDDAPAH,312,135,103,32,135,0,0,0,0,0
ANDHRA PRADESH,KADAPA,SCHEDULED CASTE,ALL CLASSES,33,CHINTHAKOMMADINNE,499,371,334,37,371,0,0,0,0,0
ANDHRA PRADESH,KADAPA,SCHEDULED CASTE,ALL CLASSES,34,PENDLIMARRI,555,508,379,128,507,0,0,0,0,0
ANDHRA PRADESH,KADAPA,SCHEDULED CASTE,ALL CLASSES,35,VEMPALLE,412,388,384,4,388,0,0,0,0,0
ANDHRA PRADESH,KADAPA,SCHEDULED CASTE,ALL CLASSES,36,CHAKRAYAPET,455,402,362,22,384,1,12,0,13,4
ANDHRA PRADESH,KADAPA,SCHEDULED CASTE,ALL CLASSES,37,GALIVEEDU,340,347,134,194,328,0,9,0,9,10
ANDHRA PRADESH,KADAPA,SCHEDULED CASTE,ALL CLASSES,38,CHINNAMANDEM,433,386,350,22,372,0,14,0,14,1
ANDHRA PRADESH,KADAPA,SCHEDULED CASTE,ALL CLASSES,39,SAMBEPALLE,892,848,664,151,815,0,32,0,32,0
ANDHRA PRADESH,KADAPA,SCHEDULED CASTE,ALL CLASSES,40,T SUNDUPALLE,1013,735,340,378,718,1,16,0,17,1
ANDHRA PRADESH,KADAPA,SCHEDULED CASTE,ALL CLASSES,41,RAYACHOTI,551,451,249,178,427,0,23,0,23,1
ANDHRA PRADESH,KADAPA,SCHEDULED CASTE,ALL CLASSES,42,LAKKIREDDIPALLE,612,532,243,288,531,0,0,0,0,0
ANDHRA PRADESH,KADAPA,SCHEDULED CASTE,ALL CLASSES,43,RAMAPURAM,773,859,807,47,854,0,4,0,4,0
ANDHRA PRADESH,KADAPA,SCHEDULED CASTE,ALL CLASSES,44,VEERABALLE,797,712,518,194,712,0,0,0,0,1
ANDHRA PRADESH,KADAPA,SCHEDULED CASTE,ALL CLASSES,45,NANDALUR,528,324,171,153,324,0,0,0,0,0
ANDHRA PRADESH,KADAPA,SCHEDULED CASTE,ALL CLASSES,46,PENAGALUR,802,536,156,291,447,1,87,0,88,1
ANDHRA PRADESH,KADAPA,SCHEDULED CASTE,ALL CLASSES,47,CHITVEL,962,606,324,280,604,0,1,0,1,1
ANDHRA PRADESH,KADAPA,SCHEDULED CASTE,ALL CLASSES,48,RAJAMPET,1388,914,294,390,684,58,56,17,131,99
ANDHRA PRADESH,KADAPA,SCHEDULED CASTE,ALL CLASSES,49,PULLAMPETA,1480,1249,266,638,904,0,345,0,345,0
ANDHRA PRADESH,KADAPA,SCHEDULED CASTE,ALL CLASSES,50,OBULAVARIPALLE,442,350,228,122,350,0,0,0,0,0
ANDHRA PRADESH,KADAPA,SCHEDULED CASTE,ALL CLASSES,51,KODUR,1124,900,539,361,900,0,0,0,0,0
ANDHRA PRADESH,KADAPA,OTHERS,ALL CLASSES,1,KONDAPURAM,9012,11786,9802,1942,11744,0,27,0,27,16
ANDHRA PRADESH,KADAPA,OTHERS,ALL CLASSES,2,MYLAVARAM,7123,10594,9722,871,10593,0,0,0,0,0
ANDHRA PRADESH,KADAPA,OTHERS,ALL CLASSES,3,PEDDAMUDIUM,10804,25435,21454,3743,25197,0,151,0,151,88
ANDHRA PRADESH,KADAPA,OTHERS,ALL CLASSES,4,RAJUPALEM,9734,16694,16567,115,16682,0,0,0,0,13
ANDHRA PRADESH,KADAPA,OTHERS,ALL CLASSES,5,DUVVUR,11439,11140,11095,5,11100,1,24,0,25,15
ANDHRA PRADESH,KADAPA,OTHERS,ALL CLASSES,6,S.MYDUKUR,11204,10820,10065,734,10799,0,13,0,13,7
ANDHRA PRADESH,KADAPA,OTHERS,ALL CLASSES,7,BRAHMAMGARIMATTAM,7400,6554,3176,3378,6554,0,0,0,0,0
ANDHRA PRADESH,KADAPA,OTHERS,ALL CLASSES,8,SRI AVADHUTHA KASINAYANA,6656,8854,4980,3874,8854,0,0,0,0,0
ANDHRA PRADESH,KADAPA,OTHERS,ALL CLASSES,9,KALASAPADU,6114,5894,4222,1524,5746,0,94,0,94,54
ANDHRA PRADESH,KADAPA,OTHERS,ALL CLASSES,10,PORUMAMILLA,7512,7322,3420,3902,7322,0,0,0,0,0
ANDHRA PRADESH,KADAPA,OTHERS,ALL CLASSES,11,B.KODUR,5227,6056,2218,602,2820,0,0,0,0,3236
ANDHRA PRADESH,KADAPA,OTHERS,ALL CLASSES,12,BADVEL,9601,6529,3039,2429,5468,0,339,73,412,649
ANDHRA PRADESH,KADAPA,OTHERS,ALL CLASSES,13,GOPAVARAM,4844,4236,2761,834,3595,0,81,105,186,455
ANDHRA PRADESH,KADAPA,OTHERS,ALL CLASSES,14,KHAJIPET,10461,9264,8414,850,9264,0,0,0,0,0
ANDHRA PRADESH,KADAPA,OTHERS,ALL CLASSES,15,CHAPAD,10541,9190,8295,768,9063,0,23,0,23,104
ANDHRA PRADESH,KADAPA,OTHERS,ALL CLASSES,16,PRODDATUR,8220,11362,11201,160,11361,0,0,0,0,0
ANDHRA PRADESH,KADAPA,OTHERS,ALL CLASSES,17,JAMMALAMADUGU,7024,9564,9173,311,9484,0,51,0,51,29
ANDHRA PRADESH,KADAPA,OTHERS,ALL CLASSES,18,MUDDANUR,7701,10677,9116,1520,10636,1,22,3,26,15
ANDHRA PRADESH,KADAPA,OTHERS,ALL CLASSES,19,SIMHADRIPURAM,9846,20002,12498,7190,19688,0,200,0,200,114
ANDHRA PRADESH,KADAPA,OTHERS,ALL CLASSES,20,LINGALA,7975,14077,13975,102,14077,0,0,0,0,0
ANDHRA PRADESH,KADAPA,OTHERS,ALL CLASSES,21,PULIVENDLA,6563,9678,9563,115,9678,0,0,0,0,0
ANDHRA PRADESH,KADAPA,OTHERS,ALL CLASSES,22,VEMULA,7567,12885,11448,903,12351,0,336,7,343,192
ANDHRA PRADESH,KADAPA,OTHERS,ALL CLASSES,23,THONDUR,8144,15361,13390,1971,15361,0,0,0,0,0
ANDHRA PRADESH,KADAPA,OTHERS,ALL CLASSES,24,VEERAPUNAYUNIPALLE,8178,14932,12314,2618,14932,0,0,0,0,0
ANDHRA PRADESH,KADAPA,OTHERS,ALL CLASSES,25,YERRAGUNTLA,8790,13987,8517,5471,13988,0,0,0,0,0
ANDHRA PRADESH,KADAPA,OTHERS,ALL CLASSES,26,KAMALAPURAM,8383,11049,7245,3804,11049,0,0,0,0,0
ANDHRA PRADESH,KADAPA,OTHERS,ALL CLASSES,27,VALLUR,6672,8135,5877,1796,7673,0,281,10,291,171
ANDHRA PRADESH,KADAPA,OTHERS,ALL CLASSES,28,CHENNUR,6109,4473,3838,511,4349,0,80,0,80,45
ANDHRA PRADESH,KADAPA,OTHERS,ALL CLASSES,29,ATLUR,4850,4356,1405,2948,4353,0,0,0,0,3
ANDHRA PRADESH,KADAPA,OTHERS,ALL CLASSES,30,VONTIMITTA,4348,3689,1562,1461,3023,0,424,0,424,241
ANDHRA PRADESH,KADAPA,OTHERS,ALL CLASSES,31,SIDHOUT,4046,3631,2450,528,2978,0,13,392,405,248
ANDHRA PRADESH,KADAPA,OTHERS,ALL CLASSES,32,CUDDAPAH,4145,3147,2835,311,3146,0,0,0,0,0
ANDHRA PRADESH,KADAPA,OTHERS,ALL CLASSES,33,CHINTHAKOMMADINNE,7040,6983,6625,357,6982,0,0,0,0,0
ANDHRA PRADESH,KADAPA,OTHERS,ALL CLASSES,34,PENDLIMARRI,8725,11068,9441,1627,11068,0,0,0,0,0
ANDHRA PRADESH,KADAPA,OTHERS,ALL CLASSES,35,VEMPALLE,5469,9975,9729,236,9965,0,6,0,6,3
ANDHRA PRADESH,KADAPA,OTHERS,ALL CLASSES,36,CHAKRAYAPET,6988,9987,8029,1510,9539,33,218,27,278,171
ANDHRA PRADESH,KADAPA,OTHERS,ALL CLASSES,37,GALIVEEDU,9619,14349,8056,5607,13663,1,402,1,404,281
ANDHRA PRADESH,KADAPA,OTHERS,ALL CLASSES,38,CHINNAMANDEM,6837,8877,7668,412,8080,0,472,18,490,307
ANDHRA PRADESH,KADAPA,OTHERS,ALL CLASSES,39,SAMBEPALLE,9498,14684,12129,843,12972,0,998,87,1085,626
ANDHRA PRADESH,KADAPA,OTHERS,ALL CLASSES,40,T SUNDUPALLE,10832,12619,5307,6271,11578,29,631,0,660,380
ANDHRA PRADESH,KADAPA,OTHERS,ALL CLASSES,41,RAYACHOTI,9169,11451,4998,5208,10206,0,773,0,773,472
ANDHRA PRADESH,KADAPA,OTHERS,ALL CLASSES,42,LAKKIREDDIPALLE,8277,12255,9578,2491,12069,0,37,0,37,148
ANDHRA PRADESH,KADAPA,OTHERS,ALL CLASSES,43,RAMAPURAM,8033,11704,9741,1531,11272,0,275,0,275,157
ANDHRA PRADESH,KADAPA,OTHERS,ALL CLASSES,44,VEERABALLE,6538,7886,5919,1931,7850,0,0,0,0,37
ANDHRA PRADESH,KADAPA,OTHERS,ALL CLASSES,45,NANDALUR,3846,2843,1583,1219,2802,1,23,5,29,13
ANDHRA PRADESH,KADAPA,OTHERS,ALL CLASSES,46,PENAGALUR,6859,5446,1842,2748,4590,11,532,1,544,311
ANDHRA PRADESH,KADAPA,OTHERS,ALL CLASSES,47,CHITVEL,7490,7109,2438,4573,7011,0,59,0,59,38
ANDHRA PRADESH,KADAPA,OTHERS,ALL CLASSES,48,RAJAMPET,10125,9060,4281,2588,6869,615,243,531,1389,802
ANDHRA PRADESH,KADAPA,OTHERS,ALL CLASSES,49,PULLAMPETA,7330,8165,2471,2651,5122,2,1939,2,1943,1101
ANDHRA PRADESH,KADAPA,OTHERS,ALL CLASSES,50,OBULAVARIPALLE,7833,8613,3443,3445,6888,0,1100,0,1100,625
ANDHRA PRADESH,KADAPA,OTHERS,ALL CLASSES,51,KODUR,6495,8202,4586,3616,8202,0,0,0,0,0
ANDHRA PRADESH,KADAPA,SCHEDULED TRIBES,ALL CLASSES,1,KONDAPURAM,64,44,29,15,44,0,0,0,0,0
ANDHRA PRADESH,KADAPA,SCHEDULED TRIBES,ALL CLASSES,2,MYLAVARAM,323,289,251,38,289,0,0,0,0,0
ANDHRA PRADESH,KADAPA,SCHEDULED TRIBES,ALL CLASSES,3,PEDDAMUDIUM,28,66,56,10,66,0,0,0,0,0
ANDHRA PRADESH,KADAPA,SCHEDULED TRIBES,ALL CLASSES,4,RAJUPALEM,42,32,16,16,32,0,0,0,0,0
ANDHRA PRADESH,KADAPA,SCHEDULED TRIBES,ALL CLASSES,5,DUVVUR,47,25,23,2,25,0,0,0,0,0
ANDHRA PRADESH,KADAPA,SCHEDULED TRIBES,ALL CLASSES,6,S.MYDUKUR,183,136,104,32,136,0,0,0,0,0
ANDHRA PRADESH,KADAPA,SCHEDULED TRIBES,ALL CLASSES,7,BRAHMAMGARIMATTAM,112,76,48,29,77,0,0,0,0,0
ANDHRA PRADESH,KADAPA,SCHEDULED TRIBES,ALL CLASSES,8,SRI AVADHUTHA KASINAYANA,206,189,70,119,189,0,0,0,0,0
ANDHRA PRADESH,KADAPA,SCHEDULED TRIBES,ALL CLASSES,9,KALASAPADU,29,20,15,5,20,0,0,0,0,0
ANDHRA PRADESH,KADAPA,SCHEDULED TRIBES,ALL CLASSES,10,PORUMAMILLA,378,333,90,243,333,0,0,0,0,0
ANDHRA PRADESH,KADAPA,SCHEDULED TRIBES,ALL CLASSES,11,B.KODUR,51,45,23,7,30,0,0,0,0,16
ANDHRA PRADESH,KADAPA,SCHEDULED TRIBES,ALL CLASSES,12,BADVEL,221,146,97,44,141,0,0,2,2,4
ANDHRA PRADESH,KADAPA,SCHEDULED TRIBES,ALL CLASSES,13,GOPAVARAM,69,39,30,10,40,0,0,0,0,0
ANDHRA PRADESH,KADAPA,SCHEDULED TRIBES,ALL CLASSES,14,KHAJIPET,97,49,39,10,49,0,0,0,0,0
ANDHRA PRADESH,KADAPA,SCHEDULED TRIBES,ALL CLASSES,15,CHAPAD,149,104,92,12,104,0,0,0,0,0
ANDHRA PRADESH,KADAPA,SCHEDULED TRIBES,ALL CLASSES,16,PRODDATUR,8,3,2,2,4,0,0,0,0,0
ANDHRA PRADESH,KADAPA,SCHEDULED TRIBES,ALL CLASSES,17,JAMMALAMADUGU,144,67,46,21,67,0,0,0,0,0
ANDHRA PRADESH,KADAPA,SCHEDULED TRIBES,ALL CLASSES,18,MUDDANUR,95,103,74,29,103,0,0,0,0,0
ANDHRA PRADESH,KADAPA,SCHEDULED TRIBES,ALL CLASSES,19,SIMHADRIPURAM,83,131,69,61,130,0,0,0,0,0
ANDHRA PRADESH,KADAPA,SCHEDULED TRIBES,ALL CLASSES,20,LINGALA,20,30,24,6,30,0,0,0,0,0
ANDHRA PRADESH,KADAPA,SCHEDULED TRIBES,ALL CLASSES,21,PULIVENDLA,275,313,308,5,313,0,0,0,0,0
ANDHRA PRADESH,KADAPA,SCHEDULED TRIBES,ALL CLASSES,22,VEMULA,92,123,61,61,122,0,0,0,0,0
ANDHRA PRADESH,KADAPA,SCHEDULED TRIBES,ALL CLASSES,23,THONDUR,76,75,4,71,75,0,0,0,0,0
ANDHRA PRADESH,KADAPA,SCHEDULED TRIBES,ALL CLASSES,24,VEERAPUNAYUNIPALLE,102,110,89,21,110,0,0,0,0,0
ANDHRA PRADESH,KADAPA,SCHEDULED TRIBES,ALL CLASSES,25,YERRAGUNTLA,20,18,4,13,17,0,0,0,0,0
ANDHRA PRADESH,KADAPA,SCHEDULED TRIBES,ALL CLASSES,26,KAMALAPURAM,6,8,4,4,8,0,0,0,0,0
ANDHRA PRADESH,KADAPA,SCHEDULED TRIBES,ALL CLASSES,27,VALLUR,41,22,17,5,22,0,0,0,0,0
ANDHRA PRADESH,KADAPA,SCHEDULED TRIBES,ALL CLASSES,28,CHENNUR,68,21,11,11,22,0,0,0,0,0
ANDHRA PRADESH,KADAPA,SCHEDULED TRIBES,ALL CLASSES,29,ATLUR,82,43,2,41,43,0,0,0,0,0
ANDHRA PRADESH,KADAPA,SCHEDULED TRIBES,ALL CLASSES,30,VONTIMITTA,21,11,5,5,10,0,0,0,0,0
ANDHRA PRADESH,KADAPA,SCHEDULED TRIBES,ALL CLASSES,31,SIDHOUT,48,35,26,9,35,0,0,0,0,0
ANDHRA PRADESH,KADAPA,SCHEDULED TRIBES,ALL CLASSES,32,CUDDAPAH,182,95,91,4,95,0,0,0,0,0
ANDHRA PRADESH,KADAPA,SCHEDULED TRIBES,ALL CLASSES,33,CHINTHAKOMMADINNE,172,141,137,4,141,0,0,0,0,0
ANDHRA PRADESH,KADAPA,SCHEDULED TRIBES,ALL CLASSES,34,PENDLIMARRI,16,12,8,3,11,0,0,0,0,0
ANDHRA PRADESH,KADAPA,SCHEDULED TRIBES,ALL CLASSES,35,VEMPALLE,115,152,76,76,152,0,0,0,0,0
ANDHRA PRADESH,KADAPA,SCHEDULED TRIBES,ALL CLASSES,36,CHAKRAYAPET,339,436,332,68,400,0,28,0,28,7
ANDHRA PRADESH,KADAPA,SCHEDULED TRIBES,ALL CLASSES,37,GALIVEEDU,416,451,155,289,444,0,3,0,3,3
ANDHRA PRADESH,KADAPA,SCHEDULED TRIBES,ALL CLASSES,38,CHINNAMANDEM,44,51,44,3,47,0,3,0,3,1
ANDHRA PRADESH,KADAPA,SCHEDULED TRIBES,ALL CLASSES,39,SAMBEPALLE,488,527,445,62,507,0,16,0,16,4
ANDHRA PRADESH,KADAPA,SCHEDULED TRIBES,ALL CLASSES,40,T SUNDUPALLE,877,773,440,318,758,0,12,0,12,3
ANDHRA PRADESH,KADAPA,SCHEDULED TRIBES,ALL CLASSES,41,RAYACHOTI,26,18,12,4,16,0,1,0,1,0
ANDHRA PRADESH,KADAPA,SCHEDULED TRIBES,ALL CLASSES,42,LAKKIREDDIPALLE,79,77,48,29,77,0,0,0,0,0
ANDHRA PRADESH,KADAPA,SCHEDULED TRIBES,ALL CLASSES,43,RAMAPURAM,201,283,160,122,282,0,0,0,0,0
ANDHRA PRADESH,KADAPA,SCHEDULED TRIBES,ALL CLASSES,44,VEERABALLE,143,151,119,32,151,0,0,0,0,0
ANDHRA PRADESH,KADAPA,SCHEDULED TRIBES,ALL CLASSES,45,NANDALUR,30,22,11,10,21,0,0,0,0,0
ANDHRA PRADESH,KADAPA,SCHEDULED TRIBES,ALL CLASSES,46,PENAGALUR,488,371,186,185,371,0,0,0,0,0
ANDHRA PRADESH,KADAPA,SCHEDULED TRIBES,ALL CLASSES,47,CHITVEL,147,114,66,35,101,0,11,0,11,3
ANDHRA PRADESH,KADAPA,SCHEDULED TRIBES,ALL CLASSES,48,RAJAMPET,72,48,25,20,45,0,0,1,1,2
ANDHRA PRADESH,KADAPA,SCHEDULED TRIBES,ALL CLASSES,49,PULLAMPETA,197,203,99,104,203,0,0,0,0,0
ANDHRA PRADESH,KADAPA,SCHEDULED TRIBES,ALL CLASSES,50,OBULAVARIPALLE,203,147,77,67,144,0,2,0,2,0
ANDHRA PRADESH,KADAPA,SCHEDULED TRIBES,ALL CLASSES,51,KODUR,1112,795,303,492,795,0,0,0,0,0
ANDHRA PRADESH,KADAPA,ALL SOCIAL GROUPS,ALL CLASSES,1,KONDAPURAM,9714,12501,10323,2135,12458,0,28,0,28,16
ANDHRA PRADESH,KADAPA,ALL SOCIAL GROUPS,ALL CLASSES,2,MYLAVARAM,8650,11944,10976,961,11937,0,7,0,7,0
ANDHRA PRADESH,KADAPA,ALL SOCIAL GROUPS,ALL CLASSES,3,PEDDAMUDIUM,11104,25900,21845,3805,25650,0,162,0,162,88
ANDHRA PRADESH,KADAPA,ALL SOCIAL GROUPS,ALL CLASSES,4,RAJUPALEM,10502,17267,17056,199,17255,0,0,0,0,13
ANDHRA PRADESH,KADAPA,ALL SOCIAL GROUPS,ALL CLASSES,5,DUVVUR,12365,11742,11683,19,11702,1,24,0,25,15
ANDHRA PRADESH,KADAPA,ALL SOCIAL GROUPS,ALL CLASSES,6,S.MYDUKUR,12751,12200,11184,995,12179,0,13,0,13,7
ANDHRA PRADESH,KADAPA,ALL SOCIAL GROUPS,ALL CLASSES,7,BRAHMAMGARIMATTAM,9795,8334,3802,4532,8334,0,0,0,0,0
ANDHRA PRADESH,KADAPA,ALL SOCIAL GROUPS,ALL CLASSES,8,SRI AVADHUTHA KASINAYANA,8039,10073,5681,4392,10073,0,0,0,0,0
ANDHRA PRADESH,KADAPA,ALL SOCIAL GROUPS,ALL CLASSES,9,KALASAPADU,7049,6592,4865,1579,6444,0,94,0,94,54
ANDHRA PRADESH,KADAPA,ALL SOCIAL GROUPS,ALL CLASSES,10,PORUMAMILLA,9424,9127,4368,4760,9128,0,0,0,0,0
ANDHRA PRADESH,KADAPA,ALL SOCIAL GROUPS,ALL CLASSES,11,B.KODUR,6163,6747,2538,630,3168,0,0,0,0,3579
ANDHRA PRADESH,KADAPA,ALL SOCIAL GROUPS,ALL CLASSES,12,BADVEL,11233,7803,3590,3018,6608,0,444,76,520,676
ANDHRA PRADESH,KADAPA,ALL SOCIAL GROUPS,ALL CLASSES,13,GOPAVARAM,6062,5189,3242,1259,4501,0,90,113,203,485
ANDHRA PRADESH,KADAPA,ALL SOCIAL GROUPS,ALL CLASSES,14,KHAJIPET,12070,10177,9155,1022,10177,0,0,0,0,0
ANDHRA PRADESH,KADAPA,ALL SOCIAL GROUPS,ALL CLASSES,15,CHAPAD,10876,9384,8470,786,9256,0,23,0,23,105
ANDHRA PRADESH,KADAPA,ALL SOCIAL GROUPS,ALL CLASSES,16,PRODDATUR,8624,11618,11419,199,11618,0,0,0,0,0
ANDHRA PRADESH,KADAPA,ALL SOCIAL GROUPS,ALL CLASSES,17,JAMMALAMADUGU,7316,9704,9290,335,9625,0,51,0,51,29
ANDHRA PRADESH,KADAPA,ALL SOCIAL GROUPS,ALL CLASSES,18,MUDDANUR,8517,11495,9768,1685,11453,1,24,3,28,15
ANDHRA PRADESH,KADAPA,ALL SOCIAL GROUPS,ALL CLASSES,19,SIMHADRIPURAM,10363,20680,12912,7454,20366,0,200,0,200,114
ANDHRA PRADESH,KADAPA,ALL SOCIAL GROUPS,ALL CLASSES,20,LINGALA,8454,14706,14581,125,14706,0,0,0,0,0
ANDHRA PRADESH,KADAPA,ALL SOCIAL GROUPS,ALL CLASSES,21,PULIVENDLA,7107,10239,10114,125,10239,0,0,0,0,0
ANDHRA PRADESH,KADAPA,ALL SOCIAL GROUPS,ALL CLASSES,22,VEMULA,8296,13776,12174,1069,13243,0,336,7,343,192
ANDHRA PRADESH,KADAPA,ALL SOCIAL GROUPS,ALL CLASSES,23,THONDUR,8831,16099,13639,2460,16099,0,0,0,0,0
ANDHRA PRADESH,KADAPA,ALL SOCIAL GROUPS,ALL CLASSES,24,VEERAPUNAYUNIPALLE,8879,15719,12958,2762,15720,0,0,0,0,0
ANDHRA PRADESH,KADAPA,ALL SOCIAL GROUPS,ALL CLASSES,25,YERRAGUNTLA,9038,14189,8650,5539,14189,0,0,0,0,0
ANDHRA PRADESH,KADAPA,ALL SOCIAL GROUPS,ALL CLASSES,26,KAMALAPURAM,9062,11480,7568,3912,11480,0,0,0,0,0
ANDHRA PRADESH,KADAPA,ALL SOCIAL GROUPS,ALL CLASSES,27,VALLUR,7571,8721,6235,2024,8259,0,281,10,291,171
ANDHRA PRADESH,KADAPA,ALL SOCIAL GROUPS,ALL CLASSES,28,CHENNUR,6516,4648,3982,542,4524,0,80,0,80,45
ANDHRA PRADESH,KADAPA,ALL SOCIAL GROUPS,ALL CLASSES,29,ATLUR,6007,5120,1606,3510,5116,0,0,0,0,5
ANDHRA PRADESH,KADAPA,ALL SOCIAL GROUPS,ALL CLASSES,30,VONTIMITTA,5126,4172,1854,1592,3446,0,484,0,484,241
ANDHRA PRADESH,KADAPA,ALL SOCIAL GROUPS,ALL CLASSES,31,SIDHOUT,4934,4180,2671,739,3410,0,34,428,462,308
ANDHRA PRADESH,KADAPA,ALL SOCIAL GROUPS,ALL CLASSES,32,CUDDAPAH,4639,3376,3029,347,3376,0,0,0,0,0
ANDHRA PRADESH,KADAPA,ALL SOCIAL GROUPS,ALL CLASSES,33,CHINTHAKOMMADINNE,7714,7523,7109,414,7523,0,0,0,0,0
ANDHRA PRADESH,KADAPA,ALL SOCIAL GROUPS,ALL CLASSES,34,PENDLIMARRI,9296,11588,9829,1759,11588,0,0,0,0,0
ANDHRA PRADESH,KADAPA,ALL SOCIAL GROUPS,ALL CLASSES,35,VEMPALLE,5996,10515,10190,316,10506,0,6,0,6,3
ANDHRA PRADESH,KADAPA,ALL SOCIAL GROUPS,ALL CLASSES,36,CHAKRAYAPET,7782,10825,8723,1600,10323,35,258,27,320,182
ANDHRA PRADESH,KADAPA,ALL SOCIAL GROUPS,ALL CLASSES,37,GALIVEEDU,10375,15147,8346,6090,14436,1,415,1,417,294
ANDHRA PRADESH,KADAPA,ALL SOCIAL GROUPS,ALL CLASSES,38,CHINNAMANDEM,7314,9315,8062,438,8500,0,489,18,507,308
ANDHRA PRADESH,KADAPA,ALL SOCIAL GROUPS,ALL CLASSES,39,SAMBEPALLE,10878,16058,13239,1056,14295,0,1046,87,1133,631
ANDHRA PRADESH,KADAPA,ALL SOCIAL GROUPS,ALL CLASSES,40,T SUNDUPALLE,12722,14128,6087,6967,13054,30,659,0,689,385
ANDHRA PRADESH,KADAPA,ALL SOCIAL GROUPS,ALL CLASSES,41,RAYACHOTI,9746,11920,5260,5390,10650,0,796,0,796,474
ANDHRA PRADESH,KADAPA,ALL SOCIAL GROUPS,ALL CLASSES,42,LAKKIREDDIPALLE,8968,12864,9870,2809,12679,0,37,0,37,149
ANDHRA PRADESH,KADAPA,ALL SOCIAL GROUPS,ALL CLASSES,43,RAMAPURAM,9007,12845,10708,1700,12408,0,280,0,280,157
ANDHRA PRADESH,KADAPA,ALL SOCIAL GROUPS,ALL CLASSES,44,VEERABALLE,7478,8749,6556,2156,8712,0,0,0,0,37
ANDHRA PRADESH,KADAPA,ALL SOCIAL GROUPS,ALL CLASSES,45,NANDALUR,4404,3189,1764,1382,3146,1,23,5,29,13
ANDHRA PRADESH,KADAPA,ALL SOCIAL GROUPS,ALL CLASSES,46,PENAGALUR,8149,6353,2184,3223,5407,13,620,1,634,312
ANDHRA PRADESH,KADAPA,ALL SOCIAL GROUPS,ALL CLASSES,47,CHITVEL,8599,7829,2827,4888,7715,0,71,0,71,42
ANDHRA PRADESH,KADAPA,ALL SOCIAL GROUPS,ALL CLASSES,48,RAJAMPET,11585,10023,4600,2999,7599,673,299,549,1521,903
ANDHRA PRADESH,KADAPA,ALL SOCIAL GROUPS,ALL CLASSES,49,PULLAMPETA,9007,9618,2836,3394,6230,2,2284,2,2288,1101
ANDHRA PRADESH,KADAPA,ALL SOCIAL GROUPS,ALL CLASSES,50,OBULAVARIPALLE,8478,9110,3748,3634,7382,0,1101,0,1101,626
ANDHRA PRADESH,KADAPA,ALL SOCIAL GROUPS,ALL CLASSES,51,KODUR,8731,9897,5428,4469,9897,0,0,0,0,0
ANDHRA PRADESH,KADAPA,INSTITUTIONAL,20.0 & ABOVE,1,KONDAPURAM,0,0,0,0,0,0,0,0,0,0
ANDHRA PRADESH,KADAPA,INSTITUTIONAL,20.0 & ABOVE,2,MYLAVARAM,0,0,0,0,0,0,0,0,0,0
ANDHRA PRADESH,KADAPA,INSTITUTIONAL,20.0 & ABOVE,3,PEDDAMUDIUM,0,0,0,0,0,0,0,0,0,0
ANDHRA PRADESH,KADAPA,INSTITUTIONAL,20.0 & ABOVE,4,RAJUPALEM,0,0,0,0,0,0,0,0,0,0
ANDHRA PRADESH,KADAPA,INSTITUTIONAL,20.0 & ABOVE,5,DUVVUR,0,0,0,0,0,0,0,0,0,0
ANDHRA PRADESH,KADAPA,INSTITUTIONAL,20.0 & ABOVE,6,S.MYDUKUR,1,282,141,141,282,0,0,0,0,0
ANDHRA PRADESH,KADAPA,INSTITUTIONAL,20.0 & ABOVE,7,BRAHMAMGARIMATTAM,0,0,0,0,0,0,0,0,0,0
ANDHRA PRADESH,KADAPA,INSTITUTIONAL,20.0 & ABOVE,8,SRI AVADHUTHA KASINAYANA,0,0,0,0,0,0,0,0,0,0
ANDHRA PRADESH,KADAPA,INSTITUTIONAL,20.0 & ABOVE,9,KALASAPADU,0,0,0,0,0,0,0,0,0,0
ANDHRA PRADESH,KADAPA,INSTITUTIONAL,20.0 & ABOVE,10,PORUMAMILLA,1,36,18,18,36,0,0,0,0,0
ANDHRA PRADESH,KADAPA,INSTITUTIONAL,20.0 & ABOVE,11,B.KODUR,0,0,0,0,0,0,0,0,0,0
ANDHRA PRADESH,KADAPA,INSTITUTIONAL,20.0 & ABOVE,12,BADVEL,1,174,87,87,174,0,0,0,0,0
ANDHRA PRADESH,KADAPA,INSTITUTIONAL,20.0 & ABOVE,13,GOPAVARAM,0,0,0,0,0,0,0,0,0,0
ANDHRA PRADESH,KADAPA,INSTITUTIONAL,20.0 & ABOVE,14,KHAJIPET,1,65,33,33,66,0,0,0,0,0
ANDHRA PRADESH,KADAPA,INSTITUTIONAL,20.0 & ABOVE,15,CHAPAD,0,0,0,0,0,0,0,0,0,0
ANDHRA PRADESH,KADAPA,INSTITUTIONAL,20.0 & ABOVE,16,PRODDATUR,0,0,0,0,0,0,0,0,0,0
ANDHRA PRADESH,KADAPA,INSTITUTIONAL,20.0 & ABOVE,17,JAMMALAMADUGU,0,0,0,0,0,0,0,0,0,0
ANDHRA PRADESH,KADAPA,INSTITUTIONAL,20.0 & ABOVE,18,MUDDANUR,0,0,0,0,0,0,0,0,0,0
ANDHRA PRADESH,KADAPA,INSTITUTIONAL,20.0 & ABOVE,19,SIMHADRIPURAM,0,0,0,0,0,0,0,0,0,0
ANDHRA PRADESH,KADAPA,INSTITUTIONAL,20.0 & ABOVE,20,LINGALA,0,0,0,0,0,0,0,0,0,0
ANDHRA PRADESH,KADAPA,INSTITUTIONAL,20.0 & ABOVE,21,PULIVENDLA,0,0,0,0,0,0,0,0,0,0
ANDHRA PRADESH,KADAPA,INSTITUTIONAL,20.0 & ABOVE,22,VEMULA,0,0,0,0,0,0,0,0,0,0
ANDHRA PRADESH,KADAPA,INSTITUTIONAL,20.0 & ABOVE,23,THONDUR,0,0,0,0,0,0,0,0,0,0
ANDHRA PRADESH,KADAPA,INSTITUTIONAL,20.0 & ABOVE,24,VEERAPUNAYUNIPALLE,0,0,0,0,0,0,0,0,0,0
ANDHRA PRADESH,KADAPA,INSTITUTIONAL,20.0 & ABOVE,25,YERRAGUNTLA,0,0,0,0,0,0,0,0,0,0
ANDHRA PRADESH,KADAPA,INSTITUTIONAL,20.0 & ABOVE,26,KAMALAPURAM,0,0,0,0,0,0,0,0,0,0
ANDHRA PRADESH,KADAPA,INSTITUTIONAL,20.0 & ABOVE,27,VALLUR,0,0,0,0,0,0,0,0,0,0
ANDHRA PRADESH,KADAPA,INSTITUTIONAL,20.0 & ABOVE,28,CHENNUR,0,0,0,0,0,0,0,0,0,0
ANDHRA PRADESH,KADAPA,INSTITUTIONAL,20.0 & ABOVE,29,ATLUR,0,0,0,0,0,0,0,0,0,0
ANDHRA PRADESH,KADAPA,INSTITUTIONAL,20.0 & ABOVE,30,VONTIMITTA,0,0,0,0,0,0,0,0,0,0
ANDHRA PRADESH,KADAPA,INSTITUTIONAL,20.0 & ABOVE,31,SIDHOUT,0,0,0,0,0,0,0,0,0,0
ANDHRA PRADESH,KADAPA,INSTITUTIONAL,20.0 & ABOVE,32,CUDDAPAH,0,0,0,0,0,0,0,0,0,0
ANDHRA PRADESH,KADAPA,INSTITUTIONAL,20.0 & ABOVE,33,CHINTHAKOMMADINNE,1,24,12,12,24,0,0,0,0,0
ANDHRA PRADESH,KADAPA,INSTITUTIONAL,20.0 & ABOVE,34,PENDLIMARRI,0,0,0,0,0,0,0,0,0,0
ANDHRA PRADESH,KADAPA,INSTITUTIONAL,20.0 & ABOVE,35,VEMPALLE,0,0,0,0,0,0,0,0,0,0
ANDHRA PRADESH,KADAPA,INSTITUTIONAL,20.0 & ABOVE,36,CHAKRAYAPET,0,0,0,0,0,0,0,0,0,0
ANDHRA PRADESH,KADAPA,INSTITUTIONAL,20.0 & ABOVE,37,GALIVEEDU,0,0,0,0,0,0,0,0,0,0
ANDHRA PRADESH,KADAPA,INSTITUTIONAL,20.0 & ABOVE,38,CHINNAMANDEM,0,0,0,0,0,0,0,0,0,0
ANDHRA PRADESH,KADAPA,INSTITUTIONAL,20.0 & ABOVE,39,SAMBEPALLE,0,0,0,0,0,0,0,0,0,0
ANDHRA PRADESH,KADAPA,INSTITUTIONAL,20.0 & ABOVE,40,T SUNDUPALLE,0,0,0,0,0,0,0,0,0,0
ANDHRA PRADESH,KADAPA,INSTITUTIONAL,20.0 & ABOVE,41,RAYACHOTI,0,0,0,0,0,0,0,0,0,0
ANDHRA PRADESH,KADAPA,INSTITUTIONAL,20.0 & ABOVE,42,LAKKIREDDIPALLE,0,0,0,0,0,0,0,0,0,0
ANDHRA PRADESH,KADAPA,INSTITUTIONAL,20.0 & ABOVE,43,RAMAPURAM,0,0,0,0,0,0,0,0,0,0
ANDHRA PRADESH,KADAPA,INSTITUTIONAL,20.0 & ABOVE,44,VEERABALLE,0,0,0,0,0,0,0,0,0,0
ANDHRA PRADESH,KADAPA,INSTITUTIONAL,20.0 & ABOVE,45,NANDALUR,0,0,0,0,0,0,0,0,0,0
ANDHRA PRADESH,KADAPA,INSTITUTIONAL,20.0 & ABOVE,46,PENAGALUR,0,0,0,0,0,0,0,0,0,0
ANDHRA PRADESH,KADAPA,INSTITUTIONAL,20.0 & ABOVE,47,CHITVEL,0,0,0,0,0,0,0,0,0,0
ANDHRA PRADESH,KADAPA,INSTITUTIONAL,20.0 & ABOVE,48,RAJAMPET,0,0,0,0,0,0,0,0,0,0
ANDHRA PRADESH,KADAPA,INSTITUTIONAL,20.0 & ABOVE,49,PULLAMPETA,0,0,0,0,0,0,0,0,0,0
ANDHRA PRADESH,KADAPA,INSTITUTIONAL,20.0 & ABOVE,50,OBULAVARIPALLE,0,0,0,0,0,0,0,0,0,0
ANDHRA PRADESH,KADAPA,INSTITUTIONAL,20.0 & ABOVE,51,KODUR,0,0,0,0,0,0,0,0,0,0
ANDHRA PRADESH,KADAPA,SCHEDULED CASTE,20.0 & ABOVE,1,KONDAPURAM,0,0,0,0,0,0,0,0,0,0
ANDHRA PRADESH,KADAPA,SCHEDULED CASTE,20.0 & ABOVE,2,MYLAVARAM,0,0,0,0,0,0,0,0,0,0
ANDHRA PRADESH,KADAPA,SCHEDULED CASTE,20.0 & ABOVE,3,PEDDAMUDIUM,1,24,12,12,24,0,0,0,0,0
ANDHRA PRADESH,KADAPA,SCHEDULED CASTE,20.0 & ABOVE,4,RAJUPALEM,0,0,0,0,0,0,0,0,0,0
ANDHRA PRADESH,KADAPA,SCHEDULED CASTE,20.0 & ABOVE,5,DUVVUR,0,0,0,0,0,0,0,0,0,0
ANDHRA PRADESH,KADAPA,SCHEDULED CASTE,20.0 & ABOVE,6,S.MYDUKUR,0,0,0,0,0,0,0,0,0,0
ANDHRA PRADESH,KADAPA,SCHEDULED CASTE,20.0 & ABOVE,7,BRAHMAMGARIMATTAM,0,0,0,0,0,0,0,0,0,0
ANDHRA PRADESH,KADAPA,SCHEDULED CASTE,20.0 & ABOVE,8,SRI AVADHUTHA KASINAYANA,0,0,0,0,0,0,0,0,0,0
ANDHRA PRADESH,KADAPA,SCHEDULED CASTE,20.0 & ABOVE,9,KALASAPADU,0,0,0,0,0,0,0,0,0,0
ANDHRA PRADESH,KADAPA,SCHEDULED CASTE,20.0 & ABOVE,10,PORUMAMILLA,0,0,0,0,0,0,0,0,0,0
ANDHRA PRADESH,KADAPA,SCHEDULED CASTE,20.0 & ABOVE,11,B.KODUR,0,0,0,0,0,0,0,0,0,0
ANDHRA PRADESH,KADAPA,SCHEDULED CASTE,20.0 & ABOVE,12,BADVEL,0,0,0,0,0,0,0,0,0,0
ANDHRA PRADESH,KADAPA,SCHEDULED CASTE,20.0 & ABOVE,13,GOPAVARAM,0,0,0,0,0,0,0,0,0,0
ANDHRA PRADESH,KADAPA,SCHEDULED CASTE,20.0 & ABOVE,14,KHAJIPET,0,0,0,0,0,0,0,0,0,0
ANDHRA PRADESH,KADAPA,SCHEDULED CASTE,20.0 & ABOVE,15,CHAPAD,0,0,0,0,0,0,0,0,0,0
ANDHRA PRADESH,KADAPA,SCHEDULED CASTE,20.0 & ABOVE,16,PRODDATUR,0,0,0,0,0,0,0,0,0,0
ANDHRA PRADESH,KADAPA,SCHEDULED CASTE,20.0 & ABOVE,17,JAMMALAMADUGU,0,0,0,0,0,0,0,0,0,0
ANDHRA PRADESH,KADAPA,SCHEDULED CASTE,20.0 & ABOVE,18,MUDDANUR,0,0,0,0,0,0,0,0,0,0
ANDHRA PRADESH,KADAPA,SCHEDULED CASTE,20.0 & ABOVE,19,SIMHADRIPURAM,0,0,0,0,0,0,0,0,0,0
ANDHRA PRADESH,KADAPA,SCHEDULED CASTE,20.0 & ABOVE,20,LINGALA,0,0,0,0,0,0,0,0,0,0
ANDHRA PRADESH,KADAPA,SCHEDULED CASTE,20.0 & ABOVE,21,PULIVENDLA,0,0,0,0,0,0,0,0,0,0
ANDHRA PRADESH,KADAPA,SCHEDULED CASTE,20.0 & ABOVE,22,VEMULA,0,0,0,0,0,0,0,0,0,0
ANDHRA PRADESH,KADAPA,SCHEDULED CASTE,20.0 & ABOVE,23,THONDUR,0,0,0,0,0,0,0,0,0,0
ANDHRA PRADESH,KADAPA,SCHEDULED CASTE,20.0 & ABOVE,24,VEERAPUNAYUNIPALLE,0,0,0,0,0,0,0,0,0,0
ANDHRA PRADESH,KADAPA,SCHEDULED CASTE,20.0 & ABOVE,25,YERRAGUNTLA,0,0,0,0,0,0,0,0,0,0
ANDHRA PRADESH,KADAPA,SCHEDULED CASTE,20.0 & ABOVE,26,KAMALAPURAM,0,0,0,0,0,0,0,0,0,0
ANDHRA PRADESH,KADAPA,SCHEDULED CASTE,20.0 & ABOVE,27,VALLUR,0,0,0,0,0,0,0,0,0,0
ANDHRA PRADESH,KADAPA,SCHEDULED CASTE,20.0 & ABOVE,28,CHENNUR,0,0,0,0,0,0,0,0,0,0
ANDHRA PRADESH,KADAPA,SCHEDULED CASTE,20.0 & ABOVE,29,ATLUR,0,0,0,0,0,0,0,0,0,0
ANDHRA PRADESH,KADAPA,SCHEDULED CASTE,20.0 & ABOVE,30,VONTIMITTA,0,0,0,0,0,0,0,0,0,0
ANDHRA PRADESH,KADAPA,SCHEDULED CASTE,20.0 & ABOVE,31,SIDHOUT,0,0,0,0,0,0,0,0,0,0
ANDHRA PRADESH,KADAPA,SCHEDULED CASTE,20.0 & ABOVE,32,CUDDAPAH,0,0,0,0,0,0,0,0,0,0
ANDHRA PRADESH,KADAPA,SCHEDULED CASTE,20.0 & ABOVE,33,CHINTHAKOMMADINNE,0,0,0,0,0,0,0,0,0,0
ANDHRA PRADESH,KADAPA,SCHEDULED CASTE,20.0 & ABOVE,34,PENDLIMARRI,0,0,0,0,0,0,0,0,0,0
ANDHRA PRADESH,KADAPA,SCHEDULED CASTE,20.0 & ABOVE,35,VEMPALLE,0,0,0,0,0,0,0,0,0,0
ANDHRA PRADESH,KADAPA,SCHEDULED CASTE,20.0 & ABOVE,36,CHAKRAYAPET,0,0,0,0,0,0,0,0,0,0
ANDHRA PRADESH,KADAPA,SCHEDULED CASTE,20.0 & ABOVE,37,GALIVEEDU,0,0,0,0,0,0,0,0,0,0
ANDHRA PRADESH,KADAPA,SCHEDULED CASTE,20.0 & ABOVE,38,CHINNAMANDEM,0,0,0,0,0,0,0,0,0,0
ANDHRA PRADESH,KADAPA,SCHEDULED CASTE,20.0 & ABOVE,39,SAMBEPALLE,0,0,0,0,0,0,0,0,0,0
ANDHRA PRADESH,KADAPA,SCHEDULED CASTE,20.0 & ABOVE,40,T SUNDUPALLE,0,0,0,0,0,0,0,0,0,0
ANDHRA PRADESH,KADAPA,SCHEDULED CASTE,20.0 & ABOVE,41,RAYACHOTI,0,0,0,0,0,0,0,0,0,0
ANDHRA PRADESH,KADAPA,SCHEDULED CASTE,20.0 & ABOVE,42,LAKKIREDDIPALLE,0,0,0,0,0,0,0,0,0,0
ANDHRA PRADESH,KADAPA,SCHEDULED CASTE,20.0 & ABOVE,43,RAMAPURAM,0,0,0,0,0,0,0,0,0,0
ANDHRA PRADESH,KADAPA,SCHEDULED CASTE,20.0 & ABOVE,44,VEERABALLE,0,0,0,0,0,0,0,0,0,0
ANDHRA PRADESH,KADAPA,SCHEDULED CASTE,20.0 & ABOVE,45,NANDALUR,0,0,0,0,0,0,0,0,0,0
ANDHRA PRADESH,KADAPA,SCHEDULED CASTE,20.0 & ABOVE,46,PENAGALUR,0,0,0,0,0,0,0,0,0,0
ANDHRA PRADESH,KADAPA,SCHEDULED CASTE,20.0 & ABOVE,47,CHITVEL,0,0,0,0,0,0,0,0,0,0
ANDHRA PRADESH,KADAPA,SCHEDULED CASTE,20.0 & ABOVE,48,RAJAMPET,0,0,0,0,0,0,0,0,0,0
ANDHRA PRADESH,KADAPA,SCHEDULED CASTE,20.0 & ABOVE,49,PULLAMPETA,0,0,0,0,0,0,0,0,0,0
ANDHRA PRADESH,KADAPA,SCHEDULED CASTE,20.0 & ABOVE,50,OBULAVARIPALLE,0,0,0,0,0,0,0,0,0,0
ANDHRA PRADESH,KADAPA,SCHEDULED CASTE,20.0 & ABOVE,51,KODUR,0,0,0,0,0,0,0,0,0,0
ANDHRA PRADESH,KADAPA,OTHERS,20.0 & ABOVE,1,KONDAPURAM,1,20,6,14,20,0,0,0,0,0
ANDHRA PRADESH,KADAPA,OTHERS,20.0 & ABOVE,2,MYLAVARAM,2,48,24,24,48,0,0,0,0,0
ANDHRA PRADESH,KADAPA,OTHERS,20.0 & ABOVE,3,PEDDAMUDIUM,1,21,11,11,22,0,0,0,0,0
ANDHRA PRADESH,KADAPA,OTHERS,20.0 & ABOVE,4,RAJUPALEM,2,54,51,2,53,0,0,0,0,0
ANDHRA PRADESH,KADAPA,OTHERS,20.0 & ABOVE,5,DUVVUR,0,0,0,0,0,0,0,0,0,0
ANDHRA PRADESH,KADAPA,OTHERS,20.0 & ABOVE,6,S.MYDUKUR,0,0,0,0,0,0,0,0,0,0
ANDHRA PRADESH,KADAPA,OTHERS,20.0 & ABOVE,7,BRAHMAMGARIMATTAM,0,0,0,0,0,0,0,0,0,0
ANDHRA PRADESH,KADAPA,OTHERS,20.0 & ABOVE,8,SRI AVADHUTHA KASINAYANA,0,0,0,0,0,0,0,0,0,0
ANDHRA PRADESH,KADAPA,OTHERS,20.0 & ABOVE,9,KALASAPADU,0,0,0,0,0,0,0,0,0,0
ANDHRA PRADESH,KADAPA,OTHERS,20.0 & ABOVE,10,PORUMAMILLA,0,0,0,0,0,0,0,0,0,0
ANDHRA PRADESH,KADAPA,OTHERS,20.0 & ABOVE,11,B.KODUR,2,45,23,23,46,0,0,0,0,0
ANDHRA PRADESH,KADAPA,OTHERS,20.0 & ABOVE,12,BADVEL,0,0,0,0,0,0,0,0,0,0
ANDHRA PRADESH,KADAPA,OTHERS,20.0 & ABOVE,13,GOPAVARAM,2,54,27,27,54,0,0,0,0,0
ANDHRA PRADESH,KADAPA,OTHERS,20.0 & ABOVE,14,KHAJIPET,0,0,0,0,0,0,0,0,0,0
ANDHRA PRADESH,KADAPA,OTHERS,20.0 & ABOVE,15,CHAPAD,0,0,0,0,0,0,0,0,0,0
ANDHRA PRADESH,KADAPA,OTHERS,20.0 & ABOVE,16,PRODDATUR,2,97,48,48,96,0,0,0,0,0
ANDHRA PRADESH,KADAPA,OTHERS,20.0 & ABOVE,17,JAMMALAMADUGU,0,0,0,0,0,0,0,0,0,0
ANDHRA PRADESH,KADAPA,OTHERS,20.0 & ABOVE,18,MUDDANUR,2,47,23,23,46,0,0,0,0,0
ANDHRA PRADESH,KADAPA,OTHERS,20.0 & ABOVE,19,SIMHADRIPURAM,2,44,22,22,44,0,0,0,0,0
ANDHRA PRADESH,KADAPA,OTHERS,20.0 & ABOVE,20,LINGALA,4,103,103,0,103,0,0,0,0,0
ANDHRA PRADESH,KADAPA,OTHERS,20.0 & ABOVE,21,PULIVENDLA,0,0,0,0,0,0,0,0,0,0
ANDHRA PRADESH,KADAPA,OTHERS,20.0 & ABOVE,22,VEMULA,0,0,0,0,0,0,0,0,0,0
ANDHRA PRADESH,KADAPA,OTHERS,20.0 & ABOVE,23,THONDUR,0,0,0,0,0,0,0,0,0,0
ANDHRA PRADESH,KADAPA,OTHERS,20.0 & ABOVE,24,VEERAPUNAYUNIPALLE,1,27,13,13,26,0,0,0,0,0
ANDHRA PRADESH,KADAPA,OTHERS,20.0 & ABOVE,25,YERRAGUNTLA,2,61,30,30,60,0,0,0,0,0
ANDHRA PRADESH,KADAPA,OTHERS,20.0 & ABOVE,26,KAMALAPURAM,0,0,0,0,0,0,0,0,0,0
ANDHRA PRADESH,KADAPA,OTHERS,20.0 & ABOVE,27,VALLUR,0,0,0,0,0,0,0,0,0,0
ANDHRA PRADESH,KADAPA,OTHERS,20.0 & ABOVE,28,CHENNUR,0,0,0,0,0,0,0,0,0,0
ANDHRA PRADESH,KADAPA,OTHERS,20.0 & ABOVE,29,ATLUR,0,0,0,0,0,0,0,0,0,0
ANDHRA PRADESH,KADAPA,OTHERS,20.0 & ABOVE,30,VONTIMITTA,0,0,0,0,0,0,0,0,0,0
ANDHRA PRADESH,KADAPA,OTHERS,20.0 & ABOVE,31,SIDHOUT,0,0,0,0,0,0,0,0,0,0
ANDHRA PRADESH,KADAPA,OTHERS,20.0 & ABOVE,32,CUDDAPAH,0,0,0,0,0,0,0,0,0,0
ANDHRA PRADESH,KADAPA,OTHERS,20.0 & ABOVE,33,CHINTHAKOMMADINNE,0,0,0,0,0,0,0,0,0,0
ANDHRA PRADESH,KADAPA,OTHERS,20.0 & ABOVE,34,PENDLIMARRI,0,0,0,0,0,0,0,0,0,0
ANDHRA PRADESH,KADAPA,OTHERS,20.0 & ABOVE,35,VEMPALLE,0,0,0,0,0,0,0,0,0,0
ANDHRA PRADESH,KADAPA,OTHERS,20.0 & ABOVE,36,CHAKRAYAPET,3,110,55,55,110,0,0,0,0,0
ANDHRA PRADESH,KADAPA,OTHERS,20.0 & ABOVE,37,GALIVEEDU,2,40,20,20,40,0,0,0,0,0
ANDHRA PRADESH,KADAPA,OTHERS,20.0 & ABOVE,38,CHINNAMANDEM,1,20,10,10,20,0,0,0,0,0
ANDHRA PRADESH,KADAPA,OTHERS,20.0 & ABOVE,39,SAMBEPALLE,1,25,12,12,24,0,0,0,0,0
ANDHRA PRADESH,KADAPA,OTHERS,20.0 & ABOVE,40,T SUNDUPALLE,3,74,37,37,74,0,0,0,0,0
ANDHRA PRADESH,KADAPA,OTHERS,20.0 & ABOVE,41,RAYACHOTI,2,42,21,21,42,0,0,0,0,0
ANDHRA PRADESH,KADAPA,OTHERS,20.0 & ABOVE,42,LAKKIREDDIPALLE,0,0,0,0,0,0,0,0,0,0
ANDHRA PRADESH,KADAPA,OTHERS,20.0 & ABOVE,43,RAMAPURAM,0,0,0,0,0,0,0,0,0,0
ANDHRA PRADESH,KADAPA,OTHERS,20.0 & ABOVE,44,VEERABALLE,0,0,0,0,0,0,0,0,0,0
ANDHRA PRADESH,KADAPA,OTHERS,20.0 & ABOVE,45,NANDALUR,0,0,0,0,0,0,0,0,0,0
ANDHRA PRADESH,KADAPA,OTHERS,20.0 & ABOVE,46,PENAGALUR,0,0,0,0,0,0,0,0,0,0
ANDHRA PRADESH,KADAPA,OTHERS,20.0 & ABOVE,47,CHITVEL,1,23,11,11,22,0,0,0,0,0
ANDHRA PRADESH,KADAPA,OTHERS,20.0 & ABOVE,48,RAJAMPET,0,0,0,0,0,0,0,0,0,0
ANDHRA PRADESH,KADAPA,OTHERS,20.0 & ABOVE,49,PULLAMPETA,3,160,80,80,160,0,0,0,0,0
ANDHRA PRADESH,KADAPA,OTHERS,20.0 & ABOVE,50,OBULAVARIPALLE,1,334,33,0,33,0,192,0,192,109
ANDHRA PRADESH,KADAPA,OTHERS,20.0 & ABOVE,51,KODUR,3,261,130,130,260,0,0,0,0,0
ANDHRA PRADESH,KADAPA,SCHEDULED TRIBES,20.0 & ABOVE,1,KONDAPURAM,0,0,0,0,0,0,0,0,0,0
ANDHRA PRADESH,KADAPA,SCHEDULED TRIBES,20.0 & ABOVE,2,MYLAVARAM,0,0,0,0,0,0,0,0,0,0
ANDHRA PRADESH,KADAPA,SCHEDULED TRIBES,20.0 & ABOVE,3,PEDDAMUDIUM,0,0,0,0,0,0,0,0,0,0
ANDHRA PRADESH,KADAPA,SCHEDULED TRIBES,20.0 & ABOVE,4,RAJUPALEM,0,0,0,0,0,0,0,0,0,0
ANDHRA PRADESH,KADAPA,SCHEDULED TRIBES,20.0 & ABOVE,5,DUVVUR,0,0,0,0,0,0,0,0,0,0
ANDHRA PRADESH,KADAPA,SCHEDULED TRIBES,20.0 & ABOVE,6,S.MYDUKUR,0,0,0,0,0,0,0,0,0,0
ANDHRA PRADESH,KADAPA,SCHEDULED TRIBES,20.0 & ABOVE,7,BRAHMAMGARIMATTAM,0,0,0,0,0,0,0,0,0,0
ANDHRA PRADESH,KADAPA,SCHEDULED TRIBES,20.0 & ABOVE,8,SRI AVADHUTHA KASINAYANA,0,0,0,0,0,0,0,0,0,0
ANDHRA PRADESH,KADAPA,SCHEDULED TRIBES,20.0 & ABOVE,9,KALASAPADU,0,0,0,0,0,0,0,0,0,0
ANDHRA PRADESH,KADAPA,SCHEDULED TRIBES,20.0 & ABOVE,10,PORUMAMILLA,0,0,0,0,0,0,0,0,0,0
ANDHRA PRADESH,KADAPA,SCHEDULED TRIBES,20.0 & ABOVE,11,B.KODUR,0,0,0,0,0,0,0,0,0,0
ANDHRA PRADESH,KADAPA,SCHEDULED TRIBES,20.0 & ABOVE,12,BADVEL,0,0,0,0,0,0,0,0,0,0
ANDHRA PRADESH,KADAPA,SCHEDULED TRIBES,20.0 & ABOVE,13,GOPAVARAM,0,0,0,0,0,0,0,0,0,0
ANDHRA PRADESH,KADAPA,SCHEDULED TRIBES,20.0 & ABOVE,14,KHAJIPET,0,0,0,0,0,0,0,0,0,0
ANDHRA PRADESH,KADAPA,SCHEDULED TRIBES,20.0 & ABOVE,15,CHAPAD,0,0,0,0,0,0,0,0,0,0
ANDHRA PRADESH,KADAPA,SCHEDULED TRIBES,20.0 & ABOVE,16,PRODDATUR,0,0,0,0,0,0,0,0,0,0
ANDHRA PRADESH,KADAPA,SCHEDULED TRIBES,20.0 & ABOVE,17,JAMMALAMADUGU,0,0,0,0,0,0,0,0,0,0
ANDHRA PRADESH,KADAPA,SCHEDULED TRIBES,20.0 & ABOVE,18,MUDDANUR,0,0,0,0,0,0,0,0,0,0
ANDHRA PRADESH,KADAPA,SCHEDULED TRIBES,20.0 & ABOVE,19,SIMHADRIPURAM,0,0,0,0,0,0,0,0,0,0
ANDHRA PRADESH,KADAPA,SCHEDULED TRIBES,20.0 & ABOVE,20,LINGALA,0,0,0,0,0,0,0,0,0,0
ANDHRA PRADESH,KADAPA,SCHEDULED TRIBES,20.0 & ABOVE,21,PULIVENDLA,0,0,0,0,0,0,0,0,0,0
ANDHRA PRADESH,KADAPA,SCHEDULED TRIBES,20.0 & ABOVE,22,VEMULA,0,0,0,0,0,0,0,0,0,0
ANDHRA PRADESH,KADAPA,SCHEDULED TRIBES,20.0 & ABOVE,23,THONDUR,0,0,0,0,0,0,0,0,0,0
ANDHRA PRADESH,KADAPA,SCHEDULED TRIBES,20.0 & ABOVE,24,VEERAPUNAYUNIPALLE,0,0,0,0,0,0,0,0,0,0
ANDHRA PRADESH,KADAPA,SCHEDULED TRIBES,20.0 & ABOVE,25,YERRAGUNTLA,0,0,0,0,0,0,0,0,0,0
ANDHRA PRADESH,KADAPA,SCHEDULED TRIBES,20.0 & ABOVE,26,KAMALAPURAM,0,0,0,0,0,0,0,0,0,0
ANDHRA PRADESH,KADAPA,SCHEDULED TRIBES,20.0 & ABOVE,27,VALLUR,0,0,0,0,0,0,0,0,0,0
ANDHRA PRADESH,KADAPA,SCHEDULED TRIBES,20.0 & ABOVE,28,CHENNUR,0,0,0,0,0,0,0,0,0,0
ANDHRA PRADESH,KADAPA,SCHEDULED TRIBES,20.0 & ABOVE,29,ATLUR,0,0,0,0,0,0,0,0,0,0
ANDHRA PRADESH,KADAPA,SCHEDULED TRIBES,20.0 & ABOVE,30,VONTIMITTA,0,0,0,0,0,0,0,0,0,0
ANDHRA PRADESH,KADAPA,SCHEDULED TRIBES,20.0 & ABOVE,31,SIDHOUT,0,0,0,0,0,0,0,0,0,0
ANDHRA PRADESH,KADAPA,SCHEDULED TRIBES,20.0 & ABOVE,32,CUDDAPAH,0,0,0,0,0,0,0,0,0,0
ANDHRA PRADESH,KADAPA,SCHEDULED TRIBES,20.0 & ABOVE,33,CHINTHAKOMMADINNE,0,0,0,0,0,0,0,0,0,0
ANDHRA PRADESH,KADAPA,SCHEDULED TRIBES,20.0 & ABOVE,34,PENDLIMARRI,0,0,0,0,0,0,0,0,0,0
ANDHRA PRADESH,KADAPA,SCHEDULED TRIBES,20.0 & ABOVE,35,VEMPALLE,0,0,0,0,0,0,0,0,0,0
ANDHRA PRADESH,KADAPA,SCHEDULED TRIBES,20.0 & ABOVE,36,CHAKRAYAPET,0,0,0,0,0,0,0,0,0,0
ANDHRA PRADESH,KADAPA,SCHEDULED TRIBES,20.0 & ABOVE,37,GALIVEEDU,0,0,0,0,0,0,0,0,0,0
ANDHRA PRADESH,KADAPA,SCHEDULED TRIBES,20.0 & ABOVE,38,CHINNAMANDEM,0,0,0,0,0,0,0,0,0,0
ANDHRA PRADESH,KADAPA,SCHEDULED TRIBES,20.0 & ABOVE,39,SAMBEPALLE,0,0,0,0,0,0,0,0,0,0
ANDHRA PRADESH,KADAPA,SCHEDULED TRIBES,20.0 & ABOVE,40,T SUNDUPALLE,0,0,0,0,0,0,0,0,0,0
ANDHRA PRADESH,KADAPA,SCHEDULED TRIBES,20.0 & ABOVE,41,RAYACHOTI,0,0,0,0,0,0,0,0,0,0
ANDHRA PRADESH,KADAPA,SCHEDULED TRIBES,20.0 & ABOVE,42,LAKKIREDDIPALLE,0,0,0,0,0,0,0,0,0,0
ANDHRA PRADESH,KADAPA,SCHEDULED TRIBES,20.0 & ABOVE,43,RAMAPURAM,0,0,0,0,0,0,0,0,0,0
ANDHRA PRADESH,KADAPA,SCHEDULED TRIBES,20.0 & ABOVE,44,VEERABALLE,0,0,0,0,0,0,0,0,0,0
ANDHRA PRADESH,KADAPA,SCHEDULED TRIBES,20.0 & ABOVE,45,NANDALUR,0,0,0,0,0,0,0,0,0,0
ANDHRA PRADESH,KADAPA,SCHEDULED TRIBES,20.0 & ABOVE,46,PENAGALUR,0,0,0,0,0,0,0,0,0,0
ANDHRA PRADESH,KADAPA,SCHEDULED TRIBES,20.0 & ABOVE,47,CHITVEL,0,0,0,0,0,0,0,0,0,0
ANDHRA PRADESH,KADAPA,SCHEDULED TRIBES,20.0 & ABOVE,48,RAJAMPET,0,0,0,0,0,0,0,0,0,0
ANDHRA PRADESH,KADAPA,SCHEDULED TRIBES,20.0 & ABOVE,49,PULLAMPETA,0,0,0,0,0,0,0,0,0,0
ANDHRA PRADESH,KADAPA,SCHEDULED TRIBES,20.0 & ABOVE,50,OBULAVARIPALLE,0,0,0,0,0,0,0,0,0,0
ANDHRA PRADESH,KADAPA,SCHEDULED TRIBES,20.0 & ABOVE,51,KODUR,1,41,0,41,41,0,0,0,0,0
ANDHRA PRADESH,KADAPA,ALL SOCIAL GROUPS,20.0 & ABOVE,1,KONDAPURAM,1,20,6,14,20,0,0,0,0,0
ANDHRA PRADESH,KADAPA,ALL SOCIAL GROUPS,20.0 & ABOVE,2,MYLAVARAM,2,48,24,24,48,0,0,0,0,0
ANDHRA PRADESH,KADAPA,ALL SOCIAL GROUPS,20.0 & ABOVE,3,PEDDAMUDIUM,2,46,23,23,46,0,0,0,0,0
ANDHRA PRADESH,KADAPA,ALL SOCIAL GROUPS,20.0 & ABOVE,4,RAJUPALEM,2,54,51,2,53,0,0,0,0,0
ANDHRA PRADESH,KADAPA,ALL SOCIAL GROUPS,20.0 & ABOVE,5,DUVVUR,0,0,0,0,0,0,0,0,0,0
ANDHRA PRADESH,KADAPA,ALL SOCIAL GROUPS,20.0 & ABOVE,6,S.MYDUKUR,1,282,141,141,282,0,0,0,0,0
ANDHRA PRADESH,KADAPA,ALL SOCIAL GROUPS,20.0 & ABOVE,7,BRAHMAMGARIMATTAM,0,0,0,0,0,0,0,0,0,0
ANDHRA PRADESH,KADAPA,ALL SOCIAL GROUPS,20.0 & ABOVE,8,SRI AVADHUTHA KASINAYANA,0,0,0,0,0,0,0,0,0,0
ANDHRA PRADESH,KADAPA,ALL SOCIAL GROUPS,20.0 & ABOVE,9,KALASAPADU,0,0,0,0,0,0,0,0,0,0
ANDHRA PRADESH,KADAPA,ALL SOCIAL GROUPS,20.0 & ABOVE,10,PORUMAMILLA,1,36,18,18,36,0,0,0,0,0
ANDHRA PRADESH,KADAPA,ALL SOCIAL GROUPS,20.0 & ABOVE,11,B.KODUR,2,45,23,23,46,0,0,0,0,0
ANDHRA PRADESH,KADAPA,ALL SOCIAL GROUPS,20.0 & ABOVE,12,BADVEL,1,174,87,87,174,0,0,0,0,0
ANDHRA PRADESH,KADAPA,ALL SOCIAL GROUPS,20.0 & ABOVE,13,GOPAVARAM,2,54,27,27,54,0,0,0,0,0
ANDHRA PRADESH,KADAPA,ALL SOCIAL GROUPS,20.0 & ABOVE,14,KHAJIPET,1,65,33,33,66,0,0,0,0,0
ANDHRA PRADESH,KADAPA,ALL SOCIAL GROUPS,20.0 & ABOVE,15,CHAPAD,0,0,0,0,0,0,0,0,0,0
ANDHRA PRADESH,KADAPA,ALL SOCIAL GROUPS,20.0 & ABOVE,16,PRODDATUR,2,97,48,48,96,0,0,0,0,0
ANDHRA PRADESH,KADAPA,ALL SOCIAL GROUPS,20.0 & ABOVE,17,JAMMALAMADUGU,0,0,0,0,0,0,0,0,0,0
ANDHRA PRADESH,KADAPA,ALL SOCIAL GROUPS,20.0 & ABOVE,18,MUDDANUR,2,47,23,23,46,0,0,0,0,0
ANDHRA PRADESH,KADAPA,ALL SOCIAL GROUPS,20.0 & ABOVE,19,SIMHADRIPURAM,2,44,22,22,44,0,0,0,0,0
ANDHRA PRADESH,KADAPA,ALL SOCIAL GROUPS,20.0 & ABOVE,20,LINGALA,4,103,103,0,103,0,0,0,0,0
ANDHRA PRADESH,KADAPA,ALL SOCIAL GROUPS,20.0 & ABOVE,21,PULIVENDLA,0,0,0,0,0,0,0,0,0,0
ANDHRA PRADESH,KADAPA,ALL SOCIAL GROUPS,20.0 & ABOVE,22,VEMULA,0,0,0,0,0,0,0,0,0,0
ANDHRA PRADESH,KADAPA,ALL SOCIAL GROUPS,20.0 & ABOVE,23,THONDUR,0,0,0,0,0,0,0,0,0,0
ANDHRA PRADESH,KADAPA,ALL SOCIAL GROUPS,20.0 & ABOVE,24,VEERAPUNAYUNIPALLE,1,27,13,13,26,0,0,0,0,0
ANDHRA PRADESH,KADAPA,ALL SOCIAL GROUPS,20.0 & ABOVE,25,YERRAGUNTLA,2,61,30,30,60,0,0,0,0,0
ANDHRA PRADESH,KADAPA,ALL SOCIAL GROUPS,20.0 & ABOVE,26,KAMALAPURAM,0,0,0,0,0,0,0,0,0,0
ANDHRA PRADESH,KADAPA,ALL SOCIAL GROUPS,20.0 & ABOVE,27,VALLUR,0,0,0,0,0,0,0,0,0,0
ANDHRA PRADESH,KADAPA,ALL SOCIAL GROUPS,20.0 & ABOVE,28,CHENNUR,0,0,0,0,0,0,0,0,0,0
ANDHRA PRADESH,KADAPA,ALL SOCIAL GROUPS,20.0 & ABOVE,29,ATLUR,0,0,0,0,0,0,0,0,0,0
ANDHRA PRADESH,KADAPA,ALL SOCIAL GROUPS,20.0 & ABOVE,30,VONTIMITTA,0,0,0,0,0,0,0,0,0,0
ANDHRA PRADESH,KADAPA,ALL SOCIAL GROUPS,20.0 & ABOVE,31,SIDHOUT,0,0,0,0,0,0,0,0,0,0
ANDHRA PRADESH,KADAPA,ALL SOCIAL GROUPS,20.0 & ABOVE,32,CUDDAPAH,0,0,0,0,0,0,0,0,0,0
ANDHRA PRADESH,KADAPA,ALL SOCIAL GROUPS,20.0 & ABOVE,33,CHINTHAKOMMADINNE,1,24,12,12,24,0,0,0,0,0
ANDHRA PRADESH,KADAPA,ALL SOCIAL GROUPS,20.0 & ABOVE,34,PENDLIMARRI,0,0,0,0,0,0,0,0,0,0
ANDHRA PRADESH,KADAPA,ALL SOCIAL GROUPS,20.0 & ABOVE,35,VEMPALLE,0,0,0,0,0,0,0,0,0,0
ANDHRA PRADESH,KADAPA,ALL SOCIAL GROUPS,20.0 & ABOVE,36,CHAKRAYAPET,3,110,55,55,110,0,0,0,0,0
ANDHRA PRADESH,KADAPA,ALL SOCIAL GROUPS,20.0 & ABOVE,37,GALIVEEDU,2,40,20,20,40,0,0,0,0,0
ANDHRA PRADESH,KADAPA,ALL SOCIAL GROUPS,20.0 & ABOVE,38,CHINNAMANDEM,1,20,10,10,20,0,0,0,0,0
ANDHRA PRADESH,KADAPA,ALL SOCIAL GROUPS,20.0 & ABOVE,39,SAMBEPALLE,1,25,12,12,24,0,0,0,0,0
ANDHRA PRADESH,KADAPA,ALL SOCIAL GROUPS,20.0 & ABOVE,40,T SUNDUPALLE,3,74,37,37,74,0,0,0,0,0
ANDHRA PRADESH,KADAPA,ALL SOCIAL GROUPS,20.0 & ABOVE,41,RAYACHOTI,2,42,21,21,42,0,0,0,0,0
ANDHRA PRADESH,KADAPA,ALL SOCIAL GROUPS,20.0 & ABOVE,42,LAKKIREDDIPALLE,0,0,0,0,0,0,0,0,0,0
ANDHRA PRADESH,KADAPA,ALL SOCIAL GROUPS,20.0 & ABOVE,43,RAMAPURAM,0,0,0,0,0,0,0,0,0,0
ANDHRA PRADESH,KADAPA,ALL SOCIAL GROUPS,20.0 & ABOVE,44,VEERABALLE,0,0,0,0,0,0,0,0,0,0
ANDHRA PRADESH,KADAPA,ALL SOCIAL GROUPS,20.0 & ABOVE,45,NANDALUR,0,0,0,0,0,0,0,0,0,0
ANDHRA PRADESH,KADAPA,ALL SOCIAL GROUPS,20.0 & ABOVE,46,PENAGALUR,0,0,0,0,0,0,0,0,0,0
ANDHRA PRADESH,KADAPA,ALL SOCIAL GROUPS,20.0 & ABOVE,47,CHITVEL,1,23,11,11,22,0,0,0,0,0
ANDHRA PRADESH,KADAPA,ALL SOCIAL GROUPS,20.0 & ABOVE,48,RAJAMPET,0,0,0,0,0,0,0,0,0,0
ANDHRA PRADESH,KADAPA,ALL SOCIAL GROUPS,20.0 & ABOVE,49,PULLAMPETA,3,160,80,80,160,0,0,0,0,0
ANDHRA PRADESH,KADAPA,ALL SOCIAL GROUPS,20.0 & ABOVE,50,OBULAVARIPALLE,1,334,33,0,33,0,192,0,192,109
ANDHRA PRADESH,KADAPA,ALL SOCIAL GROUPS,20.0 & ABOVE,51,KODUR,4,302,130,171,301,0,0,0,0,0
ANDHRA PRADESH,KADAPA,INSTITUTIONAL,Below 0.5,1,KONDAPURAM,0,0,0,0,0,0,0,0,0,0
ANDHRA PRADESH,KADAPA,INSTITUTIONAL,Below 0.5,2,MYLAVARAM,0,0,0,0,0,0,0,0,0,0
ANDHRA PRADESH,KADAPA,INSTITUTIONAL,Below 0.5,3,PEDDAMUDIUM,0,0,0,0,0,0,0,0,0,0
ANDHRA PRADESH,KADAPA,INSTITUTIONAL,Below 0.5,4,RAJUPALEM,0,0,0,0,0,0,0,0,0,0
ANDHRA PRADESH,KADAPA,INSTITUTIONAL,Below 0.5,5,DUVVUR,0,0,0,0,0,0,0,0,0,0
ANDHRA PRADESH,KADAPA,INSTITUTIONAL,Below 0.5,6,S.MYDUKUR,0,0,0,0,0,0,0,0,0,0
ANDHRA PRADESH,KADAPA,INSTITUTIONAL,Below 0.5,7,BRAHMAMGARIMATTAM,0,0,0,0,0,0,0,0,0,0
ANDHRA PRADESH,KADAPA,INSTITUTIONAL,Below 0.5,8,SRI AVADHUTHA KASINAYANA,0,0,0,0,0,0,0,0,0,0
ANDHRA PRADESH,KADAPA,INSTITUTIONAL,Below 0.5,9,KALASAPADU,0,0,0,0,0,0,0,0,0,0
ANDHRA PRADESH,KADAPA,INSTITUTIONAL,Below 0.5,10,PORUMAMILLA,1,0,0,0,0,0,0,0,0,0
ANDHRA PRADESH,KADAPA,INSTITUTIONAL,Below 0.5,11,B.KODUR,0,0,0,0,0,0,0,0,0,0
ANDHRA PRADESH,KADAPA,INSTITUTIONAL,Below 0.5,12,BADVEL,0,0,0,0,0,0,0,0,0,0
ANDHRA PRADESH,KADAPA,INSTITUTIONAL,Below 0.5,13,GOPAVARAM,0,0,0,0,0,0,0,0,0,0
ANDHRA PRADESH,KADAPA,INSTITUTIONAL,Below 0.5,14,KHAJIPET,0,0,0,0,0,0,0,0,0,0
ANDHRA PRADESH,KADAPA,INSTITUTIONAL,Below 0.5,15,CHAPAD,0,0,0,0,0,0,0,0,0,0
ANDHRA PRADESH,KADAPA,INSTITUTIONAL,Below 0.5,16,PRODDATUR,1,0,0,0,0,0,0,0,0,0
ANDHRA PRADESH,KADAPA,INSTITUTIONAL,Below 0.5,17,JAMMALAMADUGU,0,0,0,0,0,0,0,0,0,0
ANDHRA PRADESH,KADAPA,INSTITUTIONAL,Below 0.5,18,MUDDANUR,0,0,0,0,0,0,0,0,0,0
ANDHRA PRADESH,KADAPA,INSTITUTIONAL,Below 0.5,19,SIMHADRIPURAM,0,0,0,0,0,0,0,0,0,0
ANDHRA PRADESH,KADAPA,INSTITUTIONAL,Below 0.5,20,LINGALA,0,0,0,0,0,0,0,0,0,0
ANDHRA PRADESH,KADAPA,INSTITUTIONAL,Below 0.5,21,PULIVENDLA,0,0,0,0,0,0,0,0,0,0
ANDHRA PRADESH,KADAPA,INSTITUTIONAL,Below 0.5,22,VEMULA,0,0,0,0,0,0,0,0,0,0
ANDHRA PRADESH,KADAPA,INSTITUTIONAL,Below 0.5,23,THONDUR,0,0,0,0,0,0,0,0,0,0
ANDHRA PRADESH,KADAPA,INSTITUTIONAL,Below 0.5,24,VEERAPUNAYUNIPALLE,0,0,0,0,0,0,0,0,0,0
ANDHRA PRADESH,KADAPA,INSTITUTIONAL,Below 0.5,25,YERRAGUNTLA,0,0,0,0,0,0,0,0,0,0
ANDHRA PRADESH,KADAPA,INSTITUTIONAL,Below 0.5,26,KAMALAPURAM,0,0,0,0,0,0,0,0,0,0
ANDHRA PRADESH,KADAPA,INSTITUTIONAL,Below 0.5,27,VALLUR,0,0,0,0,0,0,0,0,0,0
ANDHRA PRADESH,KADAPA,INSTITUTIONAL,Below 0.5,28,CHENNUR,0,0,0,0,0,0,0,0,0,0
ANDHRA PRADESH,KADAPA,INSTITUTIONAL,Below 0.5,29,ATLUR,0,0,0,0,0,0,0,0,0,0
ANDHRA PRADESH,KADAPA,INSTITUTIONAL,Below 0.5,30,VONTIMITTA,0,0,0,0,0,0,0,0,0,0
ANDHRA PRADESH,KADAPA,INSTITUTIONAL,Below 0.5,31,SIDHOUT,0,0,0,0,0,0,0,0,0,0
ANDHRA PRADESH,KADAPA,INSTITUTIONAL,Below 0.5,32,CUDDAPAH,0,0,0,0,0,0,0,0,0,0
ANDHRA PRADESH,KADAPA,INSTITUTIONAL,Below 0.5,33,CHINTHAKOMMADINNE,0,0,0,0,0,0,0,0,0,0
ANDHRA PRADESH,KADAPA,INSTITUTIONAL,Below 0.5,34,PENDLIMARRI,0,0,0,0,0,0,0,0,0,0
ANDHRA PRADESH,KADAPA,INSTITUTIONAL,Below 0.5,35,VEMPALLE,0,0,0,0,0,0,0,0,0,0
ANDHRA PRADESH,KADAPA,INSTITUTIONAL,Below 0.5,36,CHAKRAYAPET,0,0,0,0,0,0,0,0,0,0
ANDHRA PRADESH,KADAPA,INSTITUTIONAL,Below 0.5,37,GALIVEEDU,0,0,0,0,0,0,0,0,0,0
ANDHRA PRADESH,KADAPA,INSTITUTIONAL,Below 0.5,38,CHINNAMANDEM,0,0,0,0,0,0,0,0,0,0
ANDHRA PRADESH,KADAPA,INSTITUTIONAL,Below 0.5,39,SAMBEPALLE,0,0,0,0,0,0,0,0,0,0
ANDHRA PRADESH,KADAPA,INSTITUTIONAL,Below 0.5,40,T SUNDUPALLE,0,0,0,0,0,0,0,0,0,0
ANDHRA PRADESH,KADAPA,INSTITUTIONAL,Below 0.5,41,RAYACHOTI,0,0,0,0,0,0,0,0,0,0
ANDHRA PRADESH,KADAPA,INSTITUTIONAL,Below 0.5,42,LAKKIREDDIPALLE,0,0,0,0,0,0,0,0,0,0
ANDHRA PRADESH,KADAPA,INSTITUTIONAL,Below 0.5,43,RAMAPURAM,0,0,0,0,0,0,0,0,0,0
ANDHRA PRADESH,KADAPA,INSTITUTIONAL,Below 0.5,44,VEERABALLE,0,0,0,0,0,0,0,0,0,0
ANDHRA PRADESH,KADAPA,INSTITUTIONAL,Below 0.5,45,NANDALUR,0,0,0,0,0,0,0,0,0,0
ANDHRA PRADESH,KADAPA,INSTITUTIONAL,Below 0.5,46,PENAGALUR,0,0,0,0,0,0,0,0,0,0
ANDHRA PRADESH,KADAPA,INSTITUTIONAL,Below 0.5,47,CHITVEL,0,0,0,0,0,0,0,0,0,0
ANDHRA PRADESH,KADAPA,INSTITUTIONAL,Below 0.5,48,RAJAMPET,0,0,0,0,0,0,0,0,0,0
ANDHRA PRADESH,KADAPA,INSTITUTIONAL,Below 0.5,49,PULLAMPETA,0,0,0,0,0,0,0,0,0,0
ANDHRA PRADESH,KADAPA,INSTITUTIONAL,Below 0.5,50,OBULAVARIPALLE,0,0,0,0,0,0,0,0,0,0
ANDHRA PRADESH,KADAPA,INSTITUTIONAL,Below 0.5,51,KODUR,0,0,0,0,0,0,0,0,0,0
ANDHRA PRADESH,KADAPA,SCHEDULED CASTE,Below 0.5,1,KONDAPURAM,191,63,59,4,63,0,1,0,1,0
ANDHRA PRADESH,KADAPA,SCHEDULED CASTE,Below 0.5,2,MYLAVARAM,404,129,126,4,130,0,0,0,0,0
ANDHRA PRADESH,KADAPA,SCHEDULED CASTE,Below 0.5,3,PEDDAMUDIUM,74,27,18,9,27,0,0,0,0,0
ANDHRA PRADESH,KADAPA,SCHEDULED CASTE,Below 0.5,4,RAJUPALEM,356,102,91,11,102,0,0,0,0,0
ANDHRA PRADESH,KADAPA,SCHEDULED CASTE,Below 0.5,5,DUVVUR,449,129,128,1,129,0,0,0,0,0
ANDHRA PRADESH,KADAPA,SCHEDULED CASTE,Below 0.5,6,S.MYDUKUR,520,161,94,67,161,0,0,0,0,0
ANDHRA PRADESH,KADAPA,SCHEDULED CASTE,Below 0.5,7,BRAHMAMGARIMATTAM,726,261,42,219,261,0,0,0,0,0
ANDHRA PRADESH,KADAPA,SCHEDULED CASTE,Below 0.5,8,SRI AVADHUTHA KASINAYANA,367,120,83,37,120,0,0,0,0,0
ANDHRA PRADESH,KADAPA,SCHEDULED CASTE,Below 0.5,9,KALASAPADU,344,108,103,6,109,0,0,0,0,0
ANDHRA PRADESH,KADAPA,SCHEDULED CASTE,Below 0.5,10,PORUMAMILLA,432,119,42,77,119,0,0,0,0,0
ANDHRA PRADESH,KADAPA,SCHEDULED CASTE,Below 0.5,11,B.KODUR,321,110,96,1,97,0,0,0,0,12
ANDHRA PRADESH,KADAPA,SCHEDULED CASTE,Below 0.5,12,BADVEL,480,120,113,7,120,0,0,0,0,0
ANDHRA PRADESH,KADAPA,SCHEDULED CASTE,Below 0.5,13,GOPAVARAM,440,131,74,58,132,0,0,0,0,0
ANDHRA PRADESH,KADAPA,SCHEDULED CASTE,Below 0.5,14,KHAJIPET,957,265,176,89,265,0,0,0,0,0
ANDHRA PRADESH,KADAPA,SCHEDULED CASTE,Below 0.5,15,CHAPAD,135,34,33,2,35,0,0,0,0,0
ANDHRA PRADESH,KADAPA,SCHEDULED CASTE,Below 0.5,16,PRODDATUR,241,74,54,20,74,0,0,0,0,0
ANDHRA PRADESH,KADAPA,SCHEDULED CASTE,Below 0.5,17,JAMMALAMADUGU,95,22,22,0,22,0,0,0,0,0
ANDHRA PRADESH,KADAPA,SCHEDULED CASTE,Below 0.5,18,MUDDANUR,236,75,67,8,75,0,0,0,0,0
ANDHRA PRADESH,KADAPA,SCHEDULED CASTE,Below 0.5,19,SIMHADRIPURAM,156,61,28,33,61,0,0,0,0,0
ANDHRA PRADESH,KADAPA,SCHEDULED CASTE,Below 0.5,20,LINGALA,60,18,18,0,18,0,0,0,0,0
ANDHRA PRADESH,KADAPA,SCHEDULED CASTE,Below 0.5,21,PULIVENDLA,77,27,27,0,27,0,0,0,0,0
ANDHRA PRADESH,KADAPA,SCHEDULED CASTE,Below 0.5,22,VEMULA,68,26,26,0,26,0,0,0,0,0
ANDHRA PRADESH,KADAPA,SCHEDULED CASTE,Below 0.5,23,THONDUR,63,22,20,2,22,0,0,0,0,0
ANDHRA PRADESH,KADAPA,SCHEDULED CASTE,Below 0.5,24,VEERAPUNAYUNIPALLE,64,20,8,12,20,0,0,0,0,0
ANDHRA PRADESH,KADAPA,SCHEDULED CASTE,Below 0.5,25,YERRAGUNTLA,78,26,7,19,26,0,0,0,0,0
ANDHRA PRADESH,KADAPA,SCHEDULED CASTE,Below 0.5,26,KAMALAPURAM,364,105,58,47,105,0,0,0,0,0
ANDHRA PRADESH,KADAPA,SCHEDULED CASTE,Below 0.5,27,VALLUR,372,100,66,35,101,0,0,0,0,0
ANDHRA PRADESH,KADAPA,SCHEDULED CASTE,Below 0.5,28,CHENNUR,246,67,67,1,68,0,0,0,0,0
ANDHRA PRADESH,KADAPA,SCHEDULED CASTE,Below 0.5,29,ATLUR,509,170,17,153,170,0,0,0,0,0
ANDHRA PRADESH,KADAPA,SCHEDULED CASTE,Below 0.5,30,VONTIMITTA,341,89,54,36,90,0,0,0,0,0
ANDHRA PRADESH,KADAPA,SCHEDULED CASTE,Below 0.5,31,SIDHOUT,345,87,37,29,66,0,13,3,16,5
ANDHRA PRADESH,KADAPA,SCHEDULED CASTE,Below 0.5,32,CUDDAPAH,237,58,46,12,58,0,0,0,0,0
ANDHRA PRADESH,KADAPA,SCHEDULED CASTE,Below 0.5,33,CHINTHAKOMMADINNE,222,59,52,7,59,0,0,0,0,0
ANDHRA PRADESH,KADAPA,SCHEDULED CASTE,Below 0.5,34,PENDLIMARRI,138,43,32,11,43,0,0,0,0,0
ANDHRA PRADESH,KADAPA,SCHEDULED CASTE,Below 0.5,35,VEMPALLE,110,38,37,0,37,0,0,0,0,0
ANDHRA PRADESH,KADAPA,SCHEDULED CASTE,Below 0.5,36,CHAKRAYAPET,146,43,40,3,43,0,0,0,0,0
ANDHRA PRADESH,KADAPA,SCHEDULED CASTE,Below 0.5,37,GALIVEEDU,109,30,0,30,30,0,0,0,0,0
ANDHRA PRADESH,KADAPA,SCHEDULED CASTE,Below 0.5,38,CHINNAMANDEM,154,46,42,4,46,0,0,0,0,0
ANDHRA PRADESH,KADAPA,SCHEDULED CASTE,Below 0.5,39,SAMBEPALLE,304,103,39,64,103,0,0,0,0,0
ANDHRA PRADESH,KADAPA,SCHEDULED CASTE,Below 0.5,40,T SUNDUPALLE,495,131,46,84,130,0,1,0,1,0
ANDHRA PRADESH,KADAPA,SCHEDULED CASTE,Below 0.5,41,RAYACHOTI,229,64,41,24,65,0,0,0,0,0
ANDHRA PRADESH,KADAPA,SCHEDULED CASTE,Below 0.5,42,LAKKIREDDIPALLE,186,56,28,28,56,0,0,0,0,0
ANDHRA PRADESH,KADAPA,SCHEDULED CASTE,Below 0.5,43,RAMAPURAM,184,52,48,4,52,0,0,0,0,0
ANDHRA PRADESH,KADAPA,SCHEDULED CASTE,Below 0.5,44,VEERABALLE,271,78,47,31,78,0,0,0,0,0
ANDHRA PRADESH,KADAPA,SCHEDULED CASTE,Below 0.5,45,NANDALUR,277,76,30,46,76,0,0,0,0,0
ANDHRA PRADESH,KADAPA,SCHEDULED CASTE,Below 0.5,46,PENAGALUR,383,90,24,65,89,0,0,0,0,0
ANDHRA PRADESH,KADAPA,SCHEDULED CASTE,Below 0.5,47,CHITVEL,553,165,118,47,165,0,0,0,0,0
ANDHRA PRADESH,KADAPA,SCHEDULED CASTE,Below 0.5,48,RAJAMPET,659,156,82,50,132,11,0,1,12,12
ANDHRA PRADESH,KADAPA,SCHEDULED CASTE,Below 0.5,49,PULLAMPETA,394,99,20,70,90,0,9,0,9,0
ANDHRA PRADESH,KADAPA,SCHEDULED CASTE,Below 0.5,50,OBULAVARIPALLE,156,43,35,8,43,0,0,0,0,0
ANDHRA PRADESH,KADAPA,SCHEDULED CASTE,Below 0.5,51,KODUR,520,142,86,56,142,0,0,0,0,0
ANDHRA PRADESH,KADAPA,OTHERS,Below 0.5,1,KONDAPURAM,2909,831,801,27,828,0,2,0,2,1
ANDHRA PRADESH,KADAPA,OTHERS,Below 0.5,2,MYLAVARAM,1562,443,386,56,442,0,0,0,0,0
ANDHRA PRADESH,KADAPA,OTHERS,Below 0.5,3,PEDDAMUDIUM,880,304,262,42,304,0,0,0,0,0
ANDHRA PRADESH,KADAPA,OTHERS,Below 0.5,4,RAJUPALEM,1860,611,594,15,609,0,0,0,0,1
ANDHRA PRADESH,KADAPA,OTHERS,Below 0.5,5,DUVVUR,3782,1192,1192,0,1192,0,0,0,0,0
ANDHRA PRADESH,KADAPA,OTHERS,Below 0.5,6,S.MYDUKUR,3529,1063,780,283,1063,0,0,0,0,0
ANDHRA PRADESH,KADAPA,OTHERS,Below 0.5,7,BRAHMAMGARIMATTAM,1743,568,248,321,569,0,0,0,0,0
ANDHRA PRADESH,KADAPA,OTHERS,Below 0.5,8,SRI AVADHUTHA KASINAYANA,1137,350,215,135,350,0,0,0,0,0
ANDHRA PRADESH,KADAPA,OTHERS,Below 0.5,9,KALASAPADU,1848,507,449,59,508,0,0,0,0,0
ANDHRA PRADESH,KADAPA,OTHERS,Below 0.5,10,PORUMAMILLA,2547,699,165,534,699,0,0,0,0,0
ANDHRA PRADESH,KADAPA,OTHERS,Below 0.5,11,B.KODUR,1294,366,322,14,336,0,0,0,0,29
ANDHRA PRADESH,KADAPA,OTHERS,Below 0.5,12,BADVEL,4742,1252,988,241,1229,0,5,0,5,18
ANDHRA PRADESH,KADAPA,OTHERS,Below 0.5,13,GOPAVARAM,2163,580,544,35,579,0,0,0,0,2
ANDHRA PRADESH,KADAPA,OTHERS,Below 0.5,14,KHAJIPET,3885,1185,933,251,1184,0,0,0,0,0
ANDHRA PRADESH,KADAPA,OTHERS,Below 0.5,15,CHAPAD,4350,1323,1090,233,1323,0,0,0,0,0
ANDHRA PRADESH,KADAPA,OTHERS,Below 0.5,16,PRODDATUR,2197,684,639,45,684,0,0,0,0,0
ANDHRA PRADESH,KADAPA,OTHERS,Below 0.5,17,JAMMALAMADUGU,2043,567,564,3,567,0,0,0,0,0
ANDHRA PRADESH,KADAPA,OTHERS,Below 0.5,18,MUDDANUR,1825,487,394,93,487,0,0,0,0,0
ANDHRA PRADESH,KADAPA,OTHERS,Below 0.5,19,SIMHADRIPURAM,641,211,100,111,211,0,0,0,0,0
ANDHRA PRADESH,KADAPA,OTHERS,Below 0.5,20,LINGALA,565,194,190,4,194,0,0,0,0,0
ANDHRA PRADESH,KADAPA,OTHERS,Below 0.5,21,PULIVENDLA,1099,351,351,0,351,0,0,0,0,0
ANDHRA PRADESH,KADAPA,OTHERS,Below 0.5,22,VEMULA,584,196,195,1,196,0,0,0,0,0
ANDHRA PRADESH,KADAPA,OTHERS,Below 0.5,23,THONDUR,432,138,117,20,137,0,0,0,0,0
ANDHRA PRADESH,KADAPA,OTHERS,Below 0.5,24,VEERAPUNAYUNIPALLE,527,168,64,103,167,0,0,0,0,0
ANDHRA PRADESH,KADAPA,OTHERS,Below 0.5,25,YERRAGUNTLA,1493,512,176,337,513,0,0,0,0,0
ANDHRA PRADESH,KADAPA,OTHERS,Below 0.5,26,KAMALAPURAM,1994,562,241,321,562,0,0,0,0,0
ANDHRA PRADESH,KADAPA,OTHERS,Below 0.5,27,VALLUR,1610,488,373,110,483,0,2,1,3,2
ANDHRA PRADESH,KADAPA,OTHERS,Below 0.5,28,CHENNUR,3357,915,868,46,914,0,0,0,0,0
ANDHRA PRADESH,KADAPA,OTHERS,Below 0.5,29,ATLUR,1441,409,150,259,409,0,0,0,0,0
ANDHRA PRADESH,KADAPA,OTHERS,Below 0.5,30,VONTIMITTA,1769,474,350,112,462,0,8,0,8,5
ANDHRA PRADESH,KADAPA,OTHERS,Below 0.5,31,SIDHOUT,1329,381,304,68,372,0,4,2,6,3
ANDHRA PRADESH,KADAPA,OTHERS,Below 0.5,32,CUDDAPAH,2203,621,610,10,620,0,0,0,0,0
ANDHRA PRADESH,KADAPA,OTHERS,Below 0.5,33,CHINTHAKOMMADINNE,2562,715,641,74,715,0,0,0,0,0
ANDHRA PRADESH,KADAPA,OTHERS,Below 0.5,34,PENDLIMARRI,1819,567,501,65,566,0,0,0,0,0
ANDHRA PRADESH,KADAPA,OTHERS,Below 0.5,35,VEMPALLE,485,164,159,6,165,0,0,0,0,0
ANDHRA PRADESH,KADAPA,OTHERS,Below 0.5,36,CHAKRAYAPET,1538,464,393,71,464,0,0,0,0,0
ANDHRA PRADESH,KADAPA,OTHERS,Below 0.5,37,GALIVEEDU,1753,510,46,463,509,0,1,0,1,0
ANDHRA PRADESH,KADAPA,OTHERS,Below 0.5,38,CHINNAMANDEM,1577,466,379,80,459,0,4,0,4,3
ANDHRA PRADESH,KADAPA,OTHERS,Below 0.5,39,SAMBEPALLE,1616,493,405,84,489,0,3,0,3,2
ANDHRA PRADESH,KADAPA,OTHERS,Below 0.5,40,T SUNDUPALLE,3252,823,248,570,818,0,3,0,3,2
ANDHRA PRADESH,KADAPA,OTHERS,Below 0.5,41,RAYACHOTI,2442,696,440,246,686,0,4,0,4,6
ANDHRA PRADESH,KADAPA,OTHERS,Below 0.5,42,LAKKIREDDIPALLE,1492,425,217,207,424,0,0,0,0,1
ANDHRA PRADESH,KADAPA,OTHERS,Below 0.5,43,RAMAPURAM,1621,477,393,83,476,0,1,0,1,0
ANDHRA PRADESH,KADAPA,OTHERS,Below 0.5,44,VEERABALLE,1764,477,269,207,476,0,0,0,0,1
ANDHRA PRADESH,KADAPA,OTHERS,Below 0.5,45,NANDALUR,1957,489,230,257,487,0,1,0,1,0
ANDHRA PRADESH,KADAPA,OTHERS,Below 0.5,46,PENAGALUR,2907,753,227,526,753,0,0,0,0,0
ANDHRA PRADESH,KADAPA,OTHERS,Below 0.5,47,CHITVEL,3143,817,651,149,800,0,10,0,10,7
ANDHRA PRADESH,KADAPA,OTHERS,Below 0.5,48,RAJAMPET,4597,1143,668,373,1041,42,11,9,62,39
ANDHRA PRADESH,KADAPA,OTHERS,Below 0.5,49,PULLAMPETA,2531,635,204,398,602,0,21,0,21,12
ANDHRA PRADESH,KADAPA,OTHERS,Below 0.5,50,OBULAVARIPALLE,2775,703,412,291,703,0,0,0,0,0
ANDHRA PRADESH,KADAPA,OTHERS,Below 0.5,51,KODUR,2033,541,245,296,541,0,0,0,0,0
ANDHRA PRADESH,KADAPA,SCHEDULED TRIBES,Below 0.5,1,KONDAPURAM,50,13,13,0,13,0,0,0,0,0
ANDHRA PRADESH,KADAPA,SCHEDULED TRIBES,Below 0.5,2,MYLAVARAM,98,32,19,13,32,0,0,0,0,0
ANDHRA PRADESH,KADAPA,SCHEDULED TRIBES,Below 0.5,3,PEDDAMUDIUM,3,1,1,1,2,0,0,0,0,0
ANDHRA PRADESH,KADAPA,SCHEDULED TRIBES,Below 0.5,4,RAJUPALEM,15,5,3,3,6,0,0,0,0,0
ANDHRA PRADESH,KADAPA,SCHEDULED TRIBES,Below 0.5,5,DUVVUR,42,17,17,0,17,0,0,0,0,0
ANDHRA PRADESH,KADAPA,SCHEDULED TRIBES,Below 0.5,6,S.MYDUKUR,93,33,17,17,34,0,0,0,0,0
ANDHRA PRADESH,KADAPA,SCHEDULED TRIBES,Below 0.5,7,BRAHMAMGARIMATTAM,39,16,16,0,16,0,0,0,0,0
ANDHRA PRADESH,KADAPA,SCHEDULED TRIBES,Below 0.5,8,SRI AVADHUTHA KASINAYANA,64,24,12,12,24,0,0,0,0,0
ANDHRA PRADESH,KADAPA,SCHEDULED TRIBES,Below 0.5,9,KALASAPADU,17,6,6,0,6,0,0,0,0,0
ANDHRA PRADESH,KADAPA,SCHEDULED TRIBES,Below 0.5,10,PORUMAMILLA,116,33,3,30,33,0,0,0,0,0
ANDHRA PRADESH,KADAPA,SCHEDULED TRIBES,Below 0.5,11,B.KODUR,22,8,2,0,2,0,0,0,0,6
ANDHRA PRADESH,KADAPA,SCHEDULED TRIBES,Below 0.5,12,BADVEL,86,25,21,4,25,0,0,0,0,0
ANDHRA PRADESH,KADAPA,SCHEDULED TRIBES,Below 0.5,13,GOPAVARAM,32,12,3,9,12,0,0,0,0,0
ANDHRA PRADESH,KADAPA,SCHEDULED TRIBES,Below 0.5,14,KHAJIPET,68,21,20,1,21,0,0,0,0,0
ANDHRA PRADESH,KADAPA,SCHEDULED TRIBES,Below 0.5,15,CHAPAD,61,18,18,0,18,0,0,0,0,0
ANDHRA PRADESH,KADAPA,SCHEDULED TRIBES,Below 0.5,16,PRODDATUR,6,1,1,1,2,0,0,0,0,0
ANDHRA PRADESH,KADAPA,SCHEDULED TRIBES,Below 0.5,17,JAMMALAMADUGU,85,17,17,0,17,0,0,0,0,0
ANDHRA PRADESH,KADAPA,SCHEDULED TRIBES,Below 0.5,18,MUDDANUR,28,9,7,1,8,0,0,0,0,0
ANDHRA PRADESH,KADAPA,SCHEDULED TRIBES,Below 0.5,19,SIMHADRIPURAM,12,3,0,3,3,0,0,0,0,0
ANDHRA PRADESH,KADAPA,SCHEDULED TRIBES,Below 0.5,20,LINGALA,1,0,0,0,0,0,0,0,0,0
ANDHRA PRADESH,KADAPA,SCHEDULED TRIBES,Below 0.5,21,PULIVENDLA,40,14,14,0,14,0,0,0,0,0
ANDHRA PRADESH,KADAPA,SCHEDULED TRIBES,Below 0.5,22,VEMULA,2,1,0,0,0,0,0,0,0,0
ANDHRA PRADESH,KADAPA,SCHEDULED TRIBES,Below 0.5,23,THONDUR,4,2,1,1,2,0,0,0,0,0
ANDHRA PRADESH,KADAPA,SCHEDULED TRIBES,Below 0.5,24,VEERAPUNAYUNIPALLE,6,3,1,1,2,0,0,0,0,0
ANDHRA PRADESH,KADAPA,SCHEDULED TRIBES,Below 0.5,25,YERRAGUNTLA,4,2,1,1,2,0,0,0,0,0
ANDHRA PRADESH,KADAPA,SCHEDULED TRIBES,Below 0.5,26,KAMALAPURAM,0,0,0,0,0,0,0,0,0,0
ANDHRA PRADESH,KADAPA,SCHEDULED TRIBES,Below 0.5,27,VALLUR,29,8,8,0,8,0,0,0,0,0
ANDHRA PRADESH,KADAPA,SCHEDULED TRIBES,Below 0.5,28,CHENNUR,65,19,10,10,20,0,0,0,0,0
ANDHRA PRADESH,KADAPA,SCHEDULED TRIBES,Below 0.5,29,ATLUR,41,14,0,14,14,0,0,0,0,0
ANDHRA PRADESH,KADAPA,SCHEDULED TRIBES,Below 0.5,30,VONTIMITTA,8,3,1,1,2,0,0,0,0,0
ANDHRA PRADESH,KADAPA,SCHEDULED TRIBES,Below 0.5,31,SIDHOUT,16,5,2,2,4,0,0,0,0,0
ANDHRA PRADESH,KADAPA,SCHEDULED TRIBES,Below 0.5,32,CUDDAPAH,121,35,35,0,35,0,0,0,0,0
ANDHRA PRADESH,KADAPA,SCHEDULED TRIBES,Below 0.5,33,CHINTHAKOMMADINNE,51,16,16,0,16,0,0,0,0,0
ANDHRA PRADESH,KADAPA,SCHEDULED TRIBES,Below 0.5,34,PENDLIMARRI,8,3,3,0,3,0,0,0,0,0
ANDHRA PRADESH,KADAPA,SCHEDULED TRIBES,Below 0.5,35,VEMPALLE,9,3,1,1,2,0,0,0,0,0
ANDHRA PRADESH,KADAPA,SCHEDULED TRIBES,Below 0.5,36,CHAKRAYAPET,60,18,18,0,18,0,0,0,0,0
ANDHRA PRADESH,KADAPA,SCHEDULED TRIBES,Below 0.5,37,GALIVEEDU,99,32,0,32,32,0,0,0,0,0
ANDHRA PRADESH,KADAPA,SCHEDULED TRIBES,Below 0.5,38,CHINNAMANDEM,15,5,2,0,2,0,2,0,2,0
ANDHRA PRADESH,KADAPA,SCHEDULED TRIBES,Below 0.5,39,SAMBEPALLE,105,31,31,0,31,0,0,0,0,0
ANDHRA PRADESH,KADAPA,SCHEDULED TRIBES,Below 0.5,40,T SUNDUPALLE,284,74,43,31,74,0,0,0,0,0
ANDHRA PRADESH,KADAPA,SCHEDULED TRIBES,Below 0.5,41,RAYACHOTI,13,4,3,0,3,0,0,0,0,0
ANDHRA PRADESH,KADAPA,SCHEDULED TRIBES,Below 0.5,42,LAKKIREDDIPALLE,31,10,5,5,10,0,0,0,0,0
ANDHRA PRADESH,KADAPA,SCHEDULED TRIBES,Below 0.5,43,RAMAPURAM,27,8,4,4,8,0,0,0,0,0
ANDHRA PRADESH,KADAPA,SCHEDULED TRIBES,Below 0.5,44,VEERABALLE,46,15,13,2,15,0,0,0,0,0
ANDHRA PRADESH,KADAPA,SCHEDULED TRIBES,Below 0.5,45,NANDALUR,6,2,0,2,2,0,0,0,0,0
ANDHRA PRADESH,KADAPA,SCHEDULED TRIBES,Below 0.5,46,PENAGALUR,81,26,0,26,26,0,0,0,0,0
ANDHRA PRADESH,KADAPA,SCHEDULED TRIBES,Below 0.5,47,CHITVEL,37,12,12,0,12,0,0,0,0,0
ANDHRA PRADESH,KADAPA,SCHEDULED TRIBES,Below 0.5,48,RAJAMPET,29,6,6,0,6,0,0,0,0,0
ANDHRA PRADESH,KADAPA,SCHEDULED TRIBES,Below 0.5,49,PULLAMPETA,57,14,4,10,14,0,0,0,0,0
ANDHRA PRADESH,KADAPA,SCHEDULED TRIBES,Below 0.5,50,OBULAVARIPALLE,64,17,17,0,17,0,0,0,0,0
ANDHRA PRADESH,KADAPA,SCHEDULED TRIBES,Below 0.5,51,KODUR,569,139,71,68,139,0,0,0,0,0
ANDHRA PRADESH,KADAPA,ALL SOCIAL GROUPS,Below 0.5,1,KONDAPURAM,3150,907,873,31,904,0,2,0,2,1
ANDHRA PRADESH,KADAPA,ALL SOCIAL GROUPS,Below 0.5,2,MYLAVARAM,2064,604,531,73,604,0,0,0,0,0
ANDHRA PRADESH,KADAPA,ALL SOCIAL GROUPS,Below 0.5,3,PEDDAMUDIUM,957,332,280,52,332,0,0,0,0,0
ANDHRA PRADESH,KADAPA,ALL SOCIAL GROUPS,Below 0.5,4,RAJUPALEM,2231,718,688,29,717,0,0,0,0,1
ANDHRA PRADESH,KADAPA,ALL SOCIAL GROUPS,Below 0.5,5,DUVVUR,4273,1337,1336,1,1337,0,0,0,0,0
ANDHRA PRADESH,KADAPA,ALL SOCIAL GROUPS,Below 0.5,6,S.MYDUKUR,4142,1257,890,366,1256,0,0,0,0,0
ANDHRA PRADESH,KADAPA,ALL SOCIAL GROUPS,Below 0.5,7,BRAHMAMGARIMATTAM,2508,845,306,539,845,0,0,0,0,0
ANDHRA PRADESH,KADAPA,ALL SOCIAL GROUPS,Below 0.5,8,SRI AVADHUTHA KASINAYANA,1568,493,310,183,493,0,0,0,0,0
ANDHRA PRADESH,KADAPA,ALL SOCIAL GROUPS,Below 0.5,9,KALASAPADU,2209,622,557,64,621,0,0,0,0,0
ANDHRA PRADESH,KADAPA,ALL SOCIAL GROUPS,Below 0.5,10,PORUMAMILLA,3096,851,210,641,851,0,0,0,0,0
ANDHRA PRADESH,KADAPA,ALL SOCIAL GROUPS,Below 0.5,11,B.KODUR,1637,484,421,15,436,0,0,0,0,47
ANDHRA PRADESH,KADAPA,ALL SOCIAL GROUPS,Below 0.5,12,BADVEL,5308,1397,1122,252,1374,0,5,0,5,18
ANDHRA PRADESH,KADAPA,ALL SOCIAL GROUPS,Below 0.5,13,GOPAVARAM,2635,723,620,101,721,0,0,0,0,2
ANDHRA PRADESH,KADAPA,ALL SOCIAL GROUPS,Below 0.5,14,KHAJIPET,4910,1471,1130,341,1471,0,0,0,0,0
ANDHRA PRADESH,KADAPA,ALL SOCIAL GROUPS,Below 0.5,15,CHAPAD,4546,1375,1140,235,1375,0,0,0,0,0
ANDHRA PRADESH,KADAPA,ALL SOCIAL GROUPS,Below 0.5,16,PRODDATUR,2445,760,694,66,760,0,0,0,0,0
ANDHRA PRADESH,KADAPA,ALL SOCIAL GROUPS,Below 0.5,17,JAMMALAMADUGU,2223,606,604,3,607,0,0,0,0,0
ANDHRA PRADESH,KADAPA,ALL SOCIAL GROUPS,Below 0.5,18,MUDDANUR,2089,570,468,102,570,0,0,0,0,0
ANDHRA PRADESH,KADAPA,ALL SOCIAL GROUPS,Below 0.5,19,SIMHADRIPURAM,809,276,128,147,275,0,0,0,0,0
ANDHRA PRADESH,KADAPA,ALL SOCIAL GROUPS,Below 0.5,20,LINGALA,626,213,209,4,213,0,0,0,0,0
ANDHRA PRADESH,KADAPA,ALL SOCIAL GROUPS,Below 0.5,21,PULIVENDLA,1216,392,392,0,392,0,0,0,0,0
ANDHRA PRADESH,KADAPA,ALL SOCIAL GROUPS,Below 0.5,22,VEMULA,654,223,221,1,222,0,0,0,0,0
ANDHRA PRADESH,KADAPA,ALL SOCIAL GROUPS,Below 0.5,23,THONDUR,499,162,138,23,161,0,0,0,0,0
ANDHRA PRADESH,KADAPA,ALL SOCIAL GROUPS,Below 0.5,24,VEERAPUNAYUNIPALLE,597,190,73,117,190,0,0,0,0,0
ANDHRA PRADESH,KADAPA,ALL SOCIAL GROUPS,Below 0.5,25,YERRAGUNTLA,1575,540,184,357,541,0,0,0,0,0
ANDHRA PRADESH,KADAPA,ALL SOCIAL GROUPS,Below 0.5,26,KAMALAPURAM,2358,667,300,367,667,0,0,0,0,0
ANDHRA PRADESH,KADAPA,ALL SOCIAL GROUPS,Below 0.5,27,VALLUR,2011,597,447,144,591,0,2,1,3,2
ANDHRA PRADESH,KADAPA,ALL SOCIAL GROUPS,Below 0.5,28,CHENNUR,3668,1001,944,57,1001,0,0,0,0,0
ANDHRA PRADESH,KADAPA,ALL SOCIAL GROUPS,Below 0.5,29,ATLUR,1991,593,167,426,593,0,0,0,0,0
ANDHRA PRADESH,KADAPA,ALL SOCIAL GROUPS,Below 0.5,30,VONTIMITTA,2118,566,405,149,554,0,8,0,8,5
ANDHRA PRADESH,KADAPA,ALL SOCIAL GROUPS,Below 0.5,31,SIDHOUT,1690,473,344,99,443,0,16,5,21,9
ANDHRA PRADESH,KADAPA,ALL SOCIAL GROUPS,Below 0.5,32,CUDDAPAH,2561,714,691,23,714,0,0,0,0,0
ANDHRA PRADESH,KADAPA,ALL SOCIAL GROUPS,Below 0.5,33,CHINTHAKOMMADINNE,2835,790,709,81,790,0,0,0,0,0
ANDHRA PRADESH,KADAPA,ALL SOCIAL GROUPS,Below 0.5,34,PENDLIMARRI,1965,612,536,76,612,0,0,0,0,0
ANDHRA PRADESH,KADAPA,ALL SOCIAL GROUPS,Below 0.5,35,VEMPALLE,604,205,197,8,205,0,0,0,0,0
ANDHRA PRADESH,KADAPA,ALL SOCIAL GROUPS,Below 0.5,36,CHAKRAYAPET,1744,525,451,74,525,0,0,0,0,0
ANDHRA PRADESH,KADAPA,ALL SOCIAL GROUPS,Below 0.5,37,GALIVEEDU,1961,573,46,526,572,0,1,0,1,0
ANDHRA PRADESH,KADAPA,ALL SOCIAL GROUPS,Below 0.5,38,CHINNAMANDEM,1746,517,424,85,509,0,5,0,5,3
ANDHRA PRADESH,KADAPA,ALL SOCIAL GROUPS,Below 0.5,39,SAMBEPALLE,2025,627,474,148,622,0,3,0,3,2
ANDHRA PRADESH,KADAPA,ALL SOCIAL GROUPS,Below 0.5,40,T SUNDUPALLE,4031,1029,337,686,1023,0,4,0,4,2
ANDHRA PRADESH,KADAPA,ALL SOCIAL GROUPS,Below 0.5,41,RAYACHOTI,2684,764,484,270,754,0,4,0,4,7
ANDHRA PRADESH,KADAPA,ALL SOCIAL GROUPS,Below 0.5,42,LAKKIREDDIPALLE,1709,491,250,240,490,0,0,0,0,1
ANDHRA PRADESH,KADAPA,ALL SOCIAL GROUPS,Below 0.5,43,RAMAPURAM,1832,537,445,91,536,0,1,0,1,0
ANDHRA PRADESH,KADAPA,ALL SOCIAL GROUPS,Below 0.5,44,VEERABALLE,2081,570,329,239,568,0,0,0,0,1
ANDHRA PRADESH,KADAPA,ALL SOCIAL GROUPS,Below 0.5,45,NANDALUR,2240,567,259,306,565,0,1,0,1,0
ANDHRA PRADESH,KADAPA,ALL SOCIAL GROUPS,Below 0.5,46,PENAGALUR,3371,869,252,617,869,0,0,0,0,0
ANDHRA PRADESH,KADAPA,ALL SOCIAL GROUPS,Below 0.5,47,CHITVEL,3733,994,781,196,977,0,10,0,10,7
ANDHRA PRADESH,KADAPA,ALL SOCIAL GROUPS,Below 0.5,48,RAJAMPET,5285,1305,756,423,1179,53,11,10,74,51
ANDHRA PRADESH,KADAPA,ALL SOCIAL GROUPS,Below 0.5,49,PULLAMPETA,2982,748,228,478,706,0,30,0,30,12
ANDHRA PRADESH,KADAPA,ALL SOCIAL GROUPS,Below 0.5,50,OBULAVARIPALLE,2995,763,463,299,762,0,0,0,0,0
ANDHRA PRADESH,KADAPA,ALL SOCIAL GROUPS,Below 0.5,51,KODUR,3122,822,402,421,823,0,0,0,0,0
ANDHRA PRADESH,KADAPA,INSTITUTIONAL,1.0-2.0,1,KONDAPURAM,0,0,0,0,0,0,0,0,0,0
ANDHRA PRADESH,KADAPA,INSTITUTIONAL,1.0-2.0,2,MYLAVARAM,0,0,0,0,0,0,0,0,0,0
ANDHRA PRADESH,KADAPA,INSTITUTIONAL,1.0-2.0,3,PEDDAMUDIUM,0,0,0,0,0,0,0,0,0,0
ANDHRA PRADESH,KADAPA,INSTITUTIONAL,1.0-2.0,4,RAJUPALEM,0,0,0,0,0,0,0,0,0,0
ANDHRA PRADESH,KADAPA,INSTITUTIONAL,1.0-2.0,5,DUVVUR,0,0,0,0,0,0,0,0,0,0
ANDHRA PRADESH,KADAPA,INSTITUTIONAL,1.0-2.0,6,S.MYDUKUR,0,0,0,0,0,0,0,0,0,0
ANDHRA PRADESH,KADAPA,INSTITUTIONAL,1.0-2.0,7,BRAHMAMGARIMATTAM,1,1,1,0,1,0,0,0,0,0
ANDHRA PRADESH,KADAPA,INSTITUTIONAL,1.0-2.0,8,SRI AVADHUTHA KASINAYANA,0,0,0,0,0,0,0,0,0,0
ANDHRA PRADESH,KADAPA,INSTITUTIONAL,1.0-2.0,9,KALASAPADU,0,0,0,0,0,0,0,0,0,0
ANDHRA PRADESH,KADAPA,INSTITUTIONAL,1.0-2.0,10,PORUMAMILLA,0,0,0,0,0,0,0,0,0,0
ANDHRA PRADESH,KADAPA,INSTITUTIONAL,1.0-2.0,11,B.KODUR,0,0,0,0,0,0,0,0,0,0
ANDHRA PRADESH,KADAPA,INSTITUTIONAL,1.0-2.0,12,BADVEL,0,0,0,0,0,0,0,0,0,0
ANDHRA PRADESH,KADAPA,INSTITUTIONAL,1.0-2.0,13,GOPAVARAM,0,0,0,0,0,0,0,0,0,0
ANDHRA PRADESH,KADAPA,INSTITUTIONAL,1.0-2.0,14,KHAJIPET,0,0,0,0,0,0,0,0,0,0
ANDHRA PRADESH,KADAPA,INSTITUTIONAL,1.0-2.0,15,CHAPAD,0,0,0,0,0,0,0,0,0,0
ANDHRA PRADESH,KADAPA,INSTITUTIONAL,1.0-2.0,16,PRODDATUR,2,2,1,1,2,0,0,0,0,0
ANDHRA PRADESH,KADAPA,INSTITUTIONAL,1.0-2.0,17,JAMMALAMADUGU,0,0,0,0,0,0,0,0,0,0
ANDHRA PRADESH,KADAPA,INSTITUTIONAL,1.0-2.0,18,MUDDANUR,0,0,0,0,0,0,0,0,0,0
ANDHRA PRADESH,KADAPA,INSTITUTIONAL,1.0-2.0,19,SIMHADRIPURAM,0,0,0,0,0,0,0,0,0,0
ANDHRA PRADESH,KADAPA,INSTITUTIONAL,1.0-2.0,20,LINGALA,0,0,0,0,0,0,0,0,0,0
ANDHRA PRADESH,KADAPA,INSTITUTIONAL,1.0-2.0,21,PULIVENDLA,0,0,0,0,0,0,0,0,0,0
ANDHRA PRADESH,KADAPA,INSTITUTIONAL,1.0-2.0,22,VEMULA,0,0,0,0,0,0,0,0,0,0
ANDHRA PRADESH,KADAPA,INSTITUTIONAL,1.0-2.0,23,THONDUR,0,0,0,0,0,0,0,0,0,0
ANDHRA PRADESH,KADAPA,INSTITUTIONAL,1.0-2.0,24,VEERAPUNAYUNIPALLE,0,0,0,0,0,0,0,0,0,0
ANDHRA PRADESH,KADAPA,INSTITUTIONAL,1.0-2.0,25,YERRAGUNTLA,1,1,1,0,1,0,0,0,0,0
ANDHRA PRADESH,KADAPA,INSTITUTIONAL,1.0-2.0,26,KAMALAPURAM,0,0,0,0,0,0,0,0,0,0
ANDHRA PRADESH,KADAPA,INSTITUTIONAL,1.0-2.0,27,VALLUR,0,0,0,0,0,0,0,0,0,0
ANDHRA PRADESH,KADAPA,INSTITUTIONAL,1.0-2.0,28,CHENNUR,0,0,0,0,0,0,0,0,0,0
ANDHRA PRADESH,KADAPA,INSTITUTIONAL,1.0-2.0,29,ATLUR,0,0,0,0,0,0,0,0,0,0
ANDHRA PRADESH,KADAPA,INSTITUTIONAL,1.0-2.0,30,VONTIMITTA,0,0,0,0,0,0,0,0,0,0
ANDHRA PRADESH,KADAPA,INSTITUTIONAL,1.0-2.0,31,SIDHOUT,0,0,0,0,0,0,0,0,0,0
ANDHRA PRADESH,KADAPA,INSTITUTIONAL,1.0-2.0,32,CUDDAPAH,0,0,0,0,0,0,0,0,0,0
ANDHRA PRADESH,KADAPA,INSTITUTIONAL,1.0-2.0,33,CHINTHAKOMMADINNE,1,2,1,1,2,0,0,0,0,0
ANDHRA PRADESH,KADAPA,INSTITUTIONAL,1.0-2.0,34,PENDLIMARRI,0,0,0,0,0,0,0,0,0,0
ANDHRA PRADESH,KADAPA,INSTITUTIONAL,1.0-2.0,35,VEMPALLE,0,0,0,0,0,0,0,0,0,0
ANDHRA PRADESH,KADAPA,INSTITUTIONAL,1.0-2.0,36,CHAKRAYAPET,0,0,0,0,0,0,0,0,0,0
ANDHRA PRADESH,KADAPA,INSTITUTIONAL,1.0-2.0,37,GALIVEEDU,0,0,0,0,0,0,0,0,0,0
ANDHRA PRADESH,KADAPA,INSTITUTIONAL,1.0-2.0,38,CHINNAMANDEM,0,0,0,0,0,0,0,0,0,0
ANDHRA PRADESH,KADAPA,INSTITUTIONAL,1.0-2.0,39,SAMBEPALLE,0,0,0,0,0,0,0,0,0,0
ANDHRA PRADESH,KADAPA,INSTITUTIONAL,1.0-2.0,40,T SUNDUPALLE,0,0,0,0,0,0,0,0,0,0
ANDHRA PRADESH,KADAPA,INSTITUTIONAL,1.0-2.0,41,RAYACHOTI,0,0,0,0,0,0,0,0,0,0
ANDHRA PRADESH,KADAPA,INSTITUTIONAL,1.0-2.0,42,LAKKIREDDIPALLE,0,0,0,0,0,0,0,0,0,0
ANDHRA PRADESH,KADAPA,INSTITUTIONAL,1.0-2.0,43,RAMAPURAM,0,0,0,0,0,0,0,0,0,0
ANDHRA PRADESH,KADAPA,INSTITUTIONAL,1.0-2.0,44,VEERABALLE,0,0,0,0,0,0,0,0,0,0
ANDHRA PRADESH,KADAPA,INSTITUTIONAL,1.0-2.0,45,NANDALUR,0,0,0,0,0,0,0,0,0,0
ANDHRA PRADESH,KADAPA,INSTITUTIONAL,1.0-2.0,46,PENAGALUR,0,0,0,0,0,0,0,0,0,0
ANDHRA PRADESH,KADAPA,INSTITUTIONAL,1.0-2.0,47,CHITVEL,0,0,0,0,0,0,0,0,0,0
ANDHRA PRADESH,KADAPA,INSTITUTIONAL,1.0-2.0,48,RAJAMPET,0,0,0,0,0,0,0,0,0,0
ANDHRA PRADESH,KADAPA,INSTITUTIONAL,1.0-2.0,49,PULLAMPETA,0,0,0,0,0,0,0,0,0,0
ANDHRA PRADESH,KADAPA,INSTITUTIONAL,1.0-2.0,50,OBULAVARIPALLE,0,0,0,0,0,0,0,0,0,0
ANDHRA PRADESH,KADAPA,INSTITUTIONAL,1.0-2.0,51,KODUR,0,0,0,0,0,0,0,0,0,0
ANDHRA PRADESH,KADAPA,SCHEDULED CASTE,1.0-2.0,1,KONDAPURAM,154,212,166,47,213,0,0,0,0,0
ANDHRA PRADESH,KADAPA,SCHEDULED CASTE,1.0-2.0,2,MYLAVARAM,242,340,307,32,339,0,0,0,0,0
ANDHRA PRADESH,KADAPA,SCHEDULED CASTE,1.0-2.0,3,PEDDAMUDIUM,64,91,77,13,90,0,0,0,0,0
ANDHRA PRADESH,KADAPA,SCHEDULED CASTE,1.0-2.0,4,RAJUPALEM,111,147,147,0,147,0,0,0,0,0
ANDHRA PRADESH,KADAPA,SCHEDULED CASTE,1.0-2.0,5,DUVVUR,150,198,198,0,198,0,0,0,0,0
ANDHRA PRADESH,KADAPA,SCHEDULED CASTE,1.0-2.0,6,S.MYDUKUR,230,286,280,6,286,0,0,0,0,0
ANDHRA PRADESH,KADAPA,SCHEDULED CASTE,1.0-2.0,7,BRAHMAMGARIMATTAM,433,593,255,338,593,0,0,0,0,0
ANDHRA PRADESH,KADAPA,SCHEDULED CASTE,1.0-2.0,8,SRI AVADHUTHA KASINAYANA,251,349,219,130,349,0,0,0,0,0
ANDHRA PRADESH,KADAPA,SCHEDULED CASTE,1.0-2.0,9,KALASAPADU,163,231,231,0,231,0,0,0,0,0
ANDHRA PRADESH,KADAPA,SCHEDULED CASTE,1.0-2.0,10,PORUMAMILLA,417,578,380,198,578,0,0,0,0,0
ANDHRA PRADESH,KADAPA,SCHEDULED CASTE,1.0-2.0,11,B.KODUR,153,209,63,17,80,0,0,0,0,130
ANDHRA PRADESH,KADAPA,SCHEDULED CASTE,1.0-2.0,12,BADVEL,164,220,77,68,145,0,75,0,75,0
ANDHRA PRADESH,KADAPA,SCHEDULED CASTE,1.0-2.0,13,GOPAVARAM,293,436,223,190,413,0,9,3,12,11
ANDHRA PRADESH,KADAPA,SCHEDULED CASTE,1.0-2.0,14,KHAJIPET,170,210,203,7,210,0,0,0,0,0
ANDHRA PRADESH,KADAPA,SCHEDULED CASTE,1.0-2.0,15,CHAPAD,15,20,19,1,20,0,0,0,0,1
ANDHRA PRADESH,KADAPA,SCHEDULED CASTE,1.0-2.0,16,PRODDATUR,47,61,61,0,61,0,0,0,0,0
ANDHRA PRADESH,KADAPA,SCHEDULED CASTE,1.0-2.0,17,JAMMALAMADUGU,14,19,19,0,19,0,0,0,0,0
ANDHRA PRADESH,KADAPA,SCHEDULED CASTE,1.0-2.0,18,MUDDANUR,161,223,204,18,222,0,0,0,0,0
ANDHRA PRADESH,KADAPA,SCHEDULED CASTE,1.0-2.0,19,SIMHADRIPURAM,117,157,107,50,157,0,0,0,0,0
ANDHRA PRADESH,KADAPA,SCHEDULED CASTE,1.0-2.0,20,LINGALA,216,316,304,12,316,0,0,0,0,0
ANDHRA PRADESH,KADAPA,SCHEDULED CASTE,1.0-2.0,21,PULIVENDLA,68,94,94,0,94,0,0,0,0,0
ANDHRA PRADESH,KADAPA,SCHEDULED CASTE,1.0-2.0,22,VEMULA,250,360,360,0,360,0,0,0,0,0
ANDHRA PRADESH,KADAPA,SCHEDULED CASTE,1.0-2.0,23,THONDUR,224,301,60,242,302,0,0,0,0,0
ANDHRA PRADESH,KADAPA,SCHEDULED CASTE,1.0-2.0,24,VEERAPUNAYUNIPALLE,226,315,256,59,315,0,0,0,0,0
ANDHRA PRADESH,KADAPA,SCHEDULED CASTE,1.0-2.0,25,YERRAGUNTLA,41,58,56,2,58,0,0,0,0,0
ANDHRA PRADESH,KADAPA,SCHEDULED CASTE,1.0-2.0,26,KAMALAPURAM,110,151,139,11,150,0,0,0,0,0
ANDHRA PRADESH,KADAPA,SCHEDULED CASTE,1.0-2.0,27,VALLUR,133,180,141,38,179,0,0,0,0,0
ANDHRA PRADESH,KADAPA,SCHEDULED CASTE,1.0-2.0,28,CHENNUR,21,29,24,5,29,0,0,0,0,0
ANDHRA PRADESH,KADAPA,SCHEDULED CASTE,1.0-2.0,29,ATLUR,162,232,83,149,232,0,0,0,0,0
ANDHRA PRADESH,KADAPA,SCHEDULED CASTE,1.0-2.0,30,VONTIMITTA,88,125,54,35,89,0,36,0,36,0
ANDHRA PRADESH,KADAPA,SCHEDULED CASTE,1.0-2.0,31,SIDHOUT,97,137,58,39,97,0,0,15,15,25
ANDHRA PRADESH,KADAPA,SCHEDULED CASTE,1.0-2.0,32,CUDDAPAH,11,16,16,0,16,0,0,0,0,0
ANDHRA PRADESH,KADAPA,SCHEDULED CASTE,1.0-2.0,33,CHINTHAKOMMADINNE,95,135,122,13,135,0,0,0,0,0
ANDHRA PRADESH,KADAPA,SCHEDULED CASTE,1.0-2.0,34,PENDLIMARRI,135,192,153,39,192,0,0,0,0,0
ANDHRA PRADESH,KADAPA,SCHEDULED CASTE,1.0-2.0,35,VEMPALLE,151,202,202,0,202,0,0,0,0,0
ANDHRA PRADESH,KADAPA,SCHEDULED CASTE,1.0-2.0,36,CHAKRAYAPET,103,142,124,10,134,1,5,0,6,2
ANDHRA PRADESH,KADAPA,SCHEDULED CASTE,1.0-2.0,37,GALIVEEDU,106,150,81,57,138,0,4,0,4,8
ANDHRA PRADESH,KADAPA,SCHEDULED CASTE,1.0-2.0,38,CHINNAMANDEM,100,148,144,1,145,0,3,0,3,0
ANDHRA PRADESH,KADAPA,SCHEDULED CASTE,1.0-2.0,39,SAMBEPALLE,234,335,268,38,306,0,29,0,29,0
ANDHRA PRADESH,KADAPA,SCHEDULED CASTE,1.0-2.0,40,T SUNDUPALLE,215,300,134,156,290,1,8,0,9,1
ANDHRA PRADESH,KADAPA,SCHEDULED CASTE,1.0-2.0,41,RAYACHOTI,112,161,79,74,153,0,8,0,8,0
ANDHRA PRADESH,KADAPA,SCHEDULED CASTE,1.0-2.0,42,LAKKIREDDIPALLE,154,215,108,107,215,0,0,0,0,0
ANDHRA PRADESH,KADAPA,SCHEDULED CASTE,1.0-2.0,43,RAMAPURAM,255,359,352,4,356,0,3,0,3,0
ANDHRA PRADESH,KADAPA,SCHEDULED CASTE,1.0-2.0,44,VEERABALLE,237,337,237,99,336,0,0,0,0,1
ANDHRA PRADESH,KADAPA,SCHEDULED CASTE,1.0-2.0,45,NANDALUR,63,89,44,45,89,0,0,0,0,0
ANDHRA PRADESH,KADAPA,SCHEDULED CASTE,1.0-2.0,46,PENAGALUR,117,178,56,82,138,1,39,0,40,1
ANDHRA PRADESH,KADAPA,SCHEDULED CASTE,1.0-2.0,47,CHITVEL,101,159,65,93,158,0,1,0,1,0
ANDHRA PRADESH,KADAPA,SCHEDULED CASTE,1.0-2.0,48,RAJAMPET,239,325,114,141,255,23,3,3,29,41
ANDHRA PRADESH,KADAPA,SCHEDULED CASTE,1.0-2.0,49,PULLAMPETA,240,367,114,107,221,0,147,0,147,0
ANDHRA PRADESH,KADAPA,SCHEDULED CASTE,1.0-2.0,50,OBULAVARIPALLE,85,123,83,40,123,0,0,0,0,0
ANDHRA PRADESH,KADAPA,SCHEDULED CASTE,1.0-2.0,51,KODUR,182,256,144,112,256,0,0,0,0,0
ANDHRA PRADESH,KADAPA,OTHERS,1.0-2.0,1,KONDAPURAM,2767,3968,3313,637,3950,0,11,0,11,6
ANDHRA PRADESH,KADAPA,OTHERS,1.0-2.0,2,MYLAVARAM,2023,2915,2674,241,2915,0,0,0,0,0
ANDHRA PRADESH,KADAPA,OTHERS,1.0-2.0,3,PEDDAMUDIUM,3302,4818,4157,655,4812,0,3,0,3,3
ANDHRA PRADESH,KADAPA,OTHERS,1.0-2.0,4,RAJUPALEM,2786,4025,3983,41,4024,0,0,0,0,1
ANDHRA PRADESH,KADAPA,OTHERS,1.0-2.0,5,DUVVUR,3203,4435,4430,4,4434,1,0,0,1,1
ANDHRA PRADESH,KADAPA,OTHERS,1.0-2.0,6,S.MYDUKUR,3031,3962,3880,80,3960,0,1,0,1,1
ANDHRA PRADESH,KADAPA,OTHERS,1.0-2.0,7,BRAHMAMGARIMATTAM,2106,2999,1590,1408,2998,0,0,0,0,0
ANDHRA PRADESH,KADAPA,OTHERS,1.0-2.0,8,SRI AVADHUTHA KASINAYANA,2076,3001,1904,1096,3000,0,0,0,0,0
ANDHRA PRADESH,KADAPA,OTHERS,1.0-2.0,9,KALASAPADU,1673,2364,1457,903,2360,0,2,0,2,1
ANDHRA PRADESH,KADAPA,OTHERS,1.0-2.0,10,PORUMAMILLA,1753,2461,1246,1215,2461,0,0,0,0,0
ANDHRA PRADESH,KADAPA,OTHERS,1.0-2.0,11,B.KODUR,1542,2206,709,230,939,0,0,0,0,1266
ANDHRA PRADESH,KADAPA,OTHERS,1.0-2.0,12,BADVEL,1326,1830,631,907,1538,0,95,38,133,159
ANDHRA PRADESH,KADAPA,OTHERS,1.0-2.0,13,GOPAVARAM,778,1090,639,254,893,0,7,40,47,151
ANDHRA PRADESH,KADAPA,OTHERS,1.0-2.0,14,KHAJIPET,2464,3358,3173,185,3358,0,0,0,0,0
ANDHRA PRADESH,KADAPA,OTHERS,1.0-2.0,15,CHAPAD,2266,3143,2861,245,3106,0,5,0,5,33
ANDHRA PRADESH,KADAPA,OTHERS,1.0-2.0,16,PRODDATUR,2162,3076,3076,0,3076,0,0,0,0,0
ANDHRA PRADESH,KADAPA,OTHERS,1.0-2.0,17,JAMMALAMADUGU,1879,2676,2561,90,2651,0,16,0,16,9
ANDHRA PRADESH,KADAPA,OTHERS,1.0-2.0,18,MUDDANUR,2431,3515,3236,277,3513,0,0,0,0,1
ANDHRA PRADESH,KADAPA,OTHERS,1.0-2.0,19,SIMHADRIPURAM,3945,5865,3987,1878,5865,0,0,0,0,0
ANDHRA PRADESH,KADAPA,OTHERS,1.0-2.0,20,LINGALA,3335,4868,4826,42,4868,0,0,0,0,0
ANDHRA PRADESH,KADAPA,OTHERS,1.0-2.0,21,PULIVENDLA,2293,3284,3284,0,3284,0,0,0,0,0
ANDHRA PRADESH,KADAPA,OTHERS,1.0-2.0,22,VEMULA,3137,4581,4393,112,4505,0,49,0,49,28
ANDHRA PRADESH,KADAPA,OTHERS,1.0-2.0,23,THONDUR,3281,4840,4140,701,4841,0,0,0,0,0
ANDHRA PRADESH,KADAPA,OTHERS,1.0-2.0,24,VEERAPUNAYUNIPALLE,3394,4967,4104,863,4967,0,0,0,0,0
ANDHRA PRADESH,KADAPA,OTHERS,1.0-2.0,25,YERRAGUNTLA,2811,4038,2221,1817,4038,0,0,0,0,0
ANDHRA PRADESH,KADAPA,OTHERS,1.0-2.0,26,KAMALAPURAM,2730,3906,2592,1314,3906,0,0,0,0,0
ANDHRA PRADESH,KADAPA,OTHERS,1.0-2.0,27,VALLUR,2193,3178,2252,813,3065,0,65,6,71,42
ANDHRA PRADESH,KADAPA,OTHERS,1.0-2.0,28,CHENNUR,929,1273,1091,167,1258,0,9,0,9,5
ANDHRA PRADESH,KADAPA,OTHERS,1.0-2.0,29,ATLUR,1082,1546,499,1047,1546,0,0,0,0,1
ANDHRA PRADESH,KADAPA,OTHERS,1.0-2.0,30,VONTIMITTA,904,1274,473,534,1007,0,170,0,170,97
ANDHRA PRADESH,KADAPA,OTHERS,1.0-2.0,31,SIDHOUT,826,1170,788,121,909,0,0,161,161,99
ANDHRA PRADESH,KADAPA,OTHERS,1.0-2.0,32,CUDDAPAH,574,802,775,27,802,0,0,0,0,0
ANDHRA PRADESH,KADAPA,OTHERS,1.0-2.0,33,CHINTHAKOMMADINNE,1649,2353,2240,114,2354,0,0,0,0,0
ANDHRA PRADESH,KADAPA,OTHERS,1.0-2.0,34,PENDLIMARRI,2874,4160,3504,656,4160,0,0,0,0,0
ANDHRA PRADESH,KADAPA,OTHERS,1.0-2.0,35,VEMPALLE,2153,3155,3111,40,3151,0,2,0,2,1
ANDHRA PRADESH,KADAPA,OTHERS,1.0-2.0,36,CHAKRAYAPET,2223,3238,2740,375,3115,13,47,15,75,48
ANDHRA PRADESH,KADAPA,OTHERS,1.0-2.0,37,GALIVEEDU,3268,4542,2364,1927,4291,0,149,1,150,101
ANDHRA PRADESH,KADAPA,OTHERS,1.0-2.0,38,CHINNAMANDEM,2231,3187,2786,112,2898,0,176,1,177,112
ANDHRA PRADESH,KADAPA,OTHERS,1.0-2.0,39,SAMBEPALLE,3107,4558,3731,250,3981,0,348,18,366,211
ANDHRA PRADESH,KADAPA,OTHERS,1.0-2.0,40,T SUNDUPALLE,3357,4840,2102,2424,4526,13,186,0,199,115
ANDHRA PRADESH,KADAPA,OTHERS,1.0-2.0,41,RAYACHOTI,2717,3876,1568,1913,3481,0,244,0,244,151
ANDHRA PRADESH,KADAPA,OTHERS,1.0-2.0,42,LAKKIREDDIPALLE,2885,4183,3413,682,4095,0,37,0,37,51
ANDHRA PRADESH,KADAPA,OTHERS,1.0-2.0,43,RAMAPURAM,2649,3956,3397,416,3813,0,92,0,92,52
ANDHRA PRADESH,KADAPA,OTHERS,1.0-2.0,44,VEERABALLE,2134,3030,2285,728,3013,0,0,0,0,17
ANDHRA PRADESH,KADAPA,OTHERS,1.0-2.0,45,NANDALUR,645,914,573,331,904,0,5,2,7,3
ANDHRA PRADESH,KADAPA,OTHERS,1.0-2.0,46,PENAGALUR,1660,2455,838,1104,1942,5,320,0,325,188
ANDHRA PRADESH,KADAPA,OTHERS,1.0-2.0,47,CHITVEL,1645,2431,675,1737,2412,0,10,0,10,8
ANDHRA PRADESH,KADAPA,OTHERS,1.0-2.0,48,RAJAMPET,2114,3046,1417,745,2162,214,130,215,559,326
ANDHRA PRADESH,KADAPA,OTHERS,1.0-2.0,49,PULLAMPETA,1727,2579,865,770,1635,0,602,0,602,342
ANDHRA PRADESH,KADAPA,OTHERS,1.0-2.0,50,OBULAVARIPALLE,1862,2758,1063,1380,2443,0,201,0,201,114
ANDHRA PRADESH,KADAPA,OTHERS,1.0-2.0,51,KODUR,1673,2495,1273,1221,2494,0,0,0,0,0
ANDHRA PRADESH,KADAPA,SCHEDULED TRIBES,1.0-2.0,1,KONDAPURAM,7,10,5,5,10,0,0,0,0,0
ANDHRA PRADESH,KADAPA,SCHEDULED TRIBES,1.0-2.0,2,MYLAVARAM,61,82,75,6,81,0,0,0,0,0
ANDHRA PRADESH,KADAPA,SCHEDULED TRIBES,1.0-2.0,3,PEDDAMUDIUM,5,7,3,3,6,0,0,0,0,0
ANDHRA PRADESH,KADAPA,SCHEDULED TRIBES,1.0-2.0,4,RAJUPALEM,8,12,6,6,12,0,0,0,0,0
ANDHRA PRADESH,KADAPA,SCHEDULED TRIBES,1.0-2.0,5,DUVVUR,3,5,5,0,5,0,0,0,0,0
ANDHRA PRADESH,KADAPA,SCHEDULED TRIBES,1.0-2.0,6,S.MYDUKUR,34,44,44,0,44,0,0,0,0,0
ANDHRA PRADESH,KADAPA,SCHEDULED TRIBES,1.0-2.0,7,BRAHMAMGARIMATTAM,21,27,15,12,27,0,0,0,0,0
ANDHRA PRADESH,KADAPA,SCHEDULED TRIBES,1.0-2.0,8,SRI AVADHUTHA KASINAYANA,51,62,31,31,62,0,0,0,0,0
ANDHRA PRADESH,KADAPA,SCHEDULED TRIBES,1.0-2.0,9,KALASAPADU,3,4,4,0,4,0,0,0,0,0
ANDHRA PRADESH,KADAPA,SCHEDULED TRIBES,1.0-2.0,10,PORUMAMILLA,99,136,36,100,136,0,0,0,0,0
ANDHRA PRADESH,KADAPA,SCHEDULED TRIBES,1.0-2.0,11,B.KODUR,7,10,3,0,3,0,0,0,0,7
ANDHRA PRADESH,KADAPA,SCHEDULED TRIBES,1.0-2.0,12,BADVEL,31,44,22,22,44,0,0,0,0,0
ANDHRA PRADESH,KADAPA,SCHEDULED TRIBES,1.0-2.0,13,GOPAVARAM,1,1,1,1,2,0,0,0,0,0
ANDHRA PRADESH,KADAPA,SCHEDULED TRIBES,1.0-2.0,14,KHAJIPET,9,10,10,0,10,0,0,0,0,0
ANDHRA PRADESH,KADAPA,SCHEDULED TRIBES,1.0-2.0,15,CHAPAD,30,41,31,10,41,0,0,0,0,0
ANDHRA PRADESH,KADAPA,SCHEDULED TRIBES,1.0-2.0,16,PRODDATUR,1,1,1,1,2,0,0,0,0,0
ANDHRA PRADESH,KADAPA,SCHEDULED TRIBES,1.0-2.0,17,JAMMALAMADUGU,16,20,12,8,20,0,0,0,0,0
ANDHRA PRADESH,KADAPA,SCHEDULED TRIBES,1.0-2.0,18,MUDDANUR,28,38,38,0,38,0,0,0,0,0
ANDHRA PRADESH,KADAPA,SCHEDULED TRIBES,1.0-2.0,19,SIMHADRIPURAM,34,46,30,16,46,0,0,0,0,0
ANDHRA PRADESH,KADAPA,SCHEDULED TRIBES,1.0-2.0,20,LINGALA,13,19,19,0,19,0,0,0,0,0
ANDHRA PRADESH,KADAPA,SCHEDULED TRIBES,1.0-2.0,21,PULIVENDLA,107,150,150,0,150,0,0,0,0,0
ANDHRA PRADESH,KADAPA,SCHEDULED TRIBES,1.0-2.0,22,VEMULA,61,80,40,40,80,0,0,0,0,0
ANDHRA PRADESH,KADAPA,SCHEDULED TRIBES,1.0-2.0,23,THONDUR,23,28,0,28,28,0,0,0,0,0
ANDHRA PRADESH,KADAPA,SCHEDULED TRIBES,1.0-2.0,24,VEERAPUNAYUNIPALLE,21,31,31,0,31,0,0,0,0,0
ANDHRA PRADESH,KADAPA,SCHEDULED TRIBES,1.0-2.0,25,YERRAGUNTLA,7,9,0,9,9,0,0,0,0,0
ANDHRA PRADESH,KADAPA,SCHEDULED TRIBES,1.0-2.0,26,KAMALAPURAM,5,8,4,4,8,0,0,0,0,0
ANDHRA PRADESH,KADAPA,SCHEDULED TRIBES,1.0-2.0,27,VALLUR,5,7,3,3,6,0,0,0,0,0
ANDHRA PRADESH,KADAPA,SCHEDULED TRIBES,1.0-2.0,28,CHENNUR,0,0,0,0,0,0,0,0,0,0
ANDHRA PRADESH,KADAPA,SCHEDULED TRIBES,1.0-2.0,29,ATLUR,2,3,1,1,2,0,0,0,0,0
ANDHRA PRADESH,KADAPA,SCHEDULED TRIBES,1.0-2.0,30,VONTIMITTA,0,0,0,0,0,0,0,0,0,0
ANDHRA PRADESH,KADAPA,SCHEDULED TRIBES,1.0-2.0,31,SIDHOUT,2,3,2,2,4,0,0,0,0,0
ANDHRA PRADESH,KADAPA,SCHEDULED TRIBES,1.0-2.0,32,CUDDAPAH,20,26,26,0,26,0,0,0,0,0
ANDHRA PRADESH,KADAPA,SCHEDULED TRIBES,1.0-2.0,33,CHINTHAKOMMADINNE,32,40,40,0,40,0,0,0,0,0
ANDHRA PRADESH,KADAPA,SCHEDULED TRIBES,1.0-2.0,34,PENDLIMARRI,2,3,2,2,4,0,0,0,0,0
ANDHRA PRADESH,KADAPA,SCHEDULED TRIBES,1.0-2.0,35,VEMPALLE,48,69,35,34,69,0,0,0,0,0
ANDHRA PRADESH,KADAPA,SCHEDULED TRIBES,1.0-2.0,36,CHAKRAYAPET,121,179,129,34,163,0,14,0,14,3
ANDHRA PRADESH,KADAPA,SCHEDULED TRIBES,1.0-2.0,37,GALIVEEDU,136,191,90,96,186,0,2,0,2,3
ANDHRA PRADESH,KADAPA,SCHEDULED TRIBES,1.0-2.0,38,CHINNAMANDEM,14,19,17,1,18,0,1,0,1,0
ANDHRA PRADESH,KADAPA,SCHEDULED TRIBES,1.0-2.0,39,SAMBEPALLE,162,224,185,28,213,0,8,0,8,2
ANDHRA PRADESH,KADAPA,SCHEDULED TRIBES,1.0-2.0,40,T SUNDUPALLE,205,288,146,127,273,0,12,0,12,3
ANDHRA PRADESH,KADAPA,SCHEDULED TRIBES,1.0-2.0,41,RAYACHOTI,6,8,5,2,7,0,0,0,0,0
ANDHRA PRADESH,KADAPA,SCHEDULED TRIBES,1.0-2.0,42,LAKKIREDDIPALLE,21,29,23,6,29,0,0,0,0,0
ANDHRA PRADESH,KADAPA,SCHEDULED TRIBES,1.0-2.0,43,RAMAPURAM,71,104,52,52,104,0,0,0,0,0
ANDHRA PRADESH,KADAPA,SCHEDULED TRIBES,1.0-2.0,44,VEERABALLE,55,78,63,15,78,0,0,0,0,0
ANDHRA PRADESH,KADAPA,SCHEDULED TRIBES,1.0-2.0,45,NANDALUR,3,4,2,2,4,0,0,0,0,0
ANDHRA PRADESH,KADAPA,SCHEDULED TRIBES,1.0-2.0,46,PENAGALUR,142,177,88,88,176,0,0,0,0,0
ANDHRA PRADESH,KADAPA,SCHEDULED TRIBES,1.0-2.0,47,CHITVEL,20,33,19,0,19,0,11,0,11,3
ANDHRA PRADESH,KADAPA,SCHEDULED TRIBES,1.0-2.0,48,RAJAMPET,4,5,2,0,2,0,0,1,1,2
ANDHRA PRADESH,KADAPA,SCHEDULED TRIBES,1.0-2.0,49,PULLAMPETA,30,49,24,24,48,0,0,0,0,0
ANDHRA PRADESH,KADAPA,SCHEDULED TRIBES,1.0-2.0,50,OBULAVARIPALLE,24,33,6,24,30,0,2,0,2,0
ANDHRA PRADESH,KADAPA,SCHEDULED TRIBES,1.0-2.0,51,KODUR,163,231,107,124,231,0,0,0,0,0
ANDHRA PRADESH,KADAPA,ALL SOCIAL GROUPS,1.0-2.0,1,KONDAPURAM,2928,4190,3484,688,4172,0,11,0,11,6
ANDHRA PRADESH,KADAPA,ALL SOCIAL GROUPS,1.0-2.0,2,MYLAVARAM,2326,3336,3056,280,3336,0,0,0,0,0
ANDHRA PRADESH,KADAPA,ALL SOCIAL GROUPS,1.0-2.0,3,PEDDAMUDIUM,3371,4915,4238,672,4910,0,3,0,3,3
ANDHRA PRADESH,KADAPA,ALL SOCIAL GROUPS,1.0-2.0,4,RAJUPALEM,2905,4183,4136,46,4182,0,0,0,0,1
ANDHRA PRADESH,KADAPA,ALL SOCIAL GROUPS,1.0-2.0,5,DUVVUR,3356,4637,4632,4,4636,1,0,0,1,1
ANDHRA PRADESH,KADAPA,ALL SOCIAL GROUPS,1.0-2.0,6,S.MYDUKUR,3295,4292,4203,87,4290,0,1,0,1,1
ANDHRA PRADESH,KADAPA,ALL SOCIAL GROUPS,1.0-2.0,7,BRAHMAMGARIMATTAM,2561,3620,1862,1759,3621,0,0,0,0,0
ANDHRA PRADESH,KADAPA,ALL SOCIAL GROUPS,1.0-2.0,8,SRI AVADHUTHA KASINAYANA,2378,3412,2154,1258,3412,0,0,0,0,0
ANDHRA PRADESH,KADAPA,ALL SOCIAL GROUPS,1.0-2.0,9,KALASAPADU,1839,2599,1693,903,2596,0,2,0,2,1
ANDHRA PRADESH,KADAPA,ALL SOCIAL GROUPS,1.0-2.0,10,PORUMAMILLA,2269,3175,1662,1513,3175,0,0,0,0,0
ANDHRA PRADESH,KADAPA,ALL SOCIAL GROUPS,1.0-2.0,11,B.KODUR,1702,2425,775,247,1022,0,0,0,0,1404
ANDHRA PRADESH,KADAPA,ALL SOCIAL GROUPS,1.0-2.0,12,BADVEL,1521,2094,730,997,1727,0,170,38,208,159
ANDHRA PRADESH,KADAPA,ALL SOCIAL GROUPS,1.0-2.0,13,GOPAVARAM,1072,1527,862,445,1307,0,16,42,58,162
ANDHRA PRADESH,KADAPA,ALL SOCIAL GROUPS,1.0-2.0,14,KHAJIPET,2643,3578,3386,192,3578,0,0,0,0,0
ANDHRA PRADESH,KADAPA,ALL SOCIAL GROUPS,1.0-2.0,15,CHAPAD,2311,3204,2910,255,3165,0,5,0,5,34
ANDHRA PRADESH,KADAPA,ALL SOCIAL GROUPS,1.0-2.0,16,PRODDATUR,2212,3141,3139,2,3141,0,0,0,0,0
ANDHRA PRADESH,KADAPA,ALL SOCIAL GROUPS,1.0-2.0,17,JAMMALAMADUGU,1909,2715,2591,98,2689,0,16,0,16,9
ANDHRA PRADESH,KADAPA,ALL SOCIAL GROUPS,1.0-2.0,18,MUDDANUR,2620,3776,3479,295,3774,0,0,0,0,1
ANDHRA PRADESH,KADAPA,ALL SOCIAL GROUPS,1.0-2.0,19,SIMHADRIPURAM,4096,6068,4124,1944,6068,0,0,0,0,0
ANDHRA PRADESH,KADAPA,ALL SOCIAL GROUPS,1.0-2.0,20,LINGALA,3564,5203,5149,54,5203,0,0,0,0,0
ANDHRA PRADESH,KADAPA,ALL SOCIAL GROUPS,1.0-2.0,21,PULIVENDLA,2468,3528,3528,0,3528,0,0,0,0,0
ANDHRA PRADESH,KADAPA,ALL SOCIAL GROUPS,1.0-2.0,22,VEMULA,3448,5022,4793,152,4945,0,49,0,49,28
ANDHRA PRADESH,KADAPA,ALL SOCIAL GROUPS,1.0-2.0,23,THONDUR,3528,5170,4199,971,5170,0,0,0,0,0
ANDHRA PRADESH,KADAPA,ALL SOCIAL GROUPS,1.0-2.0,24,VEERAPUNAYUNIPALLE,3641,5313,4391,922,5313,0,0,0,0,0
ANDHRA PRADESH,KADAPA,ALL SOCIAL GROUPS,1.0-2.0,25,YERRAGUNTLA,2860,4106,2278,1828,4106,0,0,0,0,0
ANDHRA PRADESH,KADAPA,ALL SOCIAL GROUPS,1.0-2.0,26,KAMALAPURAM,2845,4065,2735,1329,4064,0,0,0,0,0
ANDHRA PRADESH,KADAPA,ALL SOCIAL GROUPS,1.0-2.0,27,VALLUR,2331,3364,2397,855,3252,0,65,6,71,42
ANDHRA PRADESH,KADAPA,ALL SOCIAL GROUPS,1.0-2.0,28,CHENNUR,950,1302,1115,173,1288,0,9,0,9,5
ANDHRA PRADESH,KADAPA,ALL SOCIAL GROUPS,1.0-2.0,29,ATLUR,1246,1781,583,1197,1780,0,0,0,0,1
ANDHRA PRADESH,KADAPA,ALL SOCIAL GROUPS,1.0-2.0,30,VONTIMITTA,992,1398,527,569,1096,0,206,0,206,97
ANDHRA PRADESH,KADAPA,ALL SOCIAL GROUPS,1.0-2.0,31,SIDHOUT,925,1310,847,162,1009,0,0,176,176,124
ANDHRA PRADESH,KADAPA,ALL SOCIAL GROUPS,1.0-2.0,32,CUDDAPAH,605,845,817,27,844,0,0,0,0,0
ANDHRA PRADESH,KADAPA,ALL SOCIAL GROUPS,1.0-2.0,33,CHINTHAKOMMADINNE,1777,2530,2403,127,2530,0,0,0,0,0
ANDHRA PRADESH,KADAPA,ALL SOCIAL GROUPS,1.0-2.0,34,PENDLIMARRI,3011,4355,3659,697,4356,0,0,0,0,0
ANDHRA PRADESH,KADAPA,ALL SOCIAL GROUPS,1.0-2.0,35,VEMPALLE,2352,3426,3348,75,3423,0,2,0,2,1
ANDHRA PRADESH,KADAPA,ALL SOCIAL GROUPS,1.0-2.0,36,CHAKRAYAPET,2447,3560,2993,419,3412,14,65,15,94,53
ANDHRA PRADESH,KADAPA,ALL SOCIAL GROUPS,1.0-2.0,37,GALIVEEDU,3510,4883,2535,2080,4615,0,155,1,156,112
ANDHRA PRADESH,KADAPA,ALL SOCIAL GROUPS,1.0-2.0,38,CHINNAMANDEM,2345,3354,2947,114,3061,0,180,1,181,113
ANDHRA PRADESH,KADAPA,ALL SOCIAL GROUPS,1.0-2.0,39,SAMBEPALLE,3503,5117,4185,316,4501,0,385,18,403,213
ANDHRA PRADESH,KADAPA,ALL SOCIAL GROUPS,1.0-2.0,40,T SUNDUPALLE,3777,5429,2381,2707,5088,14,207,0,221,119
ANDHRA PRADESH,KADAPA,ALL SOCIAL GROUPS,1.0-2.0,41,RAYACHOTI,2835,4044,1652,1989,3641,0,251,0,251,152
ANDHRA PRADESH,KADAPA,ALL SOCIAL GROUPS,1.0-2.0,42,LAKKIREDDIPALLE,3060,4427,3544,795,4339,0,37,0,37,51
ANDHRA PRADESH,KADAPA,ALL SOCIAL GROUPS,1.0-2.0,43,RAMAPURAM,2975,4419,3801,472,4273,0,95,0,95,52
ANDHRA PRADESH,KADAPA,ALL SOCIAL GROUPS,1.0-2.0,44,VEERABALLE,2426,3445,2585,843,3428,0,0,0,0,17
ANDHRA PRADESH,KADAPA,ALL SOCIAL GROUPS,1.0-2.0,45,NANDALUR,711,1007,618,378,996,0,5,2,7,4
ANDHRA PRADESH,KADAPA,ALL SOCIAL GROUPS,1.0-2.0,46,PENAGALUR,1919,2810,982,1274,2256,6,358,0,364,189
ANDHRA PRADESH,KADAPA,ALL SOCIAL GROUPS,1.0-2.0,47,CHITVEL,1766,2623,759,1831,2590,0,22,0,22,10
ANDHRA PRADESH,KADAPA,ALL SOCIAL GROUPS,1.0-2.0,48,RAJAMPET,2357,3376,1533,886,2419,237,133,220,590,369
ANDHRA PRADESH,KADAPA,ALL SOCIAL GROUPS,1.0-2.0,49,PULLAMPETA,1997,2995,1003,902,1905,0,749,0,749,342
ANDHRA PRADESH,KADAPA,ALL SOCIAL GROUPS,1.0-2.0,50,OBULAVARIPALLE,1971,2914,1153,1444,2597,0,203,0,203,115
ANDHRA PRADESH,KADAPA,ALL SOCIAL GROUPS,1.0-2.0,51,KODUR,2018,2982,1525,1457,2982,0,0,0,0,0
ANDHRA PRADESH,KADAPA,INSTITUTIONAL,0.5-1.0,1,KONDAPURAM,0,0,0,0,0,0,0,0,0,0
ANDHRA PRADESH,KADAPA,INSTITUTIONAL,0.5-1.0,2,MYLAVARAM,0,0,0,0,0,0,0,0,0,0
ANDHRA PRADESH,KADAPA,INSTITUTIONAL,0.5-1.0,3,PEDDAMUDIUM,0,0,0,0,0,0,0,0,0,0
ANDHRA PRADESH,KADAPA,INSTITUTIONAL,0.5-1.0,4,RAJUPALEM,0,0,0,0,0,0,0,0,0,0
ANDHRA PRADESH,KADAPA,INSTITUTIONAL,0.5-1.0,5,DUVVUR,0,0,0,0,0,0,0,0,0,0
ANDHRA PRADESH,KADAPA,INSTITUTIONAL,0.5-1.0,6,S.MYDUKUR,0,0,0,0,0,0,0,0,0,0
ANDHRA PRADESH,KADAPA,INSTITUTIONAL,0.5-1.0,7,BRAHMAMGARIMATTAM,1,1,0,1,1,0,0,0,0,0
ANDHRA PRADESH,KADAPA,INSTITUTIONAL,0.5-1.0,8,SRI AVADHUTHA KASINAYANA,0,0,0,0,0,0,0,0,0,0
ANDHRA PRADESH,KADAPA,INSTITUTIONAL,0.5-1.0,9,KALASAPADU,0,0,0,0,0,0,0,0,0,0
ANDHRA PRADESH,KADAPA,INSTITUTIONAL,0.5-1.0,10,PORUMAMILLA,0,0,0,0,0,0,0,0,0,0
ANDHRA PRADESH,KADAPA,INSTITUTIONAL,0.5-1.0,11,B.KODUR,0,0,0,0,0,0,0,0,0,0
ANDHRA PRADESH,KADAPA,INSTITUTIONAL,0.5-1.0,12,BADVEL,0,0,0,0,0,0,0,0,0,0
ANDHRA PRADESH,KADAPA,INSTITUTIONAL,0.5-1.0,13,GOPAVARAM,0,0,0,0,0,0,0,0,0,0
ANDHRA PRADESH,KADAPA,INSTITUTIONAL,0.5-1.0,14,KHAJIPET,0,0,0,0,0,0,0,0,0,0
ANDHRA PRADESH,KADAPA,INSTITUTIONAL,0.5-1.0,15,CHAPAD,0,0,0,0,0,0,0,0,0,0
ANDHRA PRADESH,KADAPA,INSTITUTIONAL,0.5-1.0,16,PRODDATUR,0,0,0,0,0,0,0,0,0,0
ANDHRA PRADESH,KADAPA,INSTITUTIONAL,0.5-1.0,17,JAMMALAMADUGU,0,0,0,0,0,0,0,0,0,0
ANDHRA PRADESH,KADAPA,INSTITUTIONAL,0.5-1.0,18,MUDDANUR,0,0,0,0,0,0,0,0,0,0
ANDHRA PRADESH,KADAPA,INSTITUTIONAL,0.5-1.0,19,SIMHADRIPURAM,0,0,0,0,0,0,0,0,0,0
ANDHRA PRADESH,KADAPA,INSTITUTIONAL,0.5-1.0,20,LINGALA,0,0,0,0,0,0,0,0,0,0
ANDHRA PRADESH,KADAPA,INSTITUTIONAL,0.5-1.0,21,PULIVENDLA,0,0,0,0,0,0,0,0,0,0
ANDHRA PRADESH,KADAPA,INSTITUTIONAL,0.5-1.0,22,VEMULA,0,0,0,0,0,0,0,0,0,0
ANDHRA PRADESH,KADAPA,INSTITUTIONAL,0.5-1.0,23,THONDUR,0,0,0,0,0,0,0,0,0,0
ANDHRA PRADESH,KADAPA,INSTITUTIONAL,0.5-1.0,24,VEERAPUNAYUNIPALLE,0,0,0,0,0,0,0,0,0,0
ANDHRA PRADESH,KADAPA,INSTITUTIONAL,0.5-1.0,25,YERRAGUNTLA,0,0,0,0,0,0,0,0,0,0
ANDHRA PRADESH,KADAPA,INSTITUTIONAL,0.5-1.0,26,KAMALAPURAM,0,0,0,0,0,0,0,0,0,0
ANDHRA PRADESH,KADAPA,INSTITUTIONAL,0.5-1.0,27,VALLUR,0,0,0,0,0,0,0,0,0,0
ANDHRA PRADESH,KADAPA,INSTITUTIONAL,0.5-1.0,28,CHENNUR,0,0,0,0,0,0,0,0,0,0
ANDHRA PRADESH,KADAPA,INSTITUTIONAL,0.5-1.0,29,ATLUR,0,0,0,0,0,0,0,0,0,0
ANDHRA PRADESH,KADAPA,INSTITUTIONAL,0.5-1.0,30,VONTIMITTA,0,0,0,0,0,0,0,0,0,0
ANDHRA PRADESH,KADAPA,INSTITUTIONAL,0.5-1.0,31,SIDHOUT,0,0,0,0,0,0,0,0,0,0
ANDHRA PRADESH,KADAPA,INSTITUTIONAL,0.5-1.0,32,CUDDAPAH,0,0,0,0,0,0,0,0,0,0
ANDHRA PRADESH,KADAPA,INSTITUTIONAL,0.5-1.0,33,CHINTHAKOMMADINNE,0,0,0,0,0,0,0,0,0,0
ANDHRA PRADESH,KADAPA,INSTITUTIONAL,0.5-1.0,34,PENDLIMARRI,0,0,0,0,0,0,0,0,0,0
ANDHRA PRADESH,KADAPA,INSTITUTIONAL,0.5-1.0,35,VEMPALLE,0,0,0,0,0,0,0,0,0,0
ANDHRA PRADESH,KADAPA,INSTITUTIONAL,0.5-1.0,36,CHAKRAYAPET,0,0,0,0,0,0,0,0,0,0
ANDHRA PRADESH,KADAPA,INSTITUTIONAL,0.5-1.0,37,GALIVEEDU,0,0,0,0,0,0,0,0,0,0
ANDHRA PRADESH,KADAPA,INSTITUTIONAL,0.5-1.0,38,CHINNAMANDEM,0,0,0,0,0,0,0,0,0,0
ANDHRA PRADESH,KADAPA,INSTITUTIONAL,0.5-1.0,39,SAMBEPALLE,0,0,0,0,0,0,0,0,0,0
ANDHRA PRADESH,KADAPA,INSTITUTIONAL,0.5-1.0,40,T SUNDUPALLE,0,0,0,0,0,0,0,0,0,0
ANDHRA PRADESH,KADAPA,INSTITUTIONAL,0.5-1.0,41,RAYACHOTI,0,0,0,0,0,0,0,0,0,0
ANDHRA PRADESH,KADAPA,INSTITUTIONAL,0.5-1.0,42,LAKKIREDDIPALLE,0,0,0,0,0,0,0,0,0,0
ANDHRA PRADESH,KADAPA,INSTITUTIONAL,0.5-1.0,43,RAMAPURAM,0,0,0,0,0,0,0,0,0,0
ANDHRA PRADESH,KADAPA,INSTITUTIONAL,0.5-1.0,44,VEERABALLE,0,0,0,0,0,0,0,0,0,0
ANDHRA PRADESH,KADAPA,INSTITUTIONAL,0.5-1.0,45,NANDALUR,0,0,0,0,0,0,0,0,0,0
ANDHRA PRADESH,KADAPA,INSTITUTIONAL,0.5-1.0,46,PENAGALUR,0,0,0,0,0,0,0,0,0,0
ANDHRA PRADESH,KADAPA,INSTITUTIONAL,0.5-1.0,47,CHITVEL,0,0,0,0,0,0,0,0,0,0
ANDHRA PRADESH,KADAPA,INSTITUTIONAL,0.5-1.0,48,RAJAMPET,0,0,0,0,0,0,0,0,0,0
ANDHRA PRADESH,KADAPA,INSTITUTIONAL,0.5-1.0,49,PULLAMPETA,0,0,0,0,0,0,0,0,0,0
ANDHRA PRADESH,KADAPA,INSTITUTIONAL,0.5-1.0,50,OBULAVARIPALLE,0,0,0,0,0,0,0,0,0,0
ANDHRA PRADESH,KADAPA,INSTITUTIONAL,0.5-1.0,51,KODUR,0,0,0,0,0,0,0,0,0,0
ANDHRA PRADESH,KADAPA,SCHEDULED CASTE,0.5-1.0,1,KONDAPURAM,236,168,137,31,168,0,0,0,0,0
ANDHRA PRADESH,KADAPA,SCHEDULED CASTE,0.5-1.0,2,MYLAVARAM,465,339,331,8,339,0,0,0,0,0
ANDHRA PRADESH,KADAPA,SCHEDULED CASTE,0.5-1.0,3,PEDDAMUDIUM,76,56,51,5,56,0,0,0,0,0
ANDHRA PRADESH,KADAPA,SCHEDULED CASTE,0.5-1.0,4,RAJUPALEM,216,155,143,12,155,0,0,0,0,0
ANDHRA PRADESH,KADAPA,SCHEDULED CASTE,0.5-1.0,5,DUVVUR,253,178,176,1,177,0,0,0,0,0
ANDHRA PRADESH,KADAPA,SCHEDULED CASTE,0.5-1.0,6,S.MYDUKUR,547,361,357,5,362,0,0,0,0,0
ANDHRA PRADESH,KADAPA,SCHEDULED CASTE,0.5-1.0,7,BRAHMAMGARIMATTAM,1052,699,207,493,700,0,0,0,0,0
ANDHRA PRADESH,KADAPA,SCHEDULED CASTE,0.5-1.0,8,SRI AVADHUTHA KASINAYANA,455,315,235,80,315,0,0,0,0,0
ANDHRA PRADESH,KADAPA,SCHEDULED CASTE,0.5-1.0,9,KALASAPADU,360,250,250,0,250,0,0,0,0,0
ANDHRA PRADESH,KADAPA,SCHEDULED CASTE,0.5-1.0,10,PORUMAMILLA,528,374,148,227,375,0,0,0,0,0
ANDHRA PRADESH,KADAPA,SCHEDULED CASTE,0.5-1.0,11,B.KODUR,378,253,118,0,118,0,0,0,0,135
ANDHRA PRADESH,KADAPA,SCHEDULED CASTE,0.5-1.0,12,BADVEL,711,470,132,294,426,0,30,0,30,14
ANDHRA PRADESH,KADAPA,SCHEDULED CASTE,0.5-1.0,13,GOPAVARAM,383,255,125,125,250,0,0,2,2,3
ANDHRA PRADESH,KADAPA,SCHEDULED CASTE,0.5-1.0,14,KHAJIPET,358,257,228,29,257,0,0,0,0,0
ANDHRA PRADESH,KADAPA,SCHEDULED CASTE,0.5-1.0,15,CHAPAD,32,23,23,0,23,0,0,0,0,0
ANDHRA PRADESH,KADAPA,SCHEDULED CASTE,0.5-1.0,16,PRODDATUR,94,69,69,0,69,0,0,0,0,0
ANDHRA PRADESH,KADAPA,SCHEDULED CASTE,0.5-1.0,17,JAMMALAMADUGU,37,27,27,0,27,0,0,0,0,0
ANDHRA PRADESH,KADAPA,SCHEDULED CASTE,0.5-1.0,18,MUDDANUR,251,180,168,12,180,0,0,0,0,0
ANDHRA PRADESH,KADAPA,SCHEDULED CASTE,0.5-1.0,19,SIMHADRIPURAM,106,81,52,29,81,0,0,0,0,0
ANDHRA PRADESH,KADAPA,SCHEDULED CASTE,0.5-1.0,20,LINGALA,113,90,86,4,90,0,0,0,0,0
ANDHRA PRADESH,KADAPA,SCHEDULED CASTE,0.5-1.0,21,PULIVENDLA,101,72,72,0,72,0,0,0,0,0
ANDHRA PRADESH,KADAPA,SCHEDULED CASTE,0.5-1.0,22,VEMULA,233,173,173,0,173,0,0,0,0,0
ANDHRA PRADESH,KADAPA,SCHEDULED CASTE,0.5-1.0,23,THONDUR,269,197,126,71,197,0,0,0,0,0
ANDHRA PRADESH,KADAPA,SCHEDULED CASTE,0.5-1.0,24,VEERAPUNAYUNIPALLE,242,179,171,8,179,0,0,0,0,0
ANDHRA PRADESH,KADAPA,SCHEDULED CASTE,0.5-1.0,25,YERRAGUNTLA,98,70,51,19,70,0,0,0,0,0
ANDHRA PRADESH,KADAPA,SCHEDULED CASTE,0.5-1.0,26,KAMALAPURAM,186,133,97,36,133,0,0,0,0,0
ANDHRA PRADESH,KADAPA,SCHEDULED CASTE,0.5-1.0,27,VALLUR,330,228,83,144,227,0,0,0,0,0
ANDHRA PRADESH,KADAPA,SCHEDULED CASTE,0.5-1.0,28,CHENNUR,66,44,37,7,44,0,0,0,0,0
ANDHRA PRADESH,KADAPA,SCHEDULED CASTE,0.5-1.0,29,ATLUR,367,238,87,151,238,0,0,0,0,0
ANDHRA PRADESH,KADAPA,SCHEDULED CASTE,0.5-1.0,30,VONTIMITTA,304,208,152,33,185,0,24,0,24,0
ANDHRA PRADESH,KADAPA,SCHEDULED CASTE,0.5-1.0,31,SIDHOUT,383,258,86,125,211,0,9,14,23,24
ANDHRA PRADESH,KADAPA,SCHEDULED CASTE,0.5-1.0,32,CUDDAPAH,56,39,28,10,38,0,0,0,0,0
ANDHRA PRADESH,KADAPA,SCHEDULED CASTE,0.5-1.0,33,CHINTHAKOMMADINNE,151,102,89,12,101,0,0,0,0,0
ANDHRA PRADESH,KADAPA,SCHEDULED CASTE,0.5-1.0,34,PENDLIMARRI,237,169,122,48,170,0,0,0,0,0
ANDHRA PRADESH,KADAPA,SCHEDULED CASTE,0.5-1.0,35,VEMPALLE,129,97,97,0,97,0,0,0,0,0
ANDHRA PRADESH,KADAPA,SCHEDULED CASTE,0.5-1.0,36,CHAKRAYAPET,169,128,121,4,125,0,0,0,0,3
ANDHRA PRADESH,KADAPA,SCHEDULED CASTE,0.5-1.0,37,GALIVEEDU,88,70,18,52,70,0,0,0,0,0
ANDHRA PRADESH,KADAPA,SCHEDULED CASTE,0.5-1.0,38,CHINNAMANDEM,150,111,106,2,108,0,4,0,4,0
ANDHRA PRADESH,KADAPA,SCHEDULED CASTE,0.5-1.0,39,SAMBEPALLE,277,203,184,16,200,0,3,0,3,0
ANDHRA PRADESH,KADAPA,SCHEDULED CASTE,0.5-1.0,40,T SUNDUPALLE,265,195,85,105,190,0,5,0,5,0
ANDHRA PRADESH,KADAPA,SCHEDULED CASTE,0.5-1.0,41,RAYACHOTI,171,124,60,60,120,0,4,0,4,0
ANDHRA PRADESH,KADAPA,SCHEDULED CASTE,0.5-1.0,42,LAKKIREDDIPALLE,243,177,66,111,177,0,0,0,0,0
ANDHRA PRADESH,KADAPA,SCHEDULED CASTE,0.5-1.0,43,RAMAPURAM,236,182,177,4,181,0,1,0,1,0
ANDHRA PRADESH,KADAPA,SCHEDULED CASTE,0.5-1.0,44,VEERABALLE,244,181,137,45,182,0,0,0,0,0
ANDHRA PRADESH,KADAPA,SCHEDULED CASTE,0.5-1.0,45,NANDALUR,169,114,57,57,114,0,0,0,0,0
ANDHRA PRADESH,KADAPA,SCHEDULED CASTE,0.5-1.0,46,PENAGALUR,260,177,57,118,175,0,2,0,2,0
ANDHRA PRADESH,KADAPA,SCHEDULED CASTE,0.5-1.0,47,CHITVEL,251,162,121,41,162,0,0,0,0,0
ANDHRA PRADESH,KADAPA,SCHEDULED CASTE,0.5-1.0,48,RAJAMPET,429,298,79,153,232,24,7,4,35,31
ANDHRA PRADESH,KADAPA,SCHEDULED CASTE,0.5-1.0,49,PULLAMPETA,694,445,69,350,419,0,27,0,27,0
ANDHRA PRADESH,KADAPA,SCHEDULED CASTE,0.5-1.0,50,OBULAVARIPALLE,173,119,77,42,119,0,0,0,0,0
ANDHRA PRADESH,KADAPA,SCHEDULED CASTE,0.5-1.0,51,KODUR,312,227,139,88,227,0,0,0,0,0
ANDHRA PRADESH,KADAPA,OTHERS,0.5-1.0,1,KONDAPURAM,1547,1137,966,163,1129,0,5,0,5,3
ANDHRA PRADESH,KADAPA,OTHERS,0.5-1.0,2,MYLAVARAM,1970,1466,1273,193,1466,0,0,0,0,0
ANDHRA PRADESH,KADAPA,OTHERS,0.5-1.0,3,PEDDAMUDIUM,1972,1499,1225,271,1496,0,1,0,1,2
ANDHRA PRADESH,KADAPA,OTHERS,0.5-1.0,4,RAJUPALEM,2318,1723,1717,5,1722,0,0,0,0,1
ANDHRA PRADESH,KADAPA,OTHERS,0.5-1.0,5,DUVVUR,3391,2468,2466,2,2468,0,0,0,0,0
ANDHRA PRADESH,KADAPA,OTHERS,0.5-1.0,6,S.MYDUKUR,3505,2471,2351,120,2471,0,0,0,0,0
ANDHRA PRADESH,KADAPA,OTHERS,0.5-1.0,7,BRAHMAMGARIMATTAM,3258,2241,1052,1189,2241,0,0,0,0,0
ANDHRA PRADESH,KADAPA,OTHERS,0.5-1.0,8,SRI AVADHUTHA KASINAYANA,2135,1553,1045,508,1553,0,0,0,0,0
ANDHRA PRADESH,KADAPA,OTHERS,0.5-1.0,9,KALASAPADU,2028,1468,1128,340,1468,0,0,0,0,0
ANDHRA PRADESH,KADAPA,OTHERS,0.5-1.0,10,PORUMAMILLA,2416,1740,632,1108,1740,0,0,0,0,0
ANDHRA PRADESH,KADAPA,OTHERS,0.5-1.0,11,B.KODUR,1618,1139,608,64,672,0,0,0,0,468
ANDHRA PRADESH,KADAPA,OTHERS,0.5-1.0,12,BADVEL,3094,2123,1098,795,1893,0,35,16,51,180
ANDHRA PRADESH,KADAPA,OTHERS,0.5-1.0,13,GOPAVARAM,1495,1040,903,125,1028,0,0,0,0,11
ANDHRA PRADESH,KADAPA,OTHERS,0.5-1.0,14,KHAJIPET,3340,2456,2329,127,2456,0,0,0,0,0
ANDHRA PRADESH,KADAPA,OTHERS,0.5-1.0,15,CHAPAD,3129,2283,2118,157,2275,0,0,0,0,8
ANDHRA PRADESH,KADAPA,OTHERS,0.5-1.0,16,PRODDATUR,2210,1637,1621,16,1637,0,0,0,0,0
ANDHRA PRADESH,KADAPA,OTHERS,0.5-1.0,17,JAMMALAMADUGU,1713,1269,1230,38,1268,0,1,0,1,0
ANDHRA PRADESH,KADAPA,OTHERS,0.5-1.0,18,MUDDANUR,1833,1352,1306,46,1352,0,0,0,0,0
ANDHRA PRADESH,KADAPA,OTHERS,0.5-1.0,19,SIMHADRIPURAM,1540,1189,750,439,1189,0,0,0,0,0
ANDHRA PRADESH,KADAPA,OTHERS,0.5-1.0,20,LINGALA,1459,1118,1106,12,1118,0,0,0,0,0
ANDHRA PRADESH,KADAPA,OTHERS,0.5-1.0,21,PULIVENDLA,1764,1323,1323,0,1323,0,0,0,0,0
ANDHRA PRADESH,KADAPA,OTHERS,0.5-1.0,22,VEMULA,1439,1106,1083,21,1104,0,1,0,1,1
ANDHRA PRADESH,KADAPA,OTHERS,0.5-1.0,23,THONDUR,1386,1074,892,182,1074,0,0,0,0,0
ANDHRA PRADESH,KADAPA,OTHERS,0.5-1.0,24,VEERAPUNAYUNIPALLE,1405,1075,827,248,1075,0,0,0,0,0
ANDHRA PRADESH,KADAPA,OTHERS,0.5-1.0,25,YERRAGUNTLA,2241,1677,728,949,1677,0,0,0,0,0
ANDHRA PRADESH,KADAPA,OTHERS,0.5-1.0,26,KAMALAPURAM,2080,1550,1001,550,1551,0,0,0,0,0
ANDHRA PRADESH,KADAPA,OTHERS,0.5-1.0,27,VALLUR,1787,1328,923,368,1291,0,20,1,21,16
ANDHRA PRADESH,KADAPA,OTHERS,0.5-1.0,28,CHENNUR,1435,1016,940,77,1017,0,0,0,0,0
ANDHRA PRADESH,KADAPA,OTHERS,0.5-1.0,29,ATLUR,1900,1289,304,983,1287,0,0,0,0,1
ANDHRA PRADESH,KADAPA,OTHERS,0.5-1.0,30,VONTIMITTA,1311,930,476,396,872,0,37,0,37,21
ANDHRA PRADESH,KADAPA,OTHERS,0.5-1.0,31,SIDHOUT,1538,1049,724,229,953,0,5,56,61,37
ANDHRA PRADESH,KADAPA,OTHERS,0.5-1.0,32,CUDDAPAH,1070,762,724,38,762,0,0,0,0,0
ANDHRA PRADESH,KADAPA,OTHERS,0.5-1.0,33,CHINTHAKOMMADINNE,2017,1439,1351,87,1438,0,0,0,0,0
ANDHRA PRADESH,KADAPA,OTHERS,0.5-1.0,34,PENDLIMARRI,2477,1809,1594,215,1809,0,0,0,0,0
ANDHRA PRADESH,KADAPA,OTHERS,0.5-1.0,35,VEMPALLE,1024,785,775,8,783,0,1,0,1,1
ANDHRA PRADESH,KADAPA,OTHERS,0.5-1.0,36,CHAKRAYAPET,1702,1268,1084,171,1255,0,0,6,6,7
ANDHRA PRADESH,KADAPA,OTHERS,0.5-1.0,37,GALIVEEDU,2261,1658,778,795,1573,1,52,0,53,32
ANDHRA PRADESH,KADAPA,OTHERS,0.5-1.0,38,CHINNAMANDEM,1767,1323,1211,43,1254,0,42,0,42,27
ANDHRA PRADESH,KADAPA,OTHERS,0.5-1.0,39,SAMBEPALLE,2254,1682,1452,154,1606,0,42,6,48,28
ANDHRA PRADESH,KADAPA,OTHERS,0.5-1.0,40,T SUNDUPALLE,2544,1895,819,1016,1835,8,29,0,37,23
ANDHRA PRADESH,KADAPA,OTHERS,0.5-1.0,41,RAYACHOTI,2382,1768,806,864,1670,0,60,0,60,38
ANDHRA PRADESH,KADAPA,OTHERS,0.5-1.0,42,LAKKIREDDIPALLE,1966,1475,891,584,1475,0,0,0,0,0
ANDHRA PRADESH,KADAPA,OTHERS,0.5-1.0,43,RAMAPURAM,1889,1411,1187,197,1384,0,18,0,18,10
ANDHRA PRADESH,KADAPA,OTHERS,0.5-1.0,44,VEERABALLE,1602,1183,915,264,1179,0,0,0,0,4
ANDHRA PRADESH,KADAPA,OTHERS,0.5-1.0,45,NANDALUR,996,698,424,274,698,0,0,0,0,0
ANDHRA PRADESH,KADAPA,OTHERS,0.5-1.0,46,PENAGALUR,1964,1431,539,848,1387,2,26,0,28,16
ANDHRA PRADESH,KADAPA,OTHERS,0.5-1.0,47,CHITVEL,1737,1231,804,424,1228,0,1,0,1,2
ANDHRA PRADESH,KADAPA,OTHERS,0.5-1.0,48,RAJAMPET,2305,1656,999,411,1410,76,55,25,156,89
ANDHRA PRADESH,KADAPA,OTHERS,0.5-1.0,49,PULLAMPETA,1760,1242,393,572,965,2,174,0,176,100
ANDHRA PRADESH,KADAPA,OTHERS,0.5-1.0,50,OBULAVARIPALLE,1958,1378,599,730,1329,0,31,0,31,18
ANDHRA PRADESH,KADAPA,OTHERS,0.5-1.0,51,KODUR,1545,1103,506,597,1103,0,0,0,0,0
ANDHRA PRADESH,KADAPA,SCHEDULED TRIBES,0.5-1.0,1,KONDAPURAM,2,1,1,1,2,0,0,0,0,0
ANDHRA PRADESH,KADAPA,SCHEDULED TRIBES,0.5-1.0,2,MYLAVARAM,137,94,75,19,94,0,0,0,0,0
ANDHRA PRADESH,KADAPA,SCHEDULED TRIBES,0.5-1.0,3,PEDDAMUDIUM,5,4,2,2,4,0,0,0,0,0
ANDHRA PRADESH,KADAPA,SCHEDULED TRIBES,0.5-1.0,4,RAJUPALEM,18,13,6,6,12,0,0,0,0,0
ANDHRA PRADESH,KADAPA,SCHEDULED TRIBES,0.5-1.0,5,DUVVUR,1,1,0,0,0,0,0,0,0,0
ANDHRA PRADESH,KADAPA,SCHEDULED TRIBES,0.5-1.0,6,S.MYDUKUR,44,28,28,0,28,0,0,0,0,0
ANDHRA PRADESH,KADAPA,SCHEDULED TRIBES,0.5-1.0,7,BRAHMAMGARIMATTAM,52,33,16,16,32,0,0,0,0,0
ANDHRA PRADESH,KADAPA,SCHEDULED TRIBES,0.5-1.0,8,SRI AVADHUTHA KASINAYANA,69,50,0,50,50,0,0,0,0,0
ANDHRA PRADESH,KADAPA,SCHEDULED TRIBES,0.5-1.0,9,KALASAPADU,8,6,3,3,6,0,0,0,0,0
ANDHRA PRADESH,KADAPA,SCHEDULED TRIBES,0.5-1.0,10,PORUMAMILLA,136,94,22,72,94,0,0,0,0,0
ANDHRA PRADESH,KADAPA,SCHEDULED TRIBES,0.5-1.0,11,B.KODUR,18,13,10,0,10,0,0,0,0,3
ANDHRA PRADESH,KADAPA,SCHEDULED TRIBES,0.5-1.0,12,BADVEL,96,59,44,9,53,0,0,2,2,4
ANDHRA PRADESH,KADAPA,SCHEDULED TRIBES,0.5-1.0,13,GOPAVARAM,36,26,26,0,26,0,0,0,0,0
ANDHRA PRADESH,KADAPA,SCHEDULED TRIBES,0.5-1.0,14,KHAJIPET,18,14,7,7,14,0,0,0,0,0
ANDHRA PRADESH,KADAPA,SCHEDULED TRIBES,0.5-1.0,15,CHAPAD,56,42,42,0,42,0,0,0,0,0
ANDHRA PRADESH,KADAPA,SCHEDULED TRIBES,0.5-1.0,16,PRODDATUR,1,1,0,0,0,0,0,0,0,0
ANDHRA PRADESH,KADAPA,SCHEDULED TRIBES,0.5-1.0,17,JAMMALAMADUGU,42,28,17,10,27,0,0,0,0,0
ANDHRA PRADESH,KADAPA,SCHEDULED TRIBES,0.5-1.0,18,MUDDANUR,28,19,10,10,20,0,0,0,0,0
ANDHRA PRADESH,KADAPA,SCHEDULED TRIBES,0.5-1.0,19,SIMHADRIPURAM,18,15,11,4,15,0,0,0,0,0
ANDHRA PRADESH,KADAPA,SCHEDULED TRIBES,0.5-1.0,20,LINGALA,2,2,1,1,2,0,0,0,0,0
ANDHRA PRADESH,KADAPA,SCHEDULED TRIBES,0.5-1.0,21,PULIVENDLA,98,72,72,0,72,0,0,0,0,0
ANDHRA PRADESH,KADAPA,SCHEDULED TRIBES,0.5-1.0,22,VEMULA,18,15,7,7,14,0,0,0,0,0
ANDHRA PRADESH,KADAPA,SCHEDULED TRIBES,0.5-1.0,23,THONDUR,46,38,3,35,38,0,0,0,0,0
ANDHRA PRADESH,KADAPA,SCHEDULED TRIBES,0.5-1.0,24,VEERAPUNAYUNIPALLE,59,37,37,0,37,0,0,0,0,0
ANDHRA PRADESH,KADAPA,SCHEDULED TRIBES,0.5-1.0,25,YERRAGUNTLA,9,7,3,3,6,0,0,0,0,0
ANDHRA PRADESH,KADAPA,SCHEDULED TRIBES,0.5-1.0,26,KAMALAPURAM,1,1,1,0,1,0,0,0,0,0
ANDHRA PRADESH,KADAPA,SCHEDULED TRIBES,0.5-1.0,27,VALLUR,6,5,5,0,5,0,0,0,0,0
ANDHRA PRADESH,KADAPA,SCHEDULED TRIBES,0.5-1.0,28,CHENNUR,3,2,1,1,2,0,0,0,0,0
ANDHRA PRADESH,KADAPA,SCHEDULED TRIBES,0.5-1.0,29,ATLUR,38,25,0,25,25,0,0,0,0,0
ANDHRA PRADESH,KADAPA,SCHEDULED TRIBES,0.5-1.0,30,VONTIMITTA,13,8,4,4,8,0,0,0,0,0
ANDHRA PRADESH,KADAPA,SCHEDULED TRIBES,0.5-1.0,31,SIDHOUT,26,18,18,0,18,0,0,0,0,0
ANDHRA PRADESH,KADAPA,SCHEDULED TRIBES,0.5-1.0,32,CUDDAPAH,38,27,27,0,27,0,0,0,0,0
ANDHRA PRADESH,KADAPA,SCHEDULED TRIBES,0.5-1.0,33,CHINTHAKOMMADINNE,78,57,56,1,57,0,0,0,0,0
ANDHRA PRADESH,KADAPA,SCHEDULED TRIBES,0.5-1.0,34,PENDLIMARRI,5,3,2,2,4,0,0,0,0,0
ANDHRA PRADESH,KADAPA,SCHEDULED TRIBES,0.5-1.0,35,VEMPALLE,35,27,13,13,26,0,0,0,0,0
ANDHRA PRADESH,KADAPA,SCHEDULED TRIBES,0.5-1.0,36,CHAKRAYAPET,103,77,77,0,77,0,0,0,0,0
ANDHRA PRADESH,KADAPA,SCHEDULED TRIBES,0.5-1.0,37,GALIVEEDU,129,94,0,94,94,0,0,0,0,0
ANDHRA PRADESH,KADAPA,SCHEDULED TRIBES,0.5-1.0,38,CHINNAMANDEM,12,10,8,1,9,0,1,0,1,0
ANDHRA PRADESH,KADAPA,SCHEDULED TRIBES,0.5-1.0,39,SAMBEPALLE,166,130,116,6,122,0,6,0,6,1
ANDHRA PRADESH,KADAPA,SCHEDULED TRIBES,0.5-1.0,40,T SUNDUPALLE,324,233,151,83,234,0,0,0,0,0
ANDHRA PRADESH,KADAPA,SCHEDULED TRIBES,0.5-1.0,41,RAYACHOTI,6,4,2,1,3,0,1,0,1,0
ANDHRA PRADESH,KADAPA,SCHEDULED TRIBES,0.5-1.0,42,LAKKIREDDIPALLE,24,17,9,8,17,0,0,0,0,0
ANDHRA PRADESH,KADAPA,SCHEDULED TRIBES,0.5-1.0,43,RAMAPURAM,65,49,25,25,50,0,0,0,0,0
ANDHRA PRADESH,KADAPA,SCHEDULED TRIBES,0.5-1.0,44,VEERABALLE,26,21,16,5,21,0,0,0,0,0
ANDHRA PRADESH,KADAPA,SCHEDULED TRIBES,0.5-1.0,45,NANDALUR,20,13,9,4,13,0,0,0,0,0
ANDHRA PRADESH,KADAPA,SCHEDULED TRIBES,0.5-1.0,46,PENAGALUR,264,166,97,69,166,0,0,0,0,0
ANDHRA PRADESH,KADAPA,SCHEDULED TRIBES,0.5-1.0,47,CHITVEL,82,53,26,27,53,0,0,0,0,0
ANDHRA PRADESH,KADAPA,SCHEDULED TRIBES,0.5-1.0,48,RAJAMPET,33,23,10,13,23,0,0,0,0,0
ANDHRA PRADESH,KADAPA,SCHEDULED TRIBES,0.5-1.0,49,PULLAMPETA,64,40,20,20,40,0,0,0,0,0
ANDHRA PRADESH,KADAPA,SCHEDULED TRIBES,0.5-1.0,50,OBULAVARIPALLE,102,66,39,28,67,0,0,0,0,0
ANDHRA PRADESH,KADAPA,SCHEDULED TRIBES,0.5-1.0,51,KODUR,320,221,79,142,221,0,0,0,0,0
ANDHRA PRADESH,KADAPA,ALL SOCIAL GROUPS,0.5-1.0,1,KONDAPURAM,1785,1306,1103,195,1298,0,5,0,5,3
ANDHRA PRADESH,KADAPA,ALL SOCIAL GROUPS,0.5-1.0,2,MYLAVARAM,2572,1899,1678,220,1898,0,0,0,0,0
ANDHRA PRADESH,KADAPA,ALL SOCIAL GROUPS,0.5-1.0,3,PEDDAMUDIUM,2053,1559,1278,278,1556,0,1,0,1,2
ANDHRA PRADESH,KADAPA,ALL SOCIAL GROUPS,0.5-1.0,4,RAJUPALEM,2552,1890,1866,24,1890,0,0,0,0,1
ANDHRA PRADESH,KADAPA,ALL SOCIAL GROUPS,0.5-1.0,5,DUVVUR,3645,2646,2642,3,2645,0,0,0,0,0
ANDHRA PRADESH,KADAPA,ALL SOCIAL GROUPS,0.5-1.0,6,S.MYDUKUR,4096,2861,2735,125,2860,0,0,0,0,0
ANDHRA PRADESH,KADAPA,ALL SOCIAL GROUPS,0.5-1.0,7,BRAHMAMGARIMATTAM,4363,2974,1275,1698,2973,0,0,0,0,0
ANDHRA PRADESH,KADAPA,ALL SOCIAL GROUPS,0.5-1.0,8,SRI AVADHUTHA KASINAYANA,2659,1918,1280,638,1918,0,0,0,0,0
ANDHRA PRADESH,KADAPA,ALL SOCIAL GROUPS,0.5-1.0,9,KALASAPADU,2396,1724,1381,343,1724,0,0,0,0,0
ANDHRA PRADESH,KADAPA,ALL SOCIAL GROUPS,0.5-1.0,10,PORUMAMILLA,3080,2208,802,1406,2208,0,0,0,0,0
ANDHRA PRADESH,KADAPA,ALL SOCIAL GROUPS,0.5-1.0,11,B.KODUR,2014,1406,737,64,801,0,0,0,0,605
ANDHRA PRADESH,KADAPA,ALL SOCIAL GROUPS,0.5-1.0,12,BADVEL,3901,2652,1274,1097,2371,0,65,18,83,197
ANDHRA PRADESH,KADAPA,ALL SOCIAL GROUPS,0.5-1.0,13,GOPAVARAM,1914,1321,1055,250,1305,0,0,2,2,14
ANDHRA PRADESH,KADAPA,ALL SOCIAL GROUPS,0.5-1.0,14,KHAJIPET,3716,2727,2564,164,2728,0,0,0,0,0
ANDHRA PRADESH,KADAPA,ALL SOCIAL GROUPS,0.5-1.0,15,CHAPAD,3217,2348,2183,157,2340,0,0,0,0,8
ANDHRA PRADESH,KADAPA,ALL SOCIAL GROUPS,0.5-1.0,16,PRODDATUR,2305,1707,1691,16,1707,0,0,0,0,0
ANDHRA PRADESH,KADAPA,ALL SOCIAL GROUPS,0.5-1.0,17,JAMMALAMADUGU,1792,1324,1274,48,1322,0,1,0,1,0
ANDHRA PRADESH,KADAPA,ALL SOCIAL GROUPS,0.5-1.0,18,MUDDANUR,2112,1552,1484,68,1552,0,0,0,0,0
ANDHRA PRADESH,KADAPA,ALL SOCIAL GROUPS,0.5-1.0,19,SIMHADRIPURAM,1664,1285,813,472,1285,0,0,0,0,0
ANDHRA PRADESH,KADAPA,ALL SOCIAL GROUPS,0.5-1.0,20,LINGALA,1574,1209,1193,16,1209,0,0,0,0,0
ANDHRA PRADESH,KADAPA,ALL SOCIAL GROUPS,0.5-1.0,21,PULIVENDLA,1963,1467,1467,0,1467,0,0,0,0,0
ANDHRA PRADESH,KADAPA,ALL SOCIAL GROUPS,0.5-1.0,22,VEMULA,1690,1294,1263,29,1292,0,1,0,1,1
ANDHRA PRADESH,KADAPA,ALL SOCIAL GROUPS,0.5-1.0,23,THONDUR,1701,1309,1022,288,1310,0,0,0,0,0
ANDHRA PRADESH,KADAPA,ALL SOCIAL GROUPS,0.5-1.0,24,VEERAPUNAYUNIPALLE,1706,1291,1035,256,1291,0,0,0,0,0
ANDHRA PRADESH,KADAPA,ALL SOCIAL GROUPS,0.5-1.0,25,YERRAGUNTLA,2348,1753,782,971,1753,0,0,0,0,0
ANDHRA PRADESH,KADAPA,ALL SOCIAL GROUPS,0.5-1.0,26,KAMALAPURAM,2267,1684,1098,586,1684,0,0,0,0,0
ANDHRA PRADESH,KADAPA,ALL SOCIAL GROUPS,0.5-1.0,27,VALLUR,2123,1560,1011,512,1523,0,20,1,21,16
ANDHRA PRADESH,KADAPA,ALL SOCIAL GROUPS,0.5-1.0,28,CHENNUR,1504,1062,978,85,1063,0,0,0,0,0
ANDHRA PRADESH,KADAPA,ALL SOCIAL GROUPS,0.5-1.0,29,ATLUR,2305,1552,392,1159,1551,0,0,0,0,2
ANDHRA PRADESH,KADAPA,ALL SOCIAL GROUPS,0.5-1.0,30,VONTIMITTA,1628,1147,631,433,1064,0,61,0,61,21
ANDHRA PRADESH,KADAPA,ALL SOCIAL GROUPS,0.5-1.0,31,SIDHOUT,1947,1325,827,354,1181,0,13,70,83,60
ANDHRA PRADESH,KADAPA,ALL SOCIAL GROUPS,0.5-1.0,32,CUDDAPAH,1164,827,779,48,827,0,0,0,0,0
ANDHRA PRADESH,KADAPA,ALL SOCIAL GROUPS,0.5-1.0,33,CHINTHAKOMMADINNE,2246,1598,1496,101,1597,0,0,0,0,0
ANDHRA PRADESH,KADAPA,ALL SOCIAL GROUPS,0.5-1.0,34,PENDLIMARRI,2719,1982,1717,264,1981,0,0,0,0,0
ANDHRA PRADESH,KADAPA,ALL SOCIAL GROUPS,0.5-1.0,35,VEMPALLE,1188,909,886,21,907,0,1,0,1,1
ANDHRA PRADESH,KADAPA,ALL SOCIAL GROUPS,0.5-1.0,36,CHAKRAYAPET,1974,1473,1282,175,1457,0,0,6,6,10
ANDHRA PRADESH,KADAPA,ALL SOCIAL GROUPS,0.5-1.0,37,GALIVEEDU,2478,1822,796,941,1737,1,52,0,53,32
ANDHRA PRADESH,KADAPA,ALL SOCIAL GROUPS,0.5-1.0,38,CHINNAMANDEM,1929,1444,1324,46,1370,0,46,0,46,28
ANDHRA PRADESH,KADAPA,ALL SOCIAL GROUPS,0.5-1.0,39,SAMBEPALLE,2697,2014,1751,176,1927,0,51,6,57,30
ANDHRA PRADESH,KADAPA,ALL SOCIAL GROUPS,0.5-1.0,40,T SUNDUPALLE,3133,2323,1055,1203,2258,8,34,0,42,23
ANDHRA PRADESH,KADAPA,ALL SOCIAL GROUPS,0.5-1.0,41,RAYACHOTI,2559,1897,869,925,1794,0,64,0,64,39
ANDHRA PRADESH,KADAPA,ALL SOCIAL GROUPS,0.5-1.0,42,LAKKIREDDIPALLE,2233,1668,966,702,1668,0,0,0,0,0
ANDHRA PRADESH,KADAPA,ALL SOCIAL GROUPS,0.5-1.0,43,RAMAPURAM,2190,1642,1388,226,1614,0,19,0,19,10
ANDHRA PRADESH,KADAPA,ALL SOCIAL GROUPS,0.5-1.0,44,VEERABALLE,1872,1386,1068,313,1381,0,0,0,0,4
ANDHRA PRADESH,KADAPA,ALL SOCIAL GROUPS,0.5-1.0,45,NANDALUR,1185,825,490,335,825,0,0,0,0,0
ANDHRA PRADESH,KADAPA,ALL SOCIAL GROUPS,0.5-1.0,46,PENAGALUR,2488,1774,693,1035,1728,2,28,0,30,16
ANDHRA PRADESH,KADAPA,ALL SOCIAL GROUPS,0.5-1.0,47,CHITVEL,2070,1446,951,492,1443,0,1,0,1,2
ANDHRA PRADESH,KADAPA,ALL SOCIAL GROUPS,0.5-1.0,48,RAJAMPET,2767,1976,1087,578,1665,101,62,29,192,120
ANDHRA PRADESH,KADAPA,ALL SOCIAL GROUPS,0.5-1.0,49,PULLAMPETA,2518,1726,482,942,1424,2,200,0,202,100
ANDHRA PRADESH,KADAPA,ALL SOCIAL GROUPS,0.5-1.0,50,OBULAVARIPALLE,2233,1563,715,799,1514,0,31,0,31,18
ANDHRA PRADESH,KADAPA,ALL SOCIAL GROUPS,0.5-1.0,51,KODUR,2177,1551,724,827,1551,0,0,0,0,0
ANDHRA PRADESH,KADAPA,INSTITUTIONAL,3.0-4.0,1,KONDAPURAM,0,0,0,0,0,0,0,0,0,0
ANDHRA PRADESH,KADAPA,INSTITUTIONAL,3.0-4.0,2,MYLAVARAM,0,0,0,0,0,0,0,0,0,0
ANDHRA PRADESH,KADAPA,INSTITUTIONAL,3.0-4.0,3,PEDDAMUDIUM,0,0,0,0,0,0,0,0,0,0
ANDHRA PRADESH,KADAPA,INSTITUTIONAL,3.0-4.0,4,RAJUPALEM,0,0,0,0,0,0,0,0,0,0
ANDHRA PRADESH,KADAPA,INSTITUTIONAL,3.0-4.0,5,DUVVUR,0,0,0,0,0,0,0,0,0,0
ANDHRA PRADESH,KADAPA,INSTITUTIONAL,3.0-4.0,6,S.MYDUKUR,0,0,0,0,0,0,0,0,0,0
ANDHRA PRADESH,KADAPA,INSTITUTIONAL,3.0-4.0,7,BRAHMAMGARIMATTAM,0,0,0,0,0,0,0,0,0,0
ANDHRA PRADESH,KADAPA,INSTITUTIONAL,3.0-4.0,8,SRI AVADHUTHA KASINAYANA,0,0,0,0,0,0,0,0,0,0
ANDHRA PRADESH,KADAPA,INSTITUTIONAL,3.0-4.0,9,KALASAPADU,0,0,0,0,0,0,0,0,0,0
ANDHRA PRADESH,KADAPA,INSTITUTIONAL,3.0-4.0,10,PORUMAMILLA,0,0,0,0,0,0,0,0,0,0
ANDHRA PRADESH,KADAPA,INSTITUTIONAL,3.0-4.0,11,B.KODUR,0,0,0,0,0,0,0,0,0,0
ANDHRA PRADESH,KADAPA,INSTITUTIONAL,3.0-4.0,12,BADVEL,0,0,0,0,0,0,0,0,0,0
ANDHRA PRADESH,KADAPA,INSTITUTIONAL,3.0-4.0,13,GOPAVARAM,0,0,0,0,0,0,0,0,0,0
ANDHRA PRADESH,KADAPA,INSTITUTIONAL,3.0-4.0,14,KHAJIPET,0,0,0,0,0,0,0,0,0,0
ANDHRA PRADESH,KADAPA,INSTITUTIONAL,3.0-4.0,15,CHAPAD,0,0,0,0,0,0,0,0,0,0
ANDHRA PRADESH,KADAPA,INSTITUTIONAL,3.0-4.0,16,PRODDATUR,0,0,0,0,0,0,0,0,0,0
ANDHRA PRADESH,KADAPA,INSTITUTIONAL,3.0-4.0,17,JAMMALAMADUGU,0,0,0,0,0,0,0,0,0,0
ANDHRA PRADESH,KADAPA,INSTITUTIONAL,3.0-4.0,18,MUDDANUR,0,0,0,0,0,0,0,0,0,0
ANDHRA PRADESH,KADAPA,INSTITUTIONAL,3.0-4.0,19,SIMHADRIPURAM,0,0,0,0,0,0,0,0,0,0
ANDHRA PRADESH,KADAPA,INSTITUTIONAL,3.0-4.0,20,LINGALA,1,3,2,2,4,0,0,0,0,0
ANDHRA PRADESH,KADAPA,INSTITUTIONAL,3.0-4.0,21,PULIVENDLA,0,0,0,0,0,0,0,0,0,0
ANDHRA PRADESH,KADAPA,INSTITUTIONAL,3.0-4.0,22,VEMULA,0,0,0,0,0,0,0,0,0,0
ANDHRA PRADESH,KADAPA,INSTITUTIONAL,3.0-4.0,23,THONDUR,0,0,0,0,0,0,0,0,0,0
ANDHRA PRADESH,KADAPA,INSTITUTIONAL,3.0-4.0,24,VEERAPUNAYUNIPALLE,0,0,0,0,0,0,0,0,0,0
ANDHRA PRADESH,KADAPA,INSTITUTIONAL,3.0-4.0,25,YERRAGUNTLA,0,0,0,0,0,0,0,0,0,0
ANDHRA PRADESH,KADAPA,INSTITUTIONAL,3.0-4.0,26,KAMALAPURAM,0,0,0,0,0,0,0,0,0,0
ANDHRA PRADESH,KADAPA,INSTITUTIONAL,3.0-4.0,27,VALLUR,0,0,0,0,0,0,0,0,0,0
ANDHRA PRADESH,KADAPA,INSTITUTIONAL,3.0-4.0,28,CHENNUR,0,0,0,0,0,0,0,0,0,0
ANDHRA PRADESH,KADAPA,INSTITUTIONAL,3.0-4.0,29,ATLUR,0,0,0,0,0,0,0,0,0,0
ANDHRA PRADESH,KADAPA,INSTITUTIONAL,3.0-4.0,30,VONTIMITTA,0,0,0,0,0,0,0,0,0,0
ANDHRA PRADESH,KADAPA,INSTITUTIONAL,3.0-4.0,31,SIDHOUT,0,0,0,0,0,0,0,0,0,0
ANDHRA PRADESH,KADAPA,INSTITUTIONAL,3.0-4.0,32,CUDDAPAH,0,0,0,0,0,0,0,0,0,0
ANDHRA PRADESH,KADAPA,INSTITUTIONAL,3.0-4.0,33,CHINTHAKOMMADINNE,0,0,0,0,0,0,0,0,0,0
ANDHRA PRADESH,KADAPA,INSTITUTIONAL,3.0-4.0,34,PENDLIMARRI,0,0,0,0,0,0,0,0,0,0
ANDHRA PRADESH,KADAPA,INSTITUTIONAL,3.0-4.0,35,VEMPALLE,0,0,0,0,0,0,0,0,0,0
ANDHRA PRADESH,KADAPA,INSTITUTIONAL,3.0-4.0,36,CHAKRAYAPET,0,0,0,0,0,0,0,0,0,0
ANDHRA PRADESH,KADAPA,INSTITUTIONAL,3.0-4.0,37,GALIVEEDU,0,0,0,0,0,0,0,0,0,0
ANDHRA PRADESH,KADAPA,INSTITUTIONAL,3.0-4.0,38,CHINNAMANDEM,0,0,0,0,0,0,0,0,0,0
ANDHRA PRADESH,KADAPA,INSTITUTIONAL,3.0-4.0,39,SAMBEPALLE,0,0,0,0,0,0,0,0,0,0
ANDHRA PRADESH,KADAPA,INSTITUTIONAL,3.0-4.0,40,T SUNDUPALLE,0,0,0,0,0,0,0,0,0,0
ANDHRA PRADESH,KADAPA,INSTITUTIONAL,3.0-4.0,41,RAYACHOTI,0,0,0,0,0,0,0,0,0,0
ANDHRA PRADESH,KADAPA,INSTITUTIONAL,3.0-4.0,42,LAKKIREDDIPALLE,0,0,0,0,0,0,0,0,0,0
ANDHRA PRADESH,KADAPA,INSTITUTIONAL,3.0-4.0,43,RAMAPURAM,0,0,0,0,0,0,0,0,0,0
ANDHRA PRADESH,KADAPA,INSTITUTIONAL,3.0-4.0,44,VEERABALLE,0,0,0,0,0,0,0,0,0,0
ANDHRA PRADESH,KADAPA,INSTITUTIONAL,3.0-4.0,45,NANDALUR,0,0,0,0,0,0,0,0,0,0
ANDHRA PRADESH,KADAPA,INSTITUTIONAL,3.0-4.0,46,PENAGALUR,0,0,0,0,0,0,0,0,0,0
ANDHRA PRADESH,KADAPA,INSTITUTIONAL,3.0-4.0,47,CHITVEL,0,0,0,0,0,0,0,0,0,0
ANDHRA PRADESH,KADAPA,INSTITUTIONAL,3.0-4.0,48,RAJAMPET,0,0,0,0,0,0,0,0,0,0
ANDHRA PRADESH,KADAPA,INSTITUTIONAL,3.0-4.0,49,PULLAMPETA,0,0,0,0,0,0,0,0,0,0
ANDHRA PRADESH,KADAPA,INSTITUTIONAL,3.0-4.0,50,OBULAVARIPALLE,0,0,0,0,0,0,0,0,0,0
ANDHRA PRADESH,KADAPA,INSTITUTIONAL,3.0-4.0,51,KODUR,0,0,0,0,0,0,0,0,0,0
ANDHRA PRADESH,KADAPA,SCHEDULED CASTE,3.0-4.0,1,KONDAPURAM,5,17,10,7,17,0,0,0,0,0
ANDHRA PRADESH,KADAPA,SCHEDULED CASTE,3.0-4.0,2,MYLAVARAM,22,75,68,0,68,0,7,0,7,0
ANDHRA PRADESH,KADAPA,SCHEDULED CASTE,3.0-4.0,3,PEDDAMUDIUM,6,21,21,0,21,0,0,0,0,0
ANDHRA PRADESH,KADAPA,SCHEDULED CASTE,3.0-4.0,4,RAJUPALEM,7,22,11,11,22,0,0,0,0,0
ANDHRA PRADESH,KADAPA,SCHEDULED CASTE,3.0-4.0,5,DUVVUR,3,11,5,5,10,0,0,0,0,0
ANDHRA PRADESH,KADAPA,SCHEDULED CASTE,3.0-4.0,6,S.MYDUKUR,6,18,18,0,18,0,0,0,0,0
ANDHRA PRADESH,KADAPA,SCHEDULED CASTE,3.0-4.0,7,BRAHMAMGARIMATTAM,2,6,3,3,6,0,0,0,0,0
ANDHRA PRADESH,KADAPA,SCHEDULED CASTE,3.0-4.0,8,SRI AVADHUTHA KASINAYANA,11,36,18,18,36,0,0,0,0,0
ANDHRA PRADESH,KADAPA,SCHEDULED CASTE,3.0-4.0,9,KALASAPADU,4,13,6,6,12,0,0,0,0,0
ANDHRA PRADESH,KADAPA,SCHEDULED CASTE,3.0-4.0,10,PORUMAMILLA,12,40,40,0,40,0,0,0,0,0
ANDHRA PRADESH,KADAPA,SCHEDULED CASTE,3.0-4.0,11,B.KODUR,2,7,3,3,6,0,0,0,0,0
ANDHRA PRADESH,KADAPA,SCHEDULED CASTE,3.0-4.0,12,BADVEL,5,17,4,3,7,0,0,0,0,9
ANDHRA PRADESH,KADAPA,SCHEDULED CASTE,3.0-4.0,13,GOPAVARAM,5,16,5,11,16,0,0,0,0,0
ANDHRA PRADESH,KADAPA,SCHEDULED CASTE,3.0-4.0,14,KHAJIPET,2,7,7,0,7,0,0,0,0,0
ANDHRA PRADESH,KADAPA,SCHEDULED CASTE,3.0-4.0,15,CHAPAD,1,3,2,2,4,0,0,0,0,0
ANDHRA PRADESH,KADAPA,SCHEDULED CASTE,3.0-4.0,16,PRODDATUR,1,3,2,2,4,0,0,0,0,0
ANDHRA PRADESH,KADAPA,SCHEDULED CASTE,3.0-4.0,17,JAMMALAMADUGU,0,0,0,0,0,0,0,0,0,0
ANDHRA PRADESH,KADAPA,SCHEDULED CASTE,3.0-4.0,18,MUDDANUR,3,11,11,0,11,0,0,0,0,0
ANDHRA PRADESH,KADAPA,SCHEDULED CASTE,3.0-4.0,19,SIMHADRIPURAM,7,24,24,0,24,0,0,0,0,0
ANDHRA PRADESH,KADAPA,SCHEDULED CASTE,3.0-4.0,20,LINGALA,6,20,20,0,20,0,0,0,0,0
ANDHRA PRADESH,KADAPA,SCHEDULED CASTE,3.0-4.0,21,PULIVENDLA,2,7,3,3,6,0,0,0,0,0
ANDHRA PRADESH,KADAPA,SCHEDULED CASTE,3.0-4.0,22,VEMULA,11,37,18,18,36,0,0,0,0,0
ANDHRA PRADESH,KADAPA,SCHEDULED CASTE,3.0-4.0,23,THONDUR,9,29,13,15,28,0,0,0,0,0
ANDHRA PRADESH,KADAPA,SCHEDULED CASTE,3.0-4.0,24,VEERAPUNAYUNIPALLE,4,13,7,7,14,0,0,0,0,0
ANDHRA PRADESH,KADAPA,SCHEDULED CASTE,3.0-4.0,25,YERRAGUNTLA,3,10,5,5,10,0,0,0,0,0
ANDHRA PRADESH,KADAPA,SCHEDULED CASTE,3.0-4.0,26,KAMALAPURAM,3,10,5,5,10,0,0,0,0,0
ANDHRA PRADESH,KADAPA,SCHEDULED CASTE,3.0-4.0,27,VALLUR,3,10,7,3,10,0,0,0,0,0
ANDHRA PRADESH,KADAPA,SCHEDULED CASTE,3.0-4.0,28,CHENNUR,0,0,0,0,0,0,0,0,0,0
ANDHRA PRADESH,KADAPA,SCHEDULED CASTE,3.0-4.0,29,ATLUR,1,3,2,2,4,0,0,0,0,0
ANDHRA PRADESH,KADAPA,SCHEDULED CASTE,3.0-4.0,30,VONTIMITTA,0,0,0,0,0,0,0,0,0,0
ANDHRA PRADESH,KADAPA,SCHEDULED CASTE,3.0-4.0,31,SIDHOUT,0,0,0,0,0,0,0,0,0,0
ANDHRA PRADESH,KADAPA,SCHEDULED CASTE,3.0-4.0,32,CUDDAPAH,2,6,3,4,7,0,0,0,0,0
ANDHRA PRADESH,KADAPA,SCHEDULED CASTE,3.0-4.0,33,CHINTHAKOMMADINNE,1,3,2,2,4,0,0,0,0,0
ANDHRA PRADESH,KADAPA,SCHEDULED CASTE,3.0-4.0,34,PENDLIMARRI,4,13,13,0,13,0,0,0,0,0
ANDHRA PRADESH,KADAPA,SCHEDULED CASTE,3.0-4.0,35,VEMPALLE,2,6,3,3,6,0,0,0,0,0
ANDHRA PRADESH,KADAPA,SCHEDULED CASTE,3.0-4.0,36,CHAKRAYAPET,3,10,5,5,10,0,0,0,0,0
ANDHRA PRADESH,KADAPA,SCHEDULED CASTE,3.0-4.0,37,GALIVEEDU,4,14,7,7,14,0,0,0,0,0
ANDHRA PRADESH,KADAPA,SCHEDULED CASTE,3.0-4.0,38,CHINNAMANDEM,7,22,11,11,22,0,0,0,0,0
ANDHRA PRADESH,KADAPA,SCHEDULED CASTE,3.0-4.0,39,SAMBEPALLE,10,34,17,17,34,0,0,0,0,0
ANDHRA PRADESH,KADAPA,SCHEDULED CASTE,3.0-4.0,40,T SUNDUPALLE,4,13,9,5,14,0,0,0,0,0
ANDHRA PRADESH,KADAPA,SCHEDULED CASTE,3.0-4.0,41,RAYACHOTI,4,13,8,4,12,0,1,0,1,0
ANDHRA PRADESH,KADAPA,SCHEDULED CASTE,3.0-4.0,42,LAKKIREDDIPALLE,0,0,0,0,0,0,0,0,0,0
ANDHRA PRADESH,KADAPA,SCHEDULED CASTE,3.0-4.0,43,RAMAPURAM,12,42,21,21,42,0,0,0,0,0
ANDHRA PRADESH,KADAPA,SCHEDULED CASTE,3.0-4.0,44,VEERABALLE,3,9,9,0,9,0,0,0,0,0
ANDHRA PRADESH,KADAPA,SCHEDULED CASTE,3.0-4.0,45,NANDALUR,2,7,3,4,7,0,0,0,0,0
ANDHRA PRADESH,KADAPA,SCHEDULED CASTE,3.0-4.0,46,PENAGALUR,1,4,2,2,4,0,0,0,0,0
ANDHRA PRADESH,KADAPA,SCHEDULED CASTE,3.0-4.0,47,CHITVEL,0,0,0,0,0,0,0,0,0,0
ANDHRA PRADESH,KADAPA,SCHEDULED CASTE,3.0-4.0,48,RAJAMPET,3,10,5,5,10,0,0,0,0,0
ANDHRA PRADESH,KADAPA,SCHEDULED CASTE,3.0-4.0,49,PULLAMPETA,6,21,1,6,7,0,14,0,14,0
ANDHRA PRADESH,KADAPA,SCHEDULED CASTE,3.0-4.0,50,OBULAVARIPALLE,3,10,5,5,10,0,0,0,0,0
ANDHRA PRADESH,KADAPA,SCHEDULED CASTE,3.0-4.0,51,KODUR,10,35,19,17,36,0,0,0,0,0
ANDHRA PRADESH,KADAPA,OTHERS,3.0-4.0,1,KONDAPURAM,406,1402,1078,316,1394,0,5,0,5,3
ANDHRA PRADESH,KADAPA,OTHERS,3.0-4.0,2,MYLAVARAM,350,1214,1156,59,1215,0,0,0,0,0
ANDHRA PRADESH,KADAPA,OTHERS,3.0-4.0,3,PEDDAMUDIUM,994,3423,3021,374,3395,0,17,0,17,10
ANDHRA PRADESH,KADAPA,OTHERS,3.0-4.0,4,RAJUPALEM,633,2189,2180,8,2188,0,0,0,0,1
ANDHRA PRADESH,KADAPA,OTHERS,3.0-4.0,5,DUVVUR,209,716,716,0,716,0,0,0,0,0
ANDHRA PRADESH,KADAPA,OTHERS,3.0-4.0,6,S.MYDUKUR,209,694,640,54,694,0,0,0,0,0
ANDHRA PRADESH,KADAPA,OTHERS,3.0-4.0,7,BRAHMAMGARIMATTAM,24,73,24,48,72,0,0,0,0,0
ANDHRA PRADESH,KADAPA,OTHERS,3.0-4.0,8,SRI AVADHUTHA KASINAYANA,248,849,294,555,849,0,0,0,0,0
ANDHRA PRADESH,KADAPA,OTHERS,3.0-4.0,9,KALASAPADU,76,259,231,13,244,0,10,0,10,5
ANDHRA PRADESH,KADAPA,OTHERS,3.0-4.0,10,PORUMAMILLA,153,517,293,224,517,0,0,0,0,0
ANDHRA PRADESH,KADAPA,OTHERS,3.0-4.0,11,B.KODUR,132,455,120,82,202,0,0,0,0,253
ANDHRA PRADESH,KADAPA,OTHERS,3.0-4.0,12,BADVEL,63,213,48,54,102,0,43,0,43,69
ANDHRA PRADESH,KADAPA,OTHERS,3.0-4.0,13,GOPAVARAM,70,238,117,80,197,0,11,11,22,19
ANDHRA PRADESH,KADAPA,OTHERS,3.0-4.0,14,KHAJIPET,130,439,391,48,439,0,0,0,0,0
ANDHRA PRADESH,KADAPA,OTHERS,3.0-4.0,15,CHAPAD,135,462,442,12,454,0,0,0,0,9
ANDHRA PRADESH,KADAPA,OTHERS,3.0-4.0,16,PRODDATUR,357,1236,1213,23,1236,0,0,0,0,0
ANDHRA PRADESH,KADAPA,OTHERS,3.0-4.0,17,JAMMALAMADUGU,296,1008,969,28,997,0,8,0,8,4
ANDHRA PRADESH,KADAPA,OTHERS,3.0-4.0,18,MUDDANUR,290,987,835,147,982,0,3,0,3,2
ANDHRA PRADESH,KADAPA,OTHERS,3.0-4.0,19,SIMHADRIPURAM,852,2925,1642,1218,2860,0,42,0,42,24
ANDHRA PRADESH,KADAPA,OTHERS,3.0-4.0,20,LINGALA,508,1747,1734,13,1747,0,0,0,0,0
ANDHRA PRADESH,KADAPA,OTHERS,3.0-4.0,21,PULIVENDLA,212,724,724,0,724,0,0,0,0,0
ANDHRA PRADESH,KADAPA,OTHERS,3.0-4.0,22,VEMULA,517,1753,1427,205,1632,0,76,2,78,44
ANDHRA PRADESH,KADAPA,OTHERS,3.0-4.0,23,THONDUR,656,2235,2012,223,2235,0,0,0,0,0
ANDHRA PRADESH,KADAPA,OTHERS,3.0-4.0,24,VEERAPUNAYUNIPALLE,613,2101,1777,324,2101,0,0,0,0,0
ANDHRA PRADESH,KADAPA,OTHERS,3.0-4.0,25,YERRAGUNTLA,494,1699,1249,451,1700,0,0,0,0,0
ANDHRA PRADESH,KADAPA,OTHERS,3.0-4.0,26,KAMALAPURAM,307,1050,682,368,1050,0,0,0,0,0
ANDHRA PRADESH,KADAPA,OTHERS,3.0-4.0,27,VALLUR,215,731,546,87,633,0,62,0,62,36
ANDHRA PRADESH,KADAPA,OTHERS,3.0-4.0,28,CHENNUR,68,233,195,38,233,0,0,0,0,0
ANDHRA PRADESH,KADAPA,OTHERS,3.0-4.0,29,ATLUR,58,192,101,90,191,0,0,0,0,0
ANDHRA PRADESH,KADAPA,OTHERS,3.0-4.0,30,VONTIMITTA,52,177,29,73,102,0,48,0,48,27
ANDHRA PRADESH,KADAPA,OTHERS,3.0-4.0,31,SIDHOUT,55,190,134,29,163,0,0,17,17,10
ANDHRA PRADESH,KADAPA,OTHERS,3.0-4.0,32,CUDDAPAH,70,244,170,74,244,0,0,0,0,0
ANDHRA PRADESH,KADAPA,OTHERS,3.0-4.0,33,CHINTHAKOMMADINNE,154,530,515,15,530,0,0,0,0,0
ANDHRA PRADESH,KADAPA,OTHERS,3.0-4.0,34,PENDLIMARRI,298,1016,886,130,1016,0,0,0,0,0
ANDHRA PRADESH,KADAPA,OTHERS,3.0-4.0,35,VEMPALLE,345,1170,1155,15,1170,0,0,0,0,0
ANDHRA PRADESH,KADAPA,OTHERS,3.0-4.0,36,CHAKRAYAPET,317,1084,835,187,1022,0,38,0,38,24
ANDHRA PRADESH,KADAPA,OTHERS,3.0-4.0,37,GALIVEEDU,509,1708,1221,402,1623,0,47,0,47,38
ANDHRA PRADESH,KADAPA,OTHERS,3.0-4.0,38,CHINNAMANDEM,247,849,695,33,728,0,60,16,76,45
ANDHRA PRADESH,KADAPA,OTHERS,3.0-4.0,39,SAMBEPALLE,599,2051,1696,57,1753,0,156,33,189,110
ANDHRA PRADESH,KADAPA,OTHERS,3.0-4.0,40,T SUNDUPALLE,301,1030,366,513,879,5,91,0,96,55
ANDHRA PRADESH,KADAPA,OTHERS,3.0-4.0,41,RAYACHOTI,351,1200,557,456,1013,0,118,0,118,69
ANDHRA PRADESH,KADAPA,OTHERS,3.0-4.0,42,LAKKIREDDIPALLE,408,1396,1123,226,1349,0,0,0,0,47
ANDHRA PRADESH,KADAPA,OTHERS,3.0-4.0,43,RAMAPURAM,364,1256,993,184,1177,0,51,0,51,29
ANDHRA PRADESH,KADAPA,OTHERS,3.0-4.0,44,VEERABALLE,212,720,580,137,717,0,0,0,0,4
ANDHRA PRADESH,KADAPA,OTHERS,3.0-4.0,45,NANDALUR,48,163,101,58,159,0,2,1,3,1
ANDHRA PRADESH,KADAPA,OTHERS,3.0-4.0,46,PENAGALUR,19,63,19,24,43,0,13,0,13,7
ANDHRA PRADESH,KADAPA,OTHERS,3.0-4.0,47,CHITVEL,102,350,33,317,350,0,0,0,0,0
ANDHRA PRADESH,KADAPA,OTHERS,3.0-4.0,48,RAJAMPET,165,566,175,222,397,37,6,40,83,86
ANDHRA PRADESH,KADAPA,OTHERS,3.0-4.0,49,PULLAMPETA,156,530,142,120,262,0,171,0,171,97
ANDHRA PRADESH,KADAPA,OTHERS,3.0-4.0,50,OBULAVARIPALLE,152,529,212,124,336,0,123,0,123,70
ANDHRA PRADESH,KADAPA,OTHERS,3.0-4.0,51,KODUR,153,532,300,232,532,0,0,0,0,0
ANDHRA PRADESH,KADAPA,SCHEDULED TRIBES,3.0-4.0,1,KONDAPURAM,0,0,0,0,0,0,0,0,0,0
ANDHRA PRADESH,KADAPA,SCHEDULED TRIBES,3.0-4.0,2,MYLAVARAM,5,17,17,0,17,0,0,0,0,0
ANDHRA PRADESH,KADAPA,SCHEDULED TRIBES,3.0-4.0,3,PEDDAMUDIUM,2,7,7,0,7,0,0,0,0,0
ANDHRA PRADESH,KADAPA,SCHEDULED TRIBES,3.0-4.0,4,RAJUPALEM,0,0,0,0,0,0,0,0,0,0
ANDHRA PRADESH,KADAPA,SCHEDULED TRIBES,3.0-4.0,5,DUVVUR,0,0,0,0,0,0,0,0,0,0
ANDHRA PRADESH,KADAPA,SCHEDULED TRIBES,3.0-4.0,6,S.MYDUKUR,3,9,5,5,10,0,0,0,0,0
ANDHRA PRADESH,KADAPA,SCHEDULED TRIBES,3.0-4.0,7,BRAHMAMGARIMATTAM,0,0,0,0,0,0,0,0,0,0
ANDHRA PRADESH,KADAPA,SCHEDULED TRIBES,3.0-4.0,8,SRI AVADHUTHA KASINAYANA,2,7,3,3,6,0,0,0,0,0
ANDHRA PRADESH,KADAPA,SCHEDULED TRIBES,3.0-4.0,9,KALASAPADU,1,3,2,2,4,0,0,0,0,0
ANDHRA PRADESH,KADAPA,SCHEDULED TRIBES,3.0-4.0,10,PORUMAMILLA,2,6,0,6,6,0,0,0,0,0
ANDHRA PRADESH,KADAPA,SCHEDULED TRIBES,3.0-4.0,11,B.KODUR,1,3,2,2,4,0,0,0,0,0
ANDHRA PRADESH,KADAPA,SCHEDULED TRIBES,3.0-4.0,12,BADVEL,1,3,2,2,4,0,0,0,0,0
ANDHRA PRADESH,KADAPA,SCHEDULED TRIBES,3.0-4.0,13,GOPAVARAM,0,0,0,0,0,0,0,0,0,0
ANDHRA PRADESH,KADAPA,SCHEDULED TRIBES,3.0-4.0,14,KHAJIPET,0,0,0,0,0,0,0,0,0,0
ANDHRA PRADESH,KADAPA,SCHEDULED TRIBES,3.0-4.0,15,CHAPAD,0,0,0,0,0,0,0,0,0,0
ANDHRA PRADESH,KADAPA,SCHEDULED TRIBES,3.0-4.0,16,PRODDATUR,0,0,0,0,0,0,0,0,0,0
ANDHRA PRADESH,KADAPA,SCHEDULED TRIBES,3.0-4.0,17,JAMMALAMADUGU,0,0,0,0,0,0,0,0,0,0
ANDHRA PRADESH,KADAPA,SCHEDULED TRIBES,3.0-4.0,18,MUDDANUR,0,0,0,0,0,0,0,0,0,0
ANDHRA PRADESH,KADAPA,SCHEDULED TRIBES,3.0-4.0,19,SIMHADRIPURAM,6,21,10,11,21,0,0,0,0,0
ANDHRA PRADESH,KADAPA,SCHEDULED TRIBES,3.0-4.0,20,LINGALA,0,0,0,0,0,0,0,0,0,0
ANDHRA PRADESH,KADAPA,SCHEDULED TRIBES,3.0-4.0,21,PULIVENDLA,4,14,14,0,14,0,0,0,0,0
ANDHRA PRADESH,KADAPA,SCHEDULED TRIBES,3.0-4.0,22,VEMULA,1,3,2,2,4,0,0,0,0,0
ANDHRA PRADESH,KADAPA,SCHEDULED TRIBES,3.0-4.0,23,THONDUR,0,0,0,0,0,0,0,0,0,0
ANDHRA PRADESH,KADAPA,SCHEDULED TRIBES,3.0-4.0,24,VEERAPUNAYUNIPALLE,3,10,5,5,10,0,0,0,0,0
ANDHRA PRADESH,KADAPA,SCHEDULED TRIBES,3.0-4.0,25,YERRAGUNTLA,0,0,0,0,0,0,0,0,0,0
ANDHRA PRADESH,KADAPA,SCHEDULED TRIBES,3.0-4.0,26,KAMALAPURAM,0,0,0,0,0,0,0,0,0,0
ANDHRA PRADESH,KADAPA,SCHEDULED TRIBES,3.0-4.0,27,VALLUR,0,0,0,0,0,0,0,0,0,0
ANDHRA PRADESH,KADAPA,SCHEDULED TRIBES,3.0-4.0,28,CHENNUR,0,0,0,0,0,0,0,0,0,0
ANDHRA PRADESH,KADAPA,SCHEDULED TRIBES,3.0-4.0,29,ATLUR,0,0,0,0,0,0,0,0,0,0
ANDHRA PRADESH,KADAPA,SCHEDULED TRIBES,3.0-4.0,30,VONTIMITTA,0,0,0,0,0,0,0,0,0,0
ANDHRA PRADESH,KADAPA,SCHEDULED TRIBES,3.0-4.0,31,SIDHOUT,0,0,0,0,0,0,0,0,0,0
ANDHRA PRADESH,KADAPA,SCHEDULED TRIBES,3.0-4.0,32,CUDDAPAH,0,0,0,0,0,0,0,0,0,0
ANDHRA PRADESH,KADAPA,SCHEDULED TRIBES,3.0-4.0,33,CHINTHAKOMMADINNE,2,6,3,3,6,0,0,0,0,0
ANDHRA PRADESH,KADAPA,SCHEDULED TRIBES,3.0-4.0,34,PENDLIMARRI,0,0,0,0,0,0,0,0,0,0
ANDHRA PRADESH,KADAPA,SCHEDULED TRIBES,3.0-4.0,35,VEMPALLE,4,14,7,7,14,0,0,0,0,0
ANDHRA PRADESH,KADAPA,SCHEDULED TRIBES,3.0-4.0,36,CHAKRAYAPET,7,24,12,12,24,0,0,0,0,0
ANDHRA PRADESH,KADAPA,SCHEDULED TRIBES,3.0-4.0,37,GALIVEEDU,7,23,12,12,24,0,0,0,0,0
ANDHRA PRADESH,KADAPA,SCHEDULED TRIBES,3.0-4.0,38,CHINNAMANDEM,0,0,0,0,0,0,0,0,0,0
ANDHRA PRADESH,KADAPA,SCHEDULED TRIBES,3.0-4.0,39,SAMBEPALLE,10,34,17,17,34,0,0,0,0,0
ANDHRA PRADESH,KADAPA,SCHEDULED TRIBES,3.0-4.0,40,T SUNDUPALLE,6,20,10,10,20,0,0,0,0,0
ANDHRA PRADESH,KADAPA,SCHEDULED TRIBES,3.0-4.0,41,RAYACHOTI,0,0,0,0,0,0,0,0,0,0
ANDHRA PRADESH,KADAPA,SCHEDULED TRIBES,3.0-4.0,42,LAKKIREDDIPALLE,0,0,0,0,0,0,0,0,0,0
ANDHRA PRADESH,KADAPA,SCHEDULED TRIBES,3.0-4.0,43,RAMAPURAM,7,24,12,12,24,0,0,0,0,0
ANDHRA PRADESH,KADAPA,SCHEDULED TRIBES,3.0-4.0,44,VEERABALLE,1,3,2,2,4,0,0,0,0,0
ANDHRA PRADESH,KADAPA,SCHEDULED TRIBES,3.0-4.0,45,NANDALUR,0,0,0,0,0,0,0,0,0,0
ANDHRA PRADESH,KADAPA,SCHEDULED TRIBES,3.0-4.0,46,PENAGALUR,0,0,0,0,0,0,0,0,0,0
ANDHRA PRADESH,KADAPA,SCHEDULED TRIBES,3.0-4.0,47,CHITVEL,0,0,0,0,0,0,0,0,0,0
ANDHRA PRADESH,KADAPA,SCHEDULED TRIBES,3.0-4.0,48,RAJAMPET,0,0,0,0,0,0,0,0,0,0
ANDHRA PRADESH,KADAPA,SCHEDULED TRIBES,3.0-4.0,49,PULLAMPETA,3,10,5,5,10,0,0,0,0,0
ANDHRA PRADESH,KADAPA,SCHEDULED TRIBES,3.0-4.0,50,OBULAVARIPALLE,0,0,0,0,0,0,0,0,0,0
ANDHRA PRADESH,KADAPA,SCHEDULED TRIBES,3.0-4.0,51,KODUR,9,32,5,27,32,0,0,0,0,0
ANDHRA PRADESH,KADAPA,ALL SOCIAL GROUPS,3.0-4.0,1,KONDAPURAM,411,1419,1089,323,1412,0,5,0,5,3
ANDHRA PRADESH,KADAPA,ALL SOCIAL GROUPS,3.0-4.0,2,MYLAVARAM,377,1306,1240,59,1299,0,7,0,7,0
ANDHRA PRADESH,KADAPA,ALL SOCIAL GROUPS,3.0-4.0,3,PEDDAMUDIUM,1002,3451,3049,374,3423,0,17,0,17,10
ANDHRA PRADESH,KADAPA,ALL SOCIAL GROUPS,3.0-4.0,4,RAJUPALEM,640,2212,2191,19,2210,0,0,0,0,1
ANDHRA PRADESH,KADAPA,ALL SOCIAL GROUPS,3.0-4.0,5,DUVVUR,212,727,721,5,726,0,0,0,0,0
ANDHRA PRADESH,KADAPA,ALL SOCIAL GROUPS,3.0-4.0,6,S.MYDUKUR,218,722,663,59,722,0,0,0,0,0
ANDHRA PRADESH,KADAPA,ALL SOCIAL GROUPS,3.0-4.0,7,BRAHMAMGARIMATTAM,26,79,27,51,78,0,0,0,0,0
ANDHRA PRADESH,KADAPA,ALL SOCIAL GROUPS,3.0-4.0,8,SRI AVADHUTHA KASINAYANA,261,892,315,576,891,0,0,0,0,0
ANDHRA PRADESH,KADAPA,ALL SOCIAL GROUPS,3.0-4.0,9,KALASAPADU,81,275,239,22,261,0,10,0,10,5
ANDHRA PRADESH,KADAPA,ALL SOCIAL GROUPS,3.0-4.0,10,PORUMAMILLA,167,564,334,230,564,0,0,0,0,0
ANDHRA PRADESH,KADAPA,ALL SOCIAL GROUPS,3.0-4.0,11,B.KODUR,135,465,125,87,212,0,0,0,0,253
ANDHRA PRADESH,KADAPA,ALL SOCIAL GROUPS,3.0-4.0,12,BADVEL,69,233,53,59,112,0,43,0,43,78
ANDHRA PRADESH,KADAPA,ALL SOCIAL GROUPS,3.0-4.0,13,GOPAVARAM,75,254,122,92,214,0,11,11,22,19
ANDHRA PRADESH,KADAPA,ALL SOCIAL GROUPS,3.0-4.0,14,KHAJIPET,132,446,398,48,446,0,0,0,0,0
ANDHRA PRADESH,KADAPA,ALL SOCIAL GROUPS,3.0-4.0,15,CHAPAD,136,465,443,13,456,0,0,0,0,9
ANDHRA PRADESH,KADAPA,ALL SOCIAL GROUPS,3.0-4.0,16,PRODDATUR,358,1239,1215,24,1239,0,0,0,0,0
ANDHRA PRADESH,KADAPA,ALL SOCIAL GROUPS,3.0-4.0,17,JAMMALAMADUGU,296,1008,969,28,997,0,8,0,8,4
ANDHRA PRADESH,KADAPA,ALL SOCIAL GROUPS,3.0-4.0,18,MUDDANUR,293,998,846,147,993,0,3,0,3,2
ANDHRA PRADESH,KADAPA,ALL SOCIAL GROUPS,3.0-4.0,19,SIMHADRIPURAM,865,2970,1676,1229,2905,0,42,0,42,24
ANDHRA PRADESH,KADAPA,ALL SOCIAL GROUPS,3.0-4.0,20,LINGALA,515,1770,1756,14,1770,0,0,0,0,0
ANDHRA PRADESH,KADAPA,ALL SOCIAL GROUPS,3.0-4.0,21,PULIVENDLA,218,744,741,3,744,0,0,0,0,0
ANDHRA PRADESH,KADAPA,ALL SOCIAL GROUPS,3.0-4.0,22,VEMULA,529,1794,1447,225,1672,0,76,2,78,44
ANDHRA PRADESH,KADAPA,ALL SOCIAL GROUPS,3.0-4.0,23,THONDUR,665,2264,2026,238,2264,0,0,0,0,0
ANDHRA PRADESH,KADAPA,ALL SOCIAL GROUPS,3.0-4.0,24,VEERAPUNAYUNIPALLE,620,2124,1789,335,2124,0,0,0,0,0
ANDHRA PRADESH,KADAPA,ALL SOCIAL GROUPS,3.0-4.0,25,YERRAGUNTLA,497,1709,1253,456,1709,0,0,0,0,0
ANDHRA PRADESH,KADAPA,ALL SOCIAL GROUPS,3.0-4.0,26,KAMALAPURAM,310,1060,686,373,1059,0,0,0,0,0
ANDHRA PRADESH,KADAPA,ALL SOCIAL GROUPS,3.0-4.0,27,VALLUR,218,741,552,91,643,0,62,0,62,36
ANDHRA PRADESH,KADAPA,ALL SOCIAL GROUPS,3.0-4.0,28,CHENNUR,68,233,195,38,233,0,0,0,0,0
ANDHRA PRADESH,KADAPA,ALL SOCIAL GROUPS,3.0-4.0,29,ATLUR,59,195,103,92,195,0,0,0,0,0
ANDHRA PRADESH,KADAPA,ALL SOCIAL GROUPS,3.0-4.0,30,VONTIMITTA,52,177,29,73,102,0,48,0,48,27
ANDHRA PRADESH,KADAPA,ALL SOCIAL GROUPS,3.0-4.0,31,SIDHOUT,55,190,134,29,163,0,0,17,17,10
ANDHRA PRADESH,KADAPA,ALL SOCIAL GROUPS,3.0-4.0,32,CUDDAPAH,72,250,173,78,251,0,0,0,0,0
ANDHRA PRADESH,KADAPA,ALL SOCIAL GROUPS,3.0-4.0,33,CHINTHAKOMMADINNE,157,540,520,20,540,0,0,0,0,0
ANDHRA PRADESH,KADAPA,ALL SOCIAL GROUPS,3.0-4.0,34,PENDLIMARRI,302,1028,898,130,1028,0,0,0,0,0
ANDHRA PRADESH,KADAPA,ALL SOCIAL GROUPS,3.0-4.0,35,VEMPALLE,351,1190,1165,25,1190,0,0,0,0,0
ANDHRA PRADESH,KADAPA,ALL SOCIAL GROUPS,3.0-4.0,36,CHAKRAYAPET,327,1118,852,204,1056,0,38,0,38,24
ANDHRA PRADESH,KADAPA,ALL SOCIAL GROUPS,3.0-4.0,37,GALIVEEDU,520,1745,1240,421,1661,0,47,0,47,38
ANDHRA PRADESH,KADAPA,ALL SOCIAL GROUPS,3.0-4.0,38,CHINNAMANDEM,254,872,706,44,750,0,60,16,76,45
ANDHRA PRADESH,KADAPA,ALL SOCIAL GROUPS,3.0-4.0,39,SAMBEPALLE,619,2120,1730,91,1821,0,156,33,189,110
ANDHRA PRADESH,KADAPA,ALL SOCIAL GROUPS,3.0-4.0,40,T SUNDUPALLE,311,1064,385,528,913,5,91,0,96,55
ANDHRA PRADESH,KADAPA,ALL SOCIAL GROUPS,3.0-4.0,41,RAYACHOTI,355,1213,565,459,1024,0,119,0,119,69
ANDHRA PRADESH,KADAPA,ALL SOCIAL GROUPS,3.0-4.0,42,LAKKIREDDIPALLE,408,1396,1123,226,1349,0,0,0,0,47
ANDHRA PRADESH,KADAPA,ALL SOCIAL GROUPS,3.0-4.0,43,RAMAPURAM,383,1321,1025,217,1242,0,51,0,51,29
ANDHRA PRADESH,KADAPA,ALL SOCIAL GROUPS,3.0-4.0,44,VEERABALLE,216,733,590,138,728,0,0,0,0,4
ANDHRA PRADESH,KADAPA,ALL SOCIAL GROUPS,3.0-4.0,45,NANDALUR,50,169,104,61,165,0,2,1,3,1
ANDHRA PRADESH,KADAPA,ALL SOCIAL GROUPS,3.0-4.0,46,PENAGALUR,20,67,21,26,47,0,13,0,13,7
ANDHRA PRADESH,KADAPA,ALL SOCIAL GROUPS,3.0-4.0,47,CHITVEL,102,350,33,317,350,0,0,0,0,0
ANDHRA PRADESH,KADAPA,ALL SOCIAL GROUPS,3.0-4.0,48,RAJAMPET,168,576,180,227,407,37,6,40,83,86
ANDHRA PRADESH,KADAPA,ALL SOCIAL GROUPS,3.0-4.0,49,PULLAMPETA,165,560,149,130,279,0,185,0,185,97
ANDHRA PRADESH,KADAPA,ALL SOCIAL GROUPS,3.0-4.0,50,OBULAVARIPALLE,155,539,217,129,346,0,123,0,123,70
ANDHRA PRADESH,KADAPA,ALL SOCIAL GROUPS,3.0-4.0,51,KODUR,172,599,324,276,600,0,0,0,0,0
ANDHRA PRADESH,KADAPA,INSTITUTIONAL,2.0-3.0,1,KONDAPURAM,0,0,0,0,0,0,0,0,0,0
ANDHRA PRADESH,KADAPA,INSTITUTIONAL,2.0-3.0,2,MYLAVARAM,0,0,0,0,0,0,0,0,0,0
ANDHRA PRADESH,KADAPA,INSTITUTIONAL,2.0-3.0,3,PEDDAMUDIUM,0,0,0,0,0,0,0,0,0,0
ANDHRA PRADESH,KADAPA,INSTITUTIONAL,2.0-3.0,4,RAJUPALEM,0,0,0,0,0,0,0,0,0,0
ANDHRA PRADESH,KADAPA,INSTITUTIONAL,2.0-3.0,5,DUVVUR,0,0,0,0,0,0,0,0,0,0
ANDHRA PRADESH,KADAPA,INSTITUTIONAL,2.0-3.0,6,S.MYDUKUR,0,0,0,0,0,0,0,0,0,0
ANDHRA PRADESH,KADAPA,INSTITUTIONAL,2.0-3.0,7,BRAHMAMGARIMATTAM,0,0,0,0,0,0,0,0,0,0
ANDHRA PRADESH,KADAPA,INSTITUTIONAL,2.0-3.0,8,SRI AVADHUTHA KASINAYANA,0,0,0,0,0,0,0,0,0,0
ANDHRA PRADESH,KADAPA,INSTITUTIONAL,2.0-3.0,9,KALASAPADU,0,0,0,0,0,0,0,0,0,0
ANDHRA PRADESH,KADAPA,INSTITUTIONAL,2.0-3.0,10,PORUMAMILLA,1,2,1,1,2,0,0,0,0,0
ANDHRA PRADESH,KADAPA,INSTITUTIONAL,2.0-3.0,11,B.KODUR,0,0,0,0,0,0,0,0,0,0
ANDHRA PRADESH,KADAPA,INSTITUTIONAL,2.0-3.0,12,BADVEL,0,0,0,0,0,0,0,0,0,0
ANDHRA PRADESH,KADAPA,INSTITUTIONAL,2.0-3.0,13,GOPAVARAM,0,0,0,0,0,0,0,0,0,0
ANDHRA PRADESH,KADAPA,INSTITUTIONAL,2.0-3.0,14,KHAJIPET,0,0,0,0,0,0,0,0,0,0
ANDHRA PRADESH,KADAPA,INSTITUTIONAL,2.0-3.0,15,CHAPAD,0,0,0,0,0,0,0,0,0,0
ANDHRA PRADESH,KADAPA,INSTITUTIONAL,2.0-3.0,16,PRODDATUR,0,0,0,0,0,0,0,0,0,0
ANDHRA PRADESH,KADAPA,INSTITUTIONAL,2.0-3.0,17,JAMMALAMADUGU,0,0,0,0,0,0,0,0,0,0
ANDHRA PRADESH,KADAPA,INSTITUTIONAL,2.0-3.0,18,MUDDANUR,0,0,0,0,0,0,0,0,0,0
ANDHRA PRADESH,KADAPA,INSTITUTIONAL,2.0-3.0,19,SIMHADRIPURAM,0,0,0,0,0,0,0,0,0,0
ANDHRA PRADESH,KADAPA,INSTITUTIONAL,2.0-3.0,20,LINGALA,0,0,0,0,0,0,0,0,0,0
ANDHRA PRADESH,KADAPA,INSTITUTIONAL,2.0-3.0,21,PULIVENDLA,0,0,0,0,0,0,0,0,0,0
ANDHRA PRADESH,KADAPA,INSTITUTIONAL,2.0-3.0,22,VEMULA,0,0,0,0,0,0,0,0,0,0
ANDHRA PRADESH,KADAPA,INSTITUTIONAL,2.0-3.0,23,THONDUR,0,0,0,0,0,0,0,0,0,0
ANDHRA PRADESH,KADAPA,INSTITUTIONAL,2.0-3.0,24,VEERAPUNAYUNIPALLE,0,0,0,0,0,0,0,0,0,0
ANDHRA PRADESH,KADAPA,INSTITUTIONAL,2.0-3.0,25,YERRAGUNTLA,0,0,0,0,0,0,0,0,0,0
ANDHRA PRADESH,KADAPA,INSTITUTIONAL,2.0-3.0,26,KAMALAPURAM,0,0,0,0,0,0,0,0,0,0
ANDHRA PRADESH,KADAPA,INSTITUTIONAL,2.0-3.0,27,VALLUR,0,0,0,0,0,0,0,0,0,0
ANDHRA PRADESH,KADAPA,INSTITUTIONAL,2.0-3.0,28,CHENNUR,0,0,0,0,0,0,0,0,0,0
ANDHRA PRADESH,KADAPA,INSTITUTIONAL,2.0-3.0,29,ATLUR,0,0,0,0,0,0,0,0,0,0
ANDHRA PRADESH,KADAPA,INSTITUTIONAL,2.0-3.0,30,VONTIMITTA,0,0,0,0,0,0,0,0,0,0
ANDHRA PRADESH,KADAPA,INSTITUTIONAL,2.0-3.0,31,SIDHOUT,0,0,0,0,0,0,0,0,0,0
ANDHRA PRADESH,KADAPA,INSTITUTIONAL,2.0-3.0,32,CUDDAPAH,0,0,0,0,0,0,0,0,0,0
ANDHRA PRADESH,KADAPA,INSTITUTIONAL,2.0-3.0,33,CHINTHAKOMMADINNE,1,3,0,3,3,0,0,0,0,0
ANDHRA PRADESH,KADAPA,INSTITUTIONAL,2.0-3.0,34,PENDLIMARRI,0,0,0,0,0,0,0,0,0,0
ANDHRA PRADESH,KADAPA,INSTITUTIONAL,2.0-3.0,35,VEMPALLE,0,0,0,0,0,0,0,0,0,0
ANDHRA PRADESH,KADAPA,INSTITUTIONAL,2.0-3.0,36,CHAKRAYAPET,0,0,0,0,0,0,0,0,0,0
ANDHRA PRADESH,KADAPA,INSTITUTIONAL,2.0-3.0,37,GALIVEEDU,0,0,0,0,0,0,0,0,0,0
ANDHRA PRADESH,KADAPA,INSTITUTIONAL,2.0-3.0,38,CHINNAMANDEM,0,0,0,0,0,0,0,0,0,0
ANDHRA PRADESH,KADAPA,INSTITUTIONAL,2.0-3.0,39,SAMBEPALLE,0,0,0,0,0,0,0,0,0,0
ANDHRA PRADESH,KADAPA,INSTITUTIONAL,2.0-3.0,40,T SUNDUPALLE,0,0,0,0,0,0,0,0,0,0
ANDHRA PRADESH,KADAPA,INSTITUTIONAL,2.0-3.0,41,RAYACHOTI,0,0,0,0,0,0,0,0,0,0
ANDHRA PRADESH,KADAPA,INSTITUTIONAL,2.0-3.0,42,LAKKIREDDIPALLE,0,0,0,0,0,0,0,0,0,0
ANDHRA PRADESH,KADAPA,INSTITUTIONAL,2.0-3.0,43,RAMAPURAM,0,0,0,0,0,0,0,0,0,0
ANDHRA PRADESH,KADAPA,INSTITUTIONAL,2.0-3.0,44,VEERABALLE,0,0,0,0,0,0,0,0,0,0
ANDHRA PRADESH,KADAPA,INSTITUTIONAL,2.0-3.0,45,NANDALUR,0,0,0,0,0,0,0,0,0,0
ANDHRA PRADESH,KADAPA,INSTITUTIONAL,2.0-3.0,46,PENAGALUR,0,0,0,0,0,0,0,0,0,0
ANDHRA PRADESH,KADAPA,INSTITUTIONAL,2.0-3.0,47,CHITVEL,0,0,0,0,0,0,0,0,0,0
ANDHRA PRADESH,KADAPA,INSTITUTIONAL,2.0-3.0,48,RAJAMPET,0,0,0,0,0,0,0,0,0,0
ANDHRA PRADESH,KADAPA,INSTITUTIONAL,2.0-3.0,49,PULLAMPETA,0,0,0,0,0,0,0,0,0,0
ANDHRA PRADESH,KADAPA,INSTITUTIONAL,2.0-3.0,50,OBULAVARIPALLE,0,0,0,0,0,0,0,0,0,0
ANDHRA PRADESH,KADAPA,INSTITUTIONAL,2.0-3.0,51,KODUR,0,0,0,0,0,0,0,0,0,0
ANDHRA PRADESH,KADAPA,SCHEDULED CASTE,2.0-3.0,1,KONDAPURAM,34,77,58,19,77,0,0,0,0,0
ANDHRA PRADESH,KADAPA,SCHEDULED CASTE,2.0-3.0,2,MYLAVARAM,66,152,152,0,152,0,0,0,0,0
ANDHRA PRADESH,KADAPA,SCHEDULED CASTE,2.0-3.0,3,PEDDAMUDIUM,34,79,79,0,79,0,0,0,0,0
ANDHRA PRADESH,KADAPA,SCHEDULED CASTE,2.0-3.0,4,RAJUPALEM,25,60,53,6,59,0,0,0,0,0
ANDHRA PRADESH,KADAPA,SCHEDULED CASTE,2.0-3.0,5,DUVVUR,21,49,49,0,49,0,0,0,0,0
ANDHRA PRADESH,KADAPA,SCHEDULED CASTE,2.0-3.0,6,S.MYDUKUR,59,125,125,0,125,0,0,0,0,0
ANDHRA PRADESH,KADAPA,SCHEDULED CASTE,2.0-3.0,7,BRAHMAMGARIMATTAM,66,134,67,67,134,0,0,0,0,0
ANDHRA PRADESH,KADAPA,SCHEDULED CASTE,2.0-3.0,8,SRI AVADHUTHA KASINAYANA,91,199,73,126,199,0,0,0,0,0
ANDHRA PRADESH,KADAPA,SCHEDULED CASTE,2.0-3.0,9,KALASAPADU,35,76,38,38,76,0,0,0,0,0
ANDHRA PRADESH,KADAPA,SCHEDULED CASTE,2.0-3.0,10,PORUMAMILLA,137,298,216,82,298,0,0,0,0,0
ANDHRA PRADESH,KADAPA,SCHEDULED CASTE,2.0-3.0,11,B.KODUR,31,67,17,0,17,0,0,0,0,50
ANDHRA PRADESH,KADAPA,SCHEDULED CASTE,2.0-3.0,12,BADVEL,47,101,29,73,102,0,0,0,0,0
ANDHRA PRADESH,KADAPA,SCHEDULED CASTE,2.0-3.0,13,GOPAVARAM,26,59,16,23,39,0,0,4,4,16
ANDHRA PRADESH,KADAPA,SCHEDULED CASTE,2.0-3.0,14,KHAJIPET,22,50,50,0,50,0,0,0,0,0
ANDHRA PRADESH,KADAPA,SCHEDULED CASTE,2.0-3.0,15,CHAPAD,3,8,6,2,8,0,0,0,0,0
ANDHRA PRADESH,KADAPA,SCHEDULED CASTE,2.0-3.0,16,PRODDATUR,8,20,10,10,20,0,0,0,0,0
ANDHRA PRADESH,KADAPA,SCHEDULED CASTE,2.0-3.0,17,JAMMALAMADUGU,1,2,1,1,2,0,0,0,0,0
ANDHRA PRADESH,KADAPA,SCHEDULED CASTE,2.0-3.0,18,MUDDANUR,48,109,76,33,109,0,0,0,0,0
ANDHRA PRADESH,KADAPA,SCHEDULED CASTE,2.0-3.0,19,SIMHADRIPURAM,34,76,28,49,77,0,0,0,0,0
ANDHRA PRADESH,KADAPA,SCHEDULED CASTE,2.0-3.0,20,LINGALA,58,126,126,0,126,0,0,0,0,0
ANDHRA PRADESH,KADAPA,SCHEDULED CASTE,2.0-3.0,21,PULIVENDLA,20,43,43,0,43,0,0,0,0,0
ANDHRA PRADESH,KADAPA,SCHEDULED CASTE,2.0-3.0,22,VEMULA,73,162,81,81,162,0,0,0,0,0
ANDHRA PRADESH,KADAPA,SCHEDULED CASTE,2.0-3.0,23,THONDUR,42,92,21,71,92,0,0,0,0,0
ANDHRA PRADESH,KADAPA,SCHEDULED CASTE,2.0-3.0,24,VEERAPUNAYUNIPALLE,62,143,107,36,143,0,0,0,0,0
ANDHRA PRADESH,KADAPA,SCHEDULED CASTE,2.0-3.0,25,YERRAGUNTLA,6,14,7,7,14,0,0,0,0,0
ANDHRA PRADESH,KADAPA,SCHEDULED CASTE,2.0-3.0,26,KAMALAPURAM,9,21,17,4,21,0,0,0,0,0
ANDHRA PRADESH,KADAPA,SCHEDULED CASTE,2.0-3.0,27,VALLUR,19,41,41,0,41,0,0,0,0,0
ANDHRA PRADESH,KADAPA,SCHEDULED CASTE,2.0-3.0,28,CHENNUR,6,13,6,7,13,0,0,0,0,0
ANDHRA PRADESH,KADAPA,SCHEDULED CASTE,2.0-3.0,29,ATLUR,36,77,9,67,76,0,0,0,0,1
ANDHRA PRADESH,KADAPA,SCHEDULED CASTE,2.0-3.0,30,VONTIMITTA,24,50,28,23,51,0,0,0,0,0
ANDHRA PRADESH,KADAPA,SCHEDULED CASTE,2.0-3.0,31,SIDHOUT,15,32,14,9,23,0,0,3,3,6
ANDHRA PRADESH,KADAPA,SCHEDULED CASTE,2.0-3.0,32,CUDDAPAH,5,11,8,3,11,0,0,0,0,0
ANDHRA PRADESH,KADAPA,SCHEDULED CASTE,2.0-3.0,33,CHINTHAKOMMADINNE,28,61,61,0,61,0,0,0,0,0
ANDHRA PRADESH,KADAPA,SCHEDULED CASTE,2.0-3.0,34,PENDLIMARRI,41,91,60,31,91,0,0,0,0,0
ANDHRA PRADESH,KADAPA,SCHEDULED CASTE,2.0-3.0,35,VEMPALLE,20,45,45,0,45,0,0,0,0,0
ANDHRA PRADESH,KADAPA,SCHEDULED CASTE,2.0-3.0,36,CHAKRAYAPET,34,79,71,0,71,0,8,0,8,0
ANDHRA PRADESH,KADAPA,SCHEDULED CASTE,2.0-3.0,37,GALIVEEDU,31,71,23,42,65,0,5,0,5,2
ANDHRA PRADESH,KADAPA,SCHEDULED CASTE,2.0-3.0,38,CHINNAMANDEM,19,44,40,0,40,0,5,0,5,0
ANDHRA PRADESH,KADAPA,SCHEDULED CASTE,2.0-3.0,39,SAMBEPALLE,60,140,134,5,139,0,0,0,0,0
ANDHRA PRADESH,KADAPA,SCHEDULED CASTE,2.0-3.0,40,T SUNDUPALLE,30,65,51,14,65,0,0,0,0,0
ANDHRA PRADESH,KADAPA,SCHEDULED CASTE,2.0-3.0,41,RAYACHOTI,32,75,55,14,69,0,5,0,5,1
ANDHRA PRADESH,KADAPA,SCHEDULED CASTE,2.0-3.0,42,LAKKIREDDIPALLE,26,58,29,29,58,0,0,0,0,0
ANDHRA PRADESH,KADAPA,SCHEDULED CASTE,2.0-3.0,43,RAMAPURAM,77,177,177,0,177,0,0,0,0,0
ANDHRA PRADESH,KADAPA,SCHEDULED CASTE,2.0-3.0,44,VEERABALLE,40,91,80,12,92,0,0,0,0,0
ANDHRA PRADESH,KADAPA,SCHEDULED CASTE,2.0-3.0,45,NANDALUR,17,38,38,0,38,0,0,0,0,0
ANDHRA PRADESH,KADAPA,SCHEDULED CASTE,2.0-3.0,46,PENAGALUR,41,88,18,24,42,0,47,0,47,0
ANDHRA PRADESH,KADAPA,SCHEDULED CASTE,2.0-3.0,47,CHITVEL,57,119,20,99,119,0,0,0,0,0
ANDHRA PRADESH,KADAPA,SCHEDULED CASTE,2.0-3.0,48,RAJAMPET,57,122,12,39,51,0,46,9,55,15
ANDHRA PRADESH,KADAPA,SCHEDULED CASTE,2.0-3.0,49,PULLAMPETA,144,304,56,99,155,0,149,0,149,0
ANDHRA PRADESH,KADAPA,SCHEDULED CASTE,2.0-3.0,50,OBULAVARIPALLE,25,55,28,28,56,0,0,0,0,0
ANDHRA PRADESH,KADAPA,SCHEDULED CASTE,2.0-3.0,51,KODUR,94,208,133,75,208,0,0,0,0,0
ANDHRA PRADESH,KADAPA,OTHERS,2.0-3.0,1,KONDAPURAM,1054,2516,2049,464,2513,0,2,0,2,1
ANDHRA PRADESH,KADAPA,OTHERS,2.0-3.0,2,MYLAVARAM,804,1928,1725,203,1928,0,0,0,0,0
ANDHRA PRADESH,KADAPA,OTHERS,2.0-3.0,3,PEDDAMUDIUM,1938,4721,4049,663,4712,0,6,0,6,4
ANDHRA PRADESH,KADAPA,OTHERS,2.0-3.0,4,RAJUPALEM,1304,3190,3166,23,3189,0,0,0,0,2
ANDHRA PRADESH,KADAPA,OTHERS,2.0-3.0,5,DUVVUR,744,1762,1741,0,1741,0,14,0,14,8
ANDHRA PRADESH,KADAPA,OTHERS,2.0-3.0,6,S.MYDUKUR,763,1715,1629,82,1711,0,2,0,2,1
ANDHRA PRADESH,KADAPA,OTHERS,2.0-3.0,7,BRAHMAMGARIMATTAM,231,471,159,311,470,0,0,0,0,0
ANDHRA PRADESH,KADAPA,OTHERS,2.0-3.0,8,SRI AVADHUTHA KASINAYANA,883,2011,1214,796,2010,0,0,0,0,0
ANDHRA PRADESH,KADAPA,OTHERS,2.0-3.0,9,KALASAPADU,439,1016,778,119,897,0,76,0,76,43
ANDHRA PRADESH,KADAPA,OTHERS,2.0-3.0,10,PORUMAMILLA,533,1234,663,571,1234,0,0,0,0,0
ANDHRA PRADESH,KADAPA,OTHERS,2.0-3.0,11,B.KODUR,528,1242,301,121,422,0,0,0,0,820
ANDHRA PRADESH,KADAPA,OTHERS,2.0-3.0,12,BADVEL,317,724,213,334,547,0,41,19,60,117
ANDHRA PRADESH,KADAPA,OTHERS,2.0-3.0,13,GOPAVARAM,219,519,275,165,440,0,33,4,37,42
ANDHRA PRADESH,KADAPA,OTHERS,2.0-3.0,14,KHAJIPET,538,1267,1158,109,1267,0,0,0,0,0
ANDHRA PRADESH,KADAPA,OTHERS,2.0-3.0,15,CHAPAD,522,1234,1139,62,1201,0,4,0,4,28
ANDHRA PRADESH,KADAPA,OTHERS,2.0-3.0,16,PRODDATUR,852,2045,2030,14,2044,0,0,0,0,0
ANDHRA PRADESH,KADAPA,OTHERS,2.0-3.0,17,JAMMALAMADUGU,712,1702,1641,57,1698,0,3,0,3,2
ANDHRA PRADESH,KADAPA,OTHERS,2.0-3.0,18,MUDDANUR,984,2317,2025,287,2312,0,2,1,3,2
ANDHRA PRADESH,KADAPA,OTHERS,2.0-3.0,19,SIMHADRIPURAM,2150,5155,3299,1826,5125,0,19,0,19,11
ANDHRA PRADESH,KADAPA,OTHERS,2.0-3.0,20,LINGALA,1720,4062,4031,31,4062,0,0,0,0,0
ANDHRA PRADESH,KADAPA,OTHERS,2.0-3.0,21,PULIVENDLA,798,1870,1870,0,1870,0,0,0,0,0
ANDHRA PRADESH,KADAPA,OTHERS,2.0-3.0,22,VEMULA,1633,3917,3369,247,3616,0,189,4,193,108
ANDHRA PRADESH,KADAPA,OTHERS,2.0-3.0,23,THONDUR,1922,4611,3977,635,4612,0,0,0,0,0
ANDHRA PRADESH,KADAPA,OTHERS,2.0-3.0,24,VEERAPUNAYUNIPALLE,1844,4435,3844,591,4435,0,0,0,0,0
ANDHRA PRADESH,KADAPA,OTHERS,2.0-3.0,25,YERRAGUNTLA,1268,3063,1916,1147,3063,0,0,0,0,0
ANDHRA PRADESH,KADAPA,OTHERS,2.0-3.0,26,KAMALAPURAM,993,2373,1678,695,2373,0,0,0,0,0
ANDHRA PRADESH,KADAPA,OTHERS,2.0-3.0,27,VALLUR,736,1726,1270,339,1609,0,73,2,75,43
ANDHRA PRADESH,KADAPA,OTHERS,2.0-3.0,28,CHENNUR,246,580,493,88,581,0,0,0,0,0
ANDHRA PRADESH,KADAPA,OTHERS,2.0-3.0,29,ATLUR,344,777,328,449,777,0,0,0,0,0
ANDHRA PRADESH,KADAPA,OTHERS,2.0-3.0,30,VONTIMITTA,281,618,146,240,386,0,147,0,147,84
ANDHRA PRADESH,KADAPA,OTHERS,2.0-3.0,31,SIDHOUT,247,567,289,61,350,0,4,131,135,83
ANDHRA PRADESH,KADAPA,OTHERS,2.0-3.0,32,CUDDAPAH,181,431,336,95,431,0,0,0,0,0
ANDHRA PRADESH,KADAPA,OTHERS,2.0-3.0,33,CHINTHAKOMMADINNE,540,1250,1213,37,1250,0,0,0,0,0
ANDHRA PRADESH,KADAPA,OTHERS,2.0-3.0,34,PENDLIMARRI,1082,2539,2102,437,2539,0,0,0,0,0
ANDHRA PRADESH,KADAPA,OTHERS,2.0-3.0,35,VEMPALLE,1022,2438,2408,27,2435,0,2,0,2,1
ANDHRA PRADESH,KADAPA,OTHERS,2.0-3.0,36,CHAKRAYAPET,909,2142,1661,373,2034,15,47,5,67,40
ANDHRA PRADESH,KADAPA,OTHERS,2.0-3.0,37,GALIVEEDU,1354,3170,2108,866,2974,0,117,0,117,79
ANDHRA PRADESH,KADAPA,OTHERS,2.0-3.0,38,CHINNAMANDEM,813,1931,1700,54,1754,0,107,1,108,69
ANDHRA PRADESH,KADAPA,OTHERS,2.0-3.0,39,SAMBEPALLE,1529,3676,3142,199,3341,0,197,15,212,123
ANDHRA PRADESH,KADAPA,OTHERS,2.0-3.0,40,T SUNDUPALLE,1151,2702,1193,1240,2433,3,168,0,171,98
ANDHRA PRADESH,KADAPA,OTHERS,2.0-3.0,41,RAYACHOTI,1009,2389,913,1161,2074,0,197,0,197,118
ANDHRA PRADESH,KADAPA,OTHERS,2.0-3.0,42,LAKKIREDDIPALLE,1197,2837,2469,340,2809,0,0,0,0,28
ANDHRA PRADESH,KADAPA,OTHERS,2.0-3.0,43,RAMAPURAM,1192,2861,2387,343,2730,0,83,0,83,47
ANDHRA PRADESH,KADAPA,OTHERS,2.0-3.0,44,VEERABALLE,672,1578,1205,365,1570,0,0,0,0,8
ANDHRA PRADESH,KADAPA,OTHERS,2.0-3.0,45,NANDALUR,172,401,194,203,397,0,2,1,3,2
ANDHRA PRADESH,KADAPA,OTHERS,2.0-3.0,46,PENAGALUR,287,624,173,209,382,3,151,0,154,87
ANDHRA PRADESH,KADAPA,OTHERS,2.0-3.0,47,CHITVEL,774,1716,177,1480,1657,0,38,0,38,21
ANDHRA PRADESH,KADAPA,OTHERS,2.0-3.0,48,RAJAMPET,800,1793,781,454,1235,148,33,172,353,205
ANDHRA PRADESH,KADAPA,OTHERS,2.0-3.0,49,PULLAMPETA,1008,2200,563,546,1109,0,696,2,698,394
ANDHRA PRADESH,KADAPA,OTHERS,2.0-3.0,50,OBULAVARIPALLE,940,2083,755,819,1574,0,324,0,324,184
ANDHRA PRADESH,KADAPA,OTHERS,2.0-3.0,51,KODUR,877,1927,1134,793,1927,0,0,0,0,0
ANDHRA PRADESH,KADAPA,SCHEDULED TRIBES,2.0-3.0,1,KONDAPURAM,1,2,1,1,2,0,0,0,0,0
ANDHRA PRADESH,KADAPA,SCHEDULED TRIBES,2.0-3.0,2,MYLAVARAM,16,36,36,0,36,0,0,0,0,0
ANDHRA PRADESH,KADAPA,SCHEDULED TRIBES,2.0-3.0,3,PEDDAMUDIUM,7,17,13,4,17,0,0,0,0,0
ANDHRA PRADESH,KADAPA,SCHEDULED TRIBES,2.0-3.0,4,RAJUPALEM,1,2,1,1,2,0,0,0,0,0
ANDHRA PRADESH,KADAPA,SCHEDULED TRIBES,2.0-3.0,5,DUVVUR,1,3,1,1,2,0,0,0,0,0
ANDHRA PRADESH,KADAPA,SCHEDULED TRIBES,2.0-3.0,6,S.MYDUKUR,8,17,9,9,18,0,0,0,0,0
ANDHRA PRADESH,KADAPA,SCHEDULED TRIBES,2.0-3.0,7,BRAHMAMGARIMATTAM,0,0,0,0,0,0,0,0,0,0
ANDHRA PRADESH,KADAPA,SCHEDULED TRIBES,2.0-3.0,8,SRI AVADHUTHA KASINAYANA,19,42,21,21,42,0,0,0,0,0
ANDHRA PRADESH,KADAPA,SCHEDULED TRIBES,2.0-3.0,9,KALASAPADU,0,0,0,0,0,0,0,0,0,0
ANDHRA PRADESH,KADAPA,SCHEDULED TRIBES,2.0-3.0,10,PORUMAMILLA,23,51,22,29,51,0,0,0,0,0
ANDHRA PRADESH,KADAPA,SCHEDULED TRIBES,2.0-3.0,11,B.KODUR,2,5,2,2,4,0,0,0,0,0
ANDHRA PRADESH,KADAPA,SCHEDULED TRIBES,2.0-3.0,12,BADVEL,7,16,8,8,16,0,0,0,0,0
ANDHRA PRADESH,KADAPA,SCHEDULED TRIBES,2.0-3.0,13,GOPAVARAM,0,0,0,0,0,0,0,0,0,0
ANDHRA PRADESH,KADAPA,SCHEDULED TRIBES,2.0-3.0,14,KHAJIPET,2,4,2,2,4,0,0,0,0,0
ANDHRA PRADESH,KADAPA,SCHEDULED TRIBES,2.0-3.0,15,CHAPAD,2,4,2,2,4,0,0,0,0,0
ANDHRA PRADESH,KADAPA,SCHEDULED TRIBES,2.0-3.0,16,PRODDATUR,0,0,0,0,0,0,0,0,0,0
ANDHRA PRADESH,KADAPA,SCHEDULED TRIBES,2.0-3.0,17,JAMMALAMADUGU,1,2,0,2,2,0,0,0,0,0
ANDHRA PRADESH,KADAPA,SCHEDULED TRIBES,2.0-3.0,18,MUDDANUR,8,19,10,10,20,0,0,0,0,0
ANDHRA PRADESH,KADAPA,SCHEDULED TRIBES,2.0-3.0,19,SIMHADRIPURAM,11,25,9,16,25,0,0,0,0,0
ANDHRA PRADESH,KADAPA,SCHEDULED TRIBES,2.0-3.0,20,LINGALA,4,9,5,5,10,0,0,0,0,0
ANDHRA PRADESH,KADAPA,SCHEDULED TRIBES,2.0-3.0,21,PULIVENDLA,24,53,53,0,53,0,0,0,0,0
ANDHRA PRADESH,KADAPA,SCHEDULED TRIBES,2.0-3.0,22,VEMULA,10,23,12,12,24,0,0,0,0,0
ANDHRA PRADESH,KADAPA,SCHEDULED TRIBES,2.0-3.0,23,THONDUR,3,7,0,7,7,0,0,0,0,0
ANDHRA PRADESH,KADAPA,SCHEDULED TRIBES,2.0-3.0,24,VEERAPUNAYUNIPALLE,13,30,15,15,30,0,0,0,0,0
ANDHRA PRADESH,KADAPA,SCHEDULED TRIBES,2.0-3.0,25,YERRAGUNTLA,0,0,0,0,0,0,0,0,0,0
ANDHRA PRADESH,KADAPA,SCHEDULED TRIBES,2.0-3.0,26,KAMALAPURAM,0,0,0,0,0,0,0,0,0,0
ANDHRA PRADESH,KADAPA,SCHEDULED TRIBES,2.0-3.0,27,VALLUR,1,3,1,1,2,0,0,0,0,0
ANDHRA PRADESH,KADAPA,SCHEDULED TRIBES,2.0-3.0,28,CHENNUR,0,0,0,0,0,0,0,0,0,0
ANDHRA PRADESH,KADAPA,SCHEDULED TRIBES,2.0-3.0,29,ATLUR,1,2,1,1,2,0,0,0,0,0
ANDHRA PRADESH,KADAPA,SCHEDULED TRIBES,2.0-3.0,30,VONTIMITTA,0,0,0,0,0,0,0,0,0,0
ANDHRA PRADESH,KADAPA,SCHEDULED TRIBES,2.0-3.0,31,SIDHOUT,4,9,5,5,10,0,0,0,0,0
ANDHRA PRADESH,KADAPA,SCHEDULED TRIBES,2.0-3.0,32,CUDDAPAH,3,7,4,4,8,0,0,0,0,0
ANDHRA PRADESH,KADAPA,SCHEDULED TRIBES,2.0-3.0,33,CHINTHAKOMMADINNE,8,18,18,0,18,0,0,0,0,0
ANDHRA PRADESH,KADAPA,SCHEDULED TRIBES,2.0-3.0,34,PENDLIMARRI,1,2,2,0,2,0,0,0,0,0
ANDHRA PRADESH,KADAPA,SCHEDULED TRIBES,2.0-3.0,35,VEMPALLE,19,39,20,20,40,0,0,0,0,0
ANDHRA PRADESH,KADAPA,SCHEDULED TRIBES,2.0-3.0,36,CHAKRAYAPET,39,92,74,0,74,0,15,0,15,4
ANDHRA PRADESH,KADAPA,SCHEDULED TRIBES,2.0-3.0,37,GALIVEEDU,42,94,45,47,92,0,1,0,1,0
ANDHRA PRADESH,KADAPA,SCHEDULED TRIBES,2.0-3.0,38,CHINNAMANDEM,1,3,1,1,2,0,0,0,0,0
ANDHRA PRADESH,KADAPA,SCHEDULED TRIBES,2.0-3.0,39,SAMBEPALLE,43,98,90,5,95,0,2,0,2,1
ANDHRA PRADESH,KADAPA,SCHEDULED TRIBES,2.0-3.0,40,T SUNDUPALLE,48,111,67,44,111,0,0,0,0,0
ANDHRA PRADESH,KADAPA,SCHEDULED TRIBES,2.0-3.0,41,RAYACHOTI,1,2,1,1,2,0,0,0,0,0
ANDHRA PRADESH,KADAPA,SCHEDULED TRIBES,2.0-3.0,42,LAKKIREDDIPALLE,1,2,1,1,2,0,0,0,0,0
ANDHRA PRADESH,KADAPA,SCHEDULED TRIBES,2.0-3.0,43,RAMAPURAM,24,56,47,9,56,0,0,0,0,0
ANDHRA PRADESH,KADAPA,SCHEDULED TRIBES,2.0-3.0,44,VEERABALLE,15,33,25,8,33,0,0,0,0,0
ANDHRA PRADESH,KADAPA,SCHEDULED TRIBES,2.0-3.0,45,NANDALUR,1,3,0,3,3,0,0,0,0,0
ANDHRA PRADESH,KADAPA,SCHEDULED TRIBES,2.0-3.0,46,PENAGALUR,1,2,1,1,2,0,0,0,0,0
ANDHRA PRADESH,KADAPA,SCHEDULED TRIBES,2.0-3.0,47,CHITVEL,8,17,8,8,16,0,0,0,0,0
ANDHRA PRADESH,KADAPA,SCHEDULED TRIBES,2.0-3.0,48,RAJAMPET,6,14,7,7,14,0,0,0,0,0
ANDHRA PRADESH,KADAPA,SCHEDULED TRIBES,2.0-3.0,49,PULLAMPETA,42,85,43,43,86,0,0,0,0,0
ANDHRA PRADESH,KADAPA,SCHEDULED TRIBES,2.0-3.0,50,OBULAVARIPALLE,12,26,13,13,26,0,0,0,0,0
ANDHRA PRADESH,KADAPA,SCHEDULED TRIBES,2.0-3.0,51,KODUR,45,101,31,70,101,0,0,0,0,0
ANDHRA PRADESH,KADAPA,ALL SOCIAL GROUPS,2.0-3.0,1,KONDAPURAM,1089,2595,2108,484,2592,0,2,0,2,1
ANDHRA PRADESH,KADAPA,ALL SOCIAL GROUPS,2.0-3.0,2,MYLAVARAM,886,2115,1912,203,2115,0,0,0,0,0
ANDHRA PRADESH,KADAPA,ALL SOCIAL GROUPS,2.0-3.0,3,PEDDAMUDIUM,1979,4817,4141,667,4808,0,6,0,6,4
ANDHRA PRADESH,KADAPA,ALL SOCIAL GROUPS,2.0-3.0,4,RAJUPALEM,1330,3252,3220,30,3250,0,0,0,0,2
ANDHRA PRADESH,KADAPA,ALL SOCIAL GROUPS,2.0-3.0,5,DUVVUR,766,1814,1791,1,1792,0,14,0,14,8
ANDHRA PRADESH,KADAPA,ALL SOCIAL GROUPS,2.0-3.0,6,S.MYDUKUR,830,1857,1763,91,1854,0,2,0,2,1
ANDHRA PRADESH,KADAPA,ALL SOCIAL GROUPS,2.0-3.0,7,BRAHMAMGARIMATTAM,297,605,226,379,605,0,0,0,0,0
ANDHRA PRADESH,KADAPA,ALL SOCIAL GROUPS,2.0-3.0,8,SRI AVADHUTHA KASINAYANA,993,2252,1309,943,2252,0,0,0,0,0
ANDHRA PRADESH,KADAPA,ALL SOCIAL GROUPS,2.0-3.0,9,KALASAPADU,474,1093,816,158,974,0,76,0,76,43
ANDHRA PRADESH,KADAPA,ALL SOCIAL GROUPS,2.0-3.0,10,PORUMAMILLA,694,1585,902,683,1585,0,0,0,0,0
ANDHRA PRADESH,KADAPA,ALL SOCIAL GROUPS,2.0-3.0,11,B.KODUR,561,1314,320,123,443,0,0,0,0,870
ANDHRA PRADESH,KADAPA,ALL SOCIAL GROUPS,2.0-3.0,12,BADVEL,371,841,249,414,663,0,41,19,60,117
ANDHRA PRADESH,KADAPA,ALL SOCIAL GROUPS,2.0-3.0,13,GOPAVARAM,245,578,291,188,479,0,33,8,41,58
ANDHRA PRADESH,KADAPA,ALL SOCIAL GROUPS,2.0-3.0,14,KHAJIPET,562,1321,1211,111,1322,0,0,0,0,0
ANDHRA PRADESH,KADAPA,ALL SOCIAL GROUPS,2.0-3.0,15,CHAPAD,527,1247,1148,66,1214,0,4,0,4,28
ANDHRA PRADESH,KADAPA,ALL SOCIAL GROUPS,2.0-3.0,16,PRODDATUR,860,2064,2040,24,2064,0,0,0,0,0
ANDHRA PRADESH,KADAPA,ALL SOCIAL GROUPS,2.0-3.0,17,JAMMALAMADUGU,714,1707,1642,60,1702,0,3,0,3,2
ANDHRA PRADESH,KADAPA,ALL SOCIAL GROUPS,2.0-3.0,18,MUDDANUR,1040,2445,2111,330,2441,0,2,1,3,2
ANDHRA PRADESH,KADAPA,ALL SOCIAL GROUPS,2.0-3.0,19,SIMHADRIPURAM,2195,5256,3335,1891,5226,0,19,0,19,11
ANDHRA PRADESH,KADAPA,ALL SOCIAL GROUPS,2.0-3.0,20,LINGALA,1782,4197,4161,36,4197,0,0,0,0,0
ANDHRA PRADESH,KADAPA,ALL SOCIAL GROUPS,2.0-3.0,21,PULIVENDLA,842,1967,1967,0,1967,0,0,0,0,0
ANDHRA PRADESH,KADAPA,ALL SOCIAL GROUPS,2.0-3.0,22,VEMULA,1716,4102,3462,340,3802,0,189,4,193,108
ANDHRA PRADESH,KADAPA,ALL SOCIAL GROUPS,2.0-3.0,23,THONDUR,1967,4710,3998,713,4711,0,0,0,0,0
ANDHRA PRADESH,KADAPA,ALL SOCIAL GROUPS,2.0-3.0,24,VEERAPUNAYUNIPALLE,1919,4608,3966,642,4608,0,0,0,0,0
ANDHRA PRADESH,KADAPA,ALL SOCIAL GROUPS,2.0-3.0,25,YERRAGUNTLA,1274,3077,1923,1154,3077,0,0,0,0,0
ANDHRA PRADESH,KADAPA,ALL SOCIAL GROUPS,2.0-3.0,26,KAMALAPURAM,1002,2393,1694,699,2393,0,0,0,0,0
ANDHRA PRADESH,KADAPA,ALL SOCIAL GROUPS,2.0-3.0,27,VALLUR,756,1770,1313,340,1653,0,73,2,75,43
ANDHRA PRADESH,KADAPA,ALL SOCIAL GROUPS,2.0-3.0,28,CHENNUR,252,593,499,94,593,0,0,0,0,0
ANDHRA PRADESH,KADAPA,ALL SOCIAL GROUPS,2.0-3.0,29,ATLUR,381,856,338,517,855,0,0,0,0,1
ANDHRA PRADESH,KADAPA,ALL SOCIAL GROUPS,2.0-3.0,30,VONTIMITTA,305,668,174,263,437,0,147,0,147,84
ANDHRA PRADESH,KADAPA,ALL SOCIAL GROUPS,2.0-3.0,31,SIDHOUT,266,609,307,75,382,0,4,134,138,89
ANDHRA PRADESH,KADAPA,ALL SOCIAL GROUPS,2.0-3.0,32,CUDDAPAH,189,450,347,102,449,0,0,0,0,0
ANDHRA PRADESH,KADAPA,ALL SOCIAL GROUPS,2.0-3.0,33,CHINTHAKOMMADINNE,577,1332,1292,40,1332,0,0,0,0,0
ANDHRA PRADESH,KADAPA,ALL SOCIAL GROUPS,2.0-3.0,34,PENDLIMARRI,1124,2632,2163,468,2631,0,0,0,0,0
ANDHRA PRADESH,KADAPA,ALL SOCIAL GROUPS,2.0-3.0,35,VEMPALLE,1061,2523,2473,46,2519,0,2,0,2,1
ANDHRA PRADESH,KADAPA,ALL SOCIAL GROUPS,2.0-3.0,36,CHAKRAYAPET,982,2312,1806,373,2179,15,70,5,90,43
ANDHRA PRADESH,KADAPA,ALL SOCIAL GROUPS,2.0-3.0,37,GALIVEEDU,1427,3336,2176,954,3130,0,124,0,124,81
ANDHRA PRADESH,KADAPA,ALL SOCIAL GROUPS,2.0-3.0,38,CHINNAMANDEM,833,1978,1741,56,1797,0,112,1,113,69
ANDHRA PRADESH,KADAPA,ALL SOCIAL GROUPS,2.0-3.0,39,SAMBEPALLE,1632,3914,3367,209,3576,0,200,15,215,124
ANDHRA PRADESH,KADAPA,ALL SOCIAL GROUPS,2.0-3.0,40,T SUNDUPALLE,1229,2877,1311,1298,2609,3,168,0,171,98
ANDHRA PRADESH,KADAPA,ALL SOCIAL GROUPS,2.0-3.0,41,RAYACHOTI,1042,2466,969,1175,2144,0,203,0,203,119
ANDHRA PRADESH,KADAPA,ALL SOCIAL GROUPS,2.0-3.0,42,LAKKIREDDIPALLE,1224,2897,2499,370,2869,0,0,0,0,28
ANDHRA PRADESH,KADAPA,ALL SOCIAL GROUPS,2.0-3.0,43,RAMAPURAM,1293,3093,2611,352,2963,0,83,0,83,47
ANDHRA PRADESH,KADAPA,ALL SOCIAL GROUPS,2.0-3.0,44,VEERABALLE,727,1702,1309,385,1694,0,0,0,0,8
ANDHRA PRADESH,KADAPA,ALL SOCIAL GROUPS,2.0-3.0,45,NANDALUR,190,441,231,206,437,0,2,1,3,2
ANDHRA PRADESH,KADAPA,ALL SOCIAL GROUPS,2.0-3.0,46,PENAGALUR,329,714,191,234,425,3,198,0,201,87
ANDHRA PRADESH,KADAPA,ALL SOCIAL GROUPS,2.0-3.0,47,CHITVEL,839,1851,205,1587,1792,0,38,0,38,21
ANDHRA PRADESH,KADAPA,ALL SOCIAL GROUPS,2.0-3.0,48,RAJAMPET,863,1929,800,500,1300,148,80,181,409,220
ANDHRA PRADESH,KADAPA,ALL SOCIAL GROUPS,2.0-3.0,49,PULLAMPETA,1194,2589,662,688,1350,0,845,2,847,394
ANDHRA PRADESH,KADAPA,ALL SOCIAL GROUPS,2.0-3.0,50,OBULAVARIPALLE,977,2164,796,860,1656,0,324,0,324,184
ANDHRA PRADESH,KADAPA,ALL SOCIAL GROUPS,2.0-3.0,51,KODUR,1016,2236,1298,938,2236,0,0,0,0,0
ANDHRA PRADESH,KADAPA,INSTITUTIONAL,5.0-7.5,1,KONDAPURAM,0,0,0,0,0,0,0,0,0,0
ANDHRA PRADESH,KADAPA,INSTITUTIONAL,5.0-7.5,2,MYLAVARAM,0,0,0,0,0,0,0,0,0,0
ANDHRA PRADESH,KADAPA,INSTITUTIONAL,5.0-7.5,3,PEDDAMUDIUM,0,0,0,0,0,0,0,0,0,0
ANDHRA PRADESH,KADAPA,INSTITUTIONAL,5.0-7.5,4,RAJUPALEM,0,0,0,0,0,0,0,0,0,0
ANDHRA PRADESH,KADAPA,INSTITUTIONAL,5.0-7.5,5,DUVVUR,0,0,0,0,0,0,0,0,0,0
ANDHRA PRADESH,KADAPA,INSTITUTIONAL,5.0-7.5,6,S.MYDUKUR,0,0,0,0,0,0,0,0,0,0
ANDHRA PRADESH,KADAPA,INSTITUTIONAL,5.0-7.5,7,BRAHMAMGARIMATTAM,0,0,0,0,0,0,0,0,0,0
ANDHRA PRADESH,KADAPA,INSTITUTIONAL,5.0-7.5,8,SRI AVADHUTHA KASINAYANA,0,0,0,0,0,0,0,0,0,0
ANDHRA PRADESH,KADAPA,INSTITUTIONAL,5.0-7.5,9,KALASAPADU,0,0,0,0,0,0,0,0,0,0
ANDHRA PRADESH,KADAPA,INSTITUTIONAL,5.0-7.5,10,PORUMAMILLA,0,0,0,0,0,0,0,0,0,0
ANDHRA PRADESH,KADAPA,INSTITUTIONAL,5.0-7.5,11,B.KODUR,0,0,0,0,0,0,0,0,0,0
ANDHRA PRADESH,KADAPA,INSTITUTIONAL,5.0-7.5,12,BADVEL,0,0,0,0,0,0,0,0,0,0
ANDHRA PRADESH,KADAPA,INSTITUTIONAL,5.0-7.5,13,GOPAVARAM,0,0,0,0,0,0,0,0,0,0
ANDHRA PRADESH,KADAPA,INSTITUTIONAL,5.0-7.5,14,KHAJIPET,0,0,0,0,0,0,0,0,0,0
ANDHRA PRADESH,KADAPA,INSTITUTIONAL,5.0-7.5,15,CHAPAD,0,0,0,0,0,0,0,0,0,0
ANDHRA PRADESH,KADAPA,INSTITUTIONAL,5.0-7.5,16,PRODDATUR,0,0,0,0,0,0,0,0,0,0
ANDHRA PRADESH,KADAPA,INSTITUTIONAL,5.0-7.5,17,JAMMALAMADUGU,0,0,0,0,0,0,0,0,0,0
ANDHRA PRADESH,KADAPA,INSTITUTIONAL,5.0-7.5,18,MUDDANUR,0,0,0,0,0,0,0,0,0,0
ANDHRA PRADESH,KADAPA,INSTITUTIONAL,5.0-7.5,19,SIMHADRIPURAM,0,0,0,0,0,0,0,0,0,0
ANDHRA PRADESH,KADAPA,INSTITUTIONAL,5.0-7.5,20,LINGALA,0,0,0,0,0,0,0,0,0,0
ANDHRA PRADESH,KADAPA,INSTITUTIONAL,5.0-7.5,21,PULIVENDLA,0,0,0,0,0,0,0,0,0,0
ANDHRA PRADESH,KADAPA,INSTITUTIONAL,5.0-7.5,22,VEMULA,0,0,0,0,0,0,0,0,0,0
ANDHRA PRADESH,KADAPA,INSTITUTIONAL,5.0-7.5,23,THONDUR,0,0,0,0,0,0,0,0,0,0
ANDHRA PRADESH,KADAPA,INSTITUTIONAL,5.0-7.5,24,VEERAPUNAYUNIPALLE,0,0,0,0,0,0,0,0,0,0
ANDHRA PRADESH,KADAPA,INSTITUTIONAL,5.0-7.5,25,YERRAGUNTLA,0,0,0,0,0,0,0,0,0,0
ANDHRA PRADESH,KADAPA,INSTITUTIONAL,5.0-7.5,26,KAMALAPURAM,0,0,0,0,0,0,0,0,0,0
ANDHRA PRADESH,KADAPA,INSTITUTIONAL,5.0-7.5,27,VALLUR,0,0,0,0,0,0,0,0,0,0
ANDHRA PRADESH,KADAPA,INSTITUTIONAL,5.0-7.5,28,CHENNUR,0,0,0,0,0,0,0,0,0,0
ANDHRA PRADESH,KADAPA,INSTITUTIONAL,5.0-7.5,29,ATLUR,0,0,0,0,0,0,0,0,0,0
ANDHRA PRADESH,KADAPA,INSTITUTIONAL,5.0-7.5,30,VONTIMITTA,0,0,0,0,0,0,0,0,0,0
ANDHRA PRADESH,KADAPA,INSTITUTIONAL,5.0-7.5,31,SIDHOUT,0,0,0,0,0,0,0,0,0,0
ANDHRA PRADESH,KADAPA,INSTITUTIONAL,5.0-7.5,32,CUDDAPAH,0,0,0,0,0,0,0,0,0,0
ANDHRA PRADESH,KADAPA,INSTITUTIONAL,5.0-7.5,33,CHINTHAKOMMADINNE,0,0,0,0,0,0,0,0,0,0
ANDHRA PRADESH,KADAPA,INSTITUTIONAL,5.0-7.5,34,PENDLIMARRI,0,0,0,0,0,0,0,0,0,0
ANDHRA PRADESH,KADAPA,INSTITUTIONAL,5.0-7.5,35,VEMPALLE,0,0,0,0,0,0,0,0,0,0
ANDHRA PRADESH,KADAPA,INSTITUTIONAL,5.0-7.5,36,CHAKRAYAPET,0,0,0,0,0,0,0,0,0,0
ANDHRA PRADESH,KADAPA,INSTITUTIONAL,5.0-7.5,37,GALIVEEDU,0,0,0,0,0,0,0,0,0,0
ANDHRA PRADESH,KADAPA,INSTITUTIONAL,5.0-7.5,38,CHINNAMANDEM,0,0,0,0,0,0,0,0,0,0
ANDHRA PRADESH,KADAPA,INSTITUTIONAL,5.0-7.5,39,SAMBEPALLE,0,0,0,0,0,0,0,0,0,0
ANDHRA PRADESH,KADAPA,INSTITUTIONAL,5.0-7.5,40,T SUNDUPALLE,0,0,0,0,0,0,0,0,0,0
ANDHRA PRADESH,KADAPA,INSTITUTIONAL,5.0-7.5,41,RAYACHOTI,0,0,0,0,0,0,0,0,0,0
ANDHRA PRADESH,KADAPA,INSTITUTIONAL,5.0-7.5,42,LAKKIREDDIPALLE,0,0,0,0,0,0,0,0,0,0
ANDHRA PRADESH,KADAPA,INSTITUTIONAL,5.0-7.5,43,RAMAPURAM,0,0,0,0,0,0,0,0,0,0
ANDHRA PRADESH,KADAPA,INSTITUTIONAL,5.0-7.5,44,VEERABALLE,0,0,0,0,0,0,0,0,0,0
ANDHRA PRADESH,KADAPA,INSTITUTIONAL,5.0-7.5,45,NANDALUR,0,0,0,0,0,0,0,0,0,0
ANDHRA PRADESH,KADAPA,INSTITUTIONAL,5.0-7.5,46,PENAGALUR,0,0,0,0,0,0,0,0,0,0
ANDHRA PRADESH,KADAPA,INSTITUTIONAL,5.0-7.5,47,CHITVEL,0,0,0,0,0,0,0,0,0,0
ANDHRA PRADESH,KADAPA,INSTITUTIONAL,5.0-7.5,48,RAJAMPET,0,0,0,0,0,0,0,0,0,0
ANDHRA PRADESH,KADAPA,INSTITUTIONAL,5.0-7.5,49,PULLAMPETA,0,0,0,0,0,0,0,0,0,0
ANDHRA PRADESH,KADAPA,INSTITUTIONAL,5.0-7.5,50,OBULAVARIPALLE,0,0,0,0,0,0,0,0,0,0
ANDHRA PRADESH,KADAPA,INSTITUTIONAL,5.0-7.5,51,KODUR,0,0,0,0,0,0,0,0,0,0
ANDHRA PRADESH,KADAPA,SCHEDULED CASTE,5.0-7.5,1,KONDAPURAM,6,36,18,18,36,0,0,0,0,0
ANDHRA PRADESH,KADAPA,SCHEDULED CASTE,5.0-7.5,2,MYLAVARAM,1,5,3,3,6,0,0,0,0,0
ANDHRA PRADESH,KADAPA,SCHEDULED CASTE,5.0-7.5,3,PEDDAMUDIUM,4,26,26,0,26,0,0,0,0,0
ANDHRA PRADESH,KADAPA,SCHEDULED CASTE,5.0-7.5,4,RAJUPALEM,6,33,17,16,33,0,0,0,0,0
ANDHRA PRADESH,KADAPA,SCHEDULED CASTE,5.0-7.5,5,DUVVUR,1,5,5,0,5,0,0,0,0,0
ANDHRA PRADESH,KADAPA,SCHEDULED CASTE,5.0-7.5,6,S.MYDUKUR,0,0,0,0,0,0,0,0,0,0
ANDHRA PRADESH,KADAPA,SCHEDULED CASTE,5.0-7.5,7,BRAHMAMGARIMATTAM,1,5,3,3,6,0,0,0,0,0
ANDHRA PRADESH,KADAPA,SCHEDULED CASTE,5.0-7.5,8,SRI AVADHUTHA KASINAYANA,1,6,1,5,6,0,0,0,0,0
ANDHRA PRADESH,KADAPA,SCHEDULED CASTE,5.0-7.5,9,KALASAPADU,0,0,0,0,0,0,0,0,0,0
ANDHRA PRADESH,KADAPA,SCHEDULED CASTE,5.0-7.5,10,PORUMAMILLA,2,11,5,5,10,0,0,0,0,0
ANDHRA PRADESH,KADAPA,SCHEDULED CASTE,5.0-7.5,11,B.KODUR,0,0,0,0,0,0,0,0,0,0
ANDHRA PRADESH,KADAPA,SCHEDULED CASTE,5.0-7.5,12,BADVEL,1,5,3,3,6,0,0,0,0,0
ANDHRA PRADESH,KADAPA,SCHEDULED CASTE,5.0-7.5,13,GOPAVARAM,1,5,3,3,6,0,0,0,0,0
ANDHRA PRADESH,KADAPA,SCHEDULED CASTE,5.0-7.5,14,KHAJIPET,1,6,3,3,6,0,0,0,0,0
ANDHRA PRADESH,KADAPA,SCHEDULED CASTE,5.0-7.5,15,CHAPAD,0,0,0,0,0,0,0,0,0,0
ANDHRA PRADESH,KADAPA,SCHEDULED CASTE,5.0-7.5,16,PRODDATUR,0,0,0,0,0,0,0,0,0,0
ANDHRA PRADESH,KADAPA,SCHEDULED CASTE,5.0-7.5,17,JAMMALAMADUGU,0,0,0,0,0,0,0,0,0,0
ANDHRA PRADESH,KADAPA,SCHEDULED CASTE,5.0-7.5,18,MUDDANUR,12,69,27,42,69,0,0,0,0,0
ANDHRA PRADESH,KADAPA,SCHEDULED CASTE,5.0-7.5,19,SIMHADRIPURAM,1,5,3,3,6,0,0,0,0,0
ANDHRA PRADESH,KADAPA,SCHEDULED CASTE,5.0-7.5,20,LINGALA,2,12,12,0,12,0,0,0,0,0
ANDHRA PRADESH,KADAPA,SCHEDULED CASTE,5.0-7.5,21,PULIVENDLA,0,0,0,0,0,0,0,0,0,0
ANDHRA PRADESH,KADAPA,SCHEDULED CASTE,5.0-7.5,22,VEMULA,1,5,3,3,6,0,0,0,0,0
ANDHRA PRADESH,KADAPA,SCHEDULED CASTE,5.0-7.5,23,THONDUR,2,11,0,11,11,0,0,0,0,0
ANDHRA PRADESH,KADAPA,SCHEDULED CASTE,5.0-7.5,24,VEERAPUNAYUNIPALLE,1,7,6,1,7,0,0,0,0,0
ANDHRA PRADESH,KADAPA,SCHEDULED CASTE,5.0-7.5,25,YERRAGUNTLA,1,5,3,3,6,0,0,0,0,0
ANDHRA PRADESH,KADAPA,SCHEDULED CASTE,5.0-7.5,26,KAMALAPURAM,0,0,0,0,0,0,0,0,0,0
ANDHRA PRADESH,KADAPA,SCHEDULED CASTE,5.0-7.5,27,VALLUR,0,0,0,0,0,0,0,0,0,0
ANDHRA PRADESH,KADAPA,SCHEDULED CASTE,5.0-7.5,28,CHENNUR,0,0,0,0,0,0,0,0,0,0
ANDHRA PRADESH,KADAPA,SCHEDULED CASTE,5.0-7.5,29,ATLUR,0,0,0,0,0,0,0,0,0,0
ANDHRA PRADESH,KADAPA,SCHEDULED CASTE,5.0-7.5,30,VONTIMITTA,0,0,0,0,0,0,0,0,0,0
ANDHRA PRADESH,KADAPA,SCHEDULED CASTE,5.0-7.5,31,SIDHOUT,0,0,0,0,0,0,0,0,0,0
ANDHRA PRADESH,KADAPA,SCHEDULED CASTE,5.0-7.5,32,CUDDAPAH,0,0,0,0,0,0,0,0,0,0
ANDHRA PRADESH,KADAPA,SCHEDULED CASTE,5.0-7.5,33,CHINTHAKOMMADINNE,1,7,3,3,6,0,0,0,0,0
ANDHRA PRADESH,KADAPA,SCHEDULED CASTE,5.0-7.5,34,PENDLIMARRI,0,0,0,0,0,0,0,0,0,0
ANDHRA PRADESH,KADAPA,SCHEDULED CASTE,5.0-7.5,35,VEMPALLE,0,0,0,0,0,0,0,0,0,0
ANDHRA PRADESH,KADAPA,SCHEDULED CASTE,5.0-7.5,36,CHAKRAYAPET,0,0,0,0,0,0,0,0,0,0
ANDHRA PRADESH,KADAPA,SCHEDULED CASTE,5.0-7.5,37,GALIVEEDU,2,12,6,6,12,0,0,0,0,0
ANDHRA PRADESH,KADAPA,SCHEDULED CASTE,5.0-7.5,38,CHINNAMANDEM,2,11,6,2,8,0,2,0,2,0
ANDHRA PRADESH,KADAPA,SCHEDULED CASTE,5.0-7.5,39,SAMBEPALLE,2,11,11,0,11,0,0,0,0,0
ANDHRA PRADESH,KADAPA,SCHEDULED CASTE,5.0-7.5,40,T SUNDUPALLE,1,7,4,4,8,0,0,0,0,0
ANDHRA PRADESH,KADAPA,SCHEDULED CASTE,5.0-7.5,41,RAYACHOTI,1,5,2,3,5,0,0,0,0,0
ANDHRA PRADESH,KADAPA,SCHEDULED CASTE,5.0-7.5,42,LAKKIREDDIPALLE,0,0,0,0,0,0,0,0,0,0
ANDHRA PRADESH,KADAPA,SCHEDULED CASTE,5.0-7.5,43,RAMAPURAM,4,24,12,12,24,0,0,0,0,0
ANDHRA PRADESH,KADAPA,SCHEDULED CASTE,5.0-7.5,44,VEERABALLE,1,7,3,3,6,0,0,0,0,0
ANDHRA PRADESH,KADAPA,SCHEDULED CASTE,5.0-7.5,45,NANDALUR,0,0,0,0,0,0,0,0,0,0
ANDHRA PRADESH,KADAPA,SCHEDULED CASTE,5.0-7.5,46,PENAGALUR,0,0,0,0,0,0,0,0,0,0
ANDHRA PRADESH,KADAPA,SCHEDULED CASTE,5.0-7.5,47,CHITVEL,0,0,0,0,0,0,0,0,0,0
ANDHRA PRADESH,KADAPA,SCHEDULED CASTE,5.0-7.5,48,RAJAMPET,0,0,0,0,0,0,0,0,0,0
ANDHRA PRADESH,KADAPA,SCHEDULED CASTE,5.0-7.5,49,PULLAMPETA,1,6,3,3,6,0,0,0,0,0
ANDHRA PRADESH,KADAPA,SCHEDULED CASTE,5.0-7.5,50,OBULAVARIPALLE,0,0,0,0,0,0,0,0,0,0
ANDHRA PRADESH,KADAPA,SCHEDULED CASTE,5.0-7.5,51,KODUR,3,18,18,0,18,0,0,0,0,0
ANDHRA PRADESH,KADAPA,OTHERS,5.0-7.5,1,KONDAPURAM,125,740,642,97,739,0,1,0,1,0
ANDHRA PRADESH,KADAPA,OTHERS,5.0-7.5,2,MYLAVARAM,151,912,880,32,912,0,0,0,0,0
ANDHRA PRADESH,KADAPA,OTHERS,5.0-7.5,3,PEDDAMUDIUM,684,4093,3301,741,4042,0,33,0,33,19
ANDHRA PRADESH,KADAPA,OTHERS,5.0-7.5,4,RAJUPALEM,354,2129,2106,17,2123,0,0,0,0,5
ANDHRA PRADESH,KADAPA,OTHERS,5.0-7.5,5,DUVVUR,39,221,205,0,205,0,10,0,10,6
ANDHRA PRADESH,KADAPA,OTHERS,5.0-7.5,6,S.MYDUKUR,73,417,328,76,404,0,8,0,8,5
ANDHRA PRADESH,KADAPA,OTHERS,5.0-7.5,7,BRAHMAMGARIMATTAM,12,62,31,31,62,0,0,0,0,0
ANDHRA PRADESH,KADAPA,OTHERS,5.0-7.5,8,SRI AVADHUTHA KASINAYANA,65,378,104,274,378,0,0,0,0,0
ANDHRA PRADESH,KADAPA,OTHERS,5.0-7.5,9,KALASAPADU,27,163,102,51,153,0,7,0,7,4
ANDHRA PRADESH,KADAPA,OTHERS,5.0-7.5,10,PORUMAMILLA,28,165,165,0,165,0,0,0,0,0
ANDHRA PRADESH,KADAPA,OTHERS,5.0-7.5,11,B.KODUR,34,197,19,0,19,0,0,0,0,178
ANDHRA PRADESH,KADAPA,OTHERS,5.0-7.5,12,BADVEL,18,107,24,44,68,0,0,0,0,39
ANDHRA PRADESH,KADAPA,OTHERS,5.0-7.5,13,GOPAVARAM,45,275,46,4,50,0,30,36,66,160
ANDHRA PRADESH,KADAPA,OTHERS,5.0-7.5,14,KHAJIPET,51,289,222,67,289,0,0,0,0,0
ANDHRA PRADESH,KADAPA,OTHERS,5.0-7.5,15,CHAPAD,49,285,272,2,274,0,0,0,0,11
ANDHRA PRADESH,KADAPA,OTHERS,5.0-7.5,16,PRODDATUR,175,1044,1029,14,1043,0,0,0,0,0
ANDHRA PRADESH,KADAPA,OTHERS,5.0-7.5,17,JAMMALAMADUGU,133,796,697,69,766,0,19,0,19,11
ANDHRA PRADESH,KADAPA,OTHERS,5.0-7.5,18,MUDDANUR,157,936,668,265,933,0,0,1,1,1
ANDHRA PRADESH,KADAPA,OTHERS,5.0-7.5,19,SIMHADRIPURAM,241,1437,686,617,1303,0,85,0,85,49
ANDHRA PRADESH,KADAPA,OTHERS,5.0-7.5,20,LINGALA,125,715,715,0,715,0,0,0,0,0
ANDHRA PRADESH,KADAPA,OTHERS,5.0-7.5,21,PULIVENDLA,163,933,933,0,933,0,0,0,0,0
ANDHRA PRADESH,KADAPA,OTHERS,5.0-7.5,22,VEMULA,76,443,330,113,443,0,0,0,0,0
ANDHRA PRADESH,KADAPA,OTHERS,5.0-7.5,23,THONDUR,148,861,789,72,861,0,0,0,0,0
ANDHRA PRADESH,KADAPA,OTHERS,5.0-7.5,24,VEERAPUNAYUNIPALLE,141,826,663,163,826,0,0,0,0,0
ANDHRA PRADESH,KADAPA,OTHERS,5.0-7.5,25,YERRAGUNTLA,188,1123,859,265,1124,0,0,0,0,0
ANDHRA PRADESH,KADAPA,OTHERS,5.0-7.5,26,KAMALAPURAM,107,635,374,261,635,0,0,0,0,0
ANDHRA PRADESH,KADAPA,OTHERS,5.0-7.5,27,VALLUR,43,259,161,29,190,0,44,0,44,25
ANDHRA PRADESH,KADAPA,OTHERS,5.0-7.5,28,CHENNUR,29,178,80,65,145,0,20,0,20,12
ANDHRA PRADESH,KADAPA,OTHERS,5.0-7.5,29,ATLUR,10,59,2,57,59,0,0,0,0,0
ANDHRA PRADESH,KADAPA,OTHERS,5.0-7.5,30,VONTIMITTA,11,66,33,33,66,0,0,0,0,0
ANDHRA PRADESH,KADAPA,OTHERS,5.0-7.5,31,SIDHOUT,16,95,63,0,63,0,0,20,20,12
ANDHRA PRADESH,KADAPA,OTHERS,5.0-7.5,32,CUDDAPAH,8,43,43,0,43,0,0,0,0,0
ANDHRA PRADESH,KADAPA,OTHERS,5.0-7.5,33,CHINTHAKOMMADINNE,38,226,226,0,226,0,0,0,0,0
ANDHRA PRADESH,KADAPA,OTHERS,5.0-7.5,34,PENDLIMARRI,73,439,369,71,440,0,0,0,0,0
ANDHRA PRADESH,KADAPA,OTHERS,5.0-7.5,35,VEMPALLE,169,953,953,0,953,0,0,0,0,0
ANDHRA PRADESH,KADAPA,OTHERS,5.0-7.5,36,CHAKRAYAPET,108,646,477,85,562,0,54,0,54,31
ANDHRA PRADESH,KADAPA,OTHERS,5.0-7.5,37,GALIVEEDU,170,997,506,472,978,0,10,0,10,8
ANDHRA PRADESH,KADAPA,OTHERS,5.0-7.5,38,CHINNAMANDEM,90,539,428,31,459,0,50,0,50,30
ANDHRA PRADESH,KADAPA,OTHERS,5.0-7.5,39,SAMBEPALLE,137,828,638,37,675,0,98,0,98,56
ANDHRA PRADESH,KADAPA,OTHERS,5.0-7.5,40,T SUNDUPALLE,79,460,158,158,316,0,92,0,92,52
ANDHRA PRADESH,KADAPA,OTHERS,5.0-7.5,41,RAYACHOTI,111,645,297,247,544,0,64,0,64,37
ANDHRA PRADESH,KADAPA,OTHERS,5.0-7.5,42,LAKKIREDDIPALLE,119,704,634,62,696,0,0,0,0,8
ANDHRA PRADESH,KADAPA,OTHERS,5.0-7.5,43,RAMAPURAM,145,857,722,119,841,0,10,0,10,6
ANDHRA PRADESH,KADAPA,OTHERS,5.0-7.5,44,VEERABALLE,51,305,213,92,305,0,0,0,0,1
ANDHRA PRADESH,KADAPA,OTHERS,5.0-7.5,45,NANDALUR,11,67,16,37,53,0,9,1,10,5
ANDHRA PRADESH,KADAPA,OTHERS,5.0-7.5,46,PENAGALUR,10,61,21,16,37,1,14,1,16,8
ANDHRA PRADESH,KADAPA,OTHERS,5.0-7.5,47,CHITVEL,29,170,0,170,170,0,0,0,0,0
ANDHRA PRADESH,KADAPA,OTHERS,5.0-7.5,48,RAJAMPET,60,352,58,144,202,63,4,46,113,37
ANDHRA PRADESH,KADAPA,OTHERS,5.0-7.5,49,PULLAMPETA,50,307,91,66,157,0,96,0,96,55
ANDHRA PRADESH,KADAPA,OTHERS,5.0-7.5,50,OBULAVARIPALLE,56,329,81,50,131,0,126,0,126,72
ANDHRA PRADESH,KADAPA,OTHERS,5.0-7.5,51,KODUR,70,413,305,108,413,0,0,0,0,0
ANDHRA PRADESH,KADAPA,SCHEDULED TRIBES,5.0-7.5,1,KONDAPURAM,0,0,0,0,0,0,0,0,0,0
ANDHRA PRADESH,KADAPA,SCHEDULED TRIBES,5.0-7.5,2,MYLAVARAM,3,17,17,0,17,0,0,0,0,0
ANDHRA PRADESH,KADAPA,SCHEDULED TRIBES,5.0-7.5,3,PEDDAMUDIUM,3,17,17,0,17,0,0,0,0,0
ANDHRA PRADESH,KADAPA,SCHEDULED TRIBES,5.0-7.5,4,RAJUPALEM,0,0,0,0,0,0,0,0,0,0
ANDHRA PRADESH,KADAPA,SCHEDULED TRIBES,5.0-7.5,5,DUVVUR,0,0,0,0,0,0,0,0,0,0
ANDHRA PRADESH,KADAPA,SCHEDULED TRIBES,5.0-7.5,6,S.MYDUKUR,1,5,3,3,6,0,0,0,0,0
ANDHRA PRADESH,KADAPA,SCHEDULED TRIBES,5.0-7.5,7,BRAHMAMGARIMATTAM,0,0,0,0,0,0,0,0,0,0
ANDHRA PRADESH,KADAPA,SCHEDULED TRIBES,5.0-7.5,8,SRI AVADHUTHA KASINAYANA,0,0,0,0,0,0,0,0,0,0
ANDHRA PRADESH,KADAPA,SCHEDULED TRIBES,5.0-7.5,9,KALASAPADU,0,0,0,0,0,0,0,0,0,0
ANDHRA PRADESH,KADAPA,SCHEDULED TRIBES,5.0-7.5,10,PORUMAMILLA,1,5,3,3,6,0,0,0,0,0
ANDHRA PRADESH,KADAPA,SCHEDULED TRIBES,5.0-7.5,11,B.KODUR,1,6,3,3,6,0,0,0,0,0
ANDHRA PRADESH,KADAPA,SCHEDULED TRIBES,5.0-7.5,12,BADVEL,0,0,0,0,0,0,0,0,0,0
ANDHRA PRADESH,KADAPA,SCHEDULED TRIBES,5.0-7.5,13,GOPAVARAM,0,0,0,0,0,0,0,0,0,0
ANDHRA PRADESH,KADAPA,SCHEDULED TRIBES,5.0-7.5,14,KHAJIPET,0,0,0,0,0,0,0,0,0,0
ANDHRA PRADESH,KADAPA,SCHEDULED TRIBES,5.0-7.5,15,CHAPAD,0,0,0,0,0,0,0,0,0,0
ANDHRA PRADESH,KADAPA,SCHEDULED TRIBES,5.0-7.5,16,PRODDATUR,0,0,0,0,0,0,0,0,0,0
ANDHRA PRADESH,KADAPA,SCHEDULED TRIBES,5.0-7.5,17,JAMMALAMADUGU,0,0,0,0,0,0,0,0,0,0
ANDHRA PRADESH,KADAPA,SCHEDULED TRIBES,5.0-7.5,18,MUDDANUR,2,12,6,6,12,0,0,0,0,0
ANDHRA PRADESH,KADAPA,SCHEDULED TRIBES,5.0-7.5,19,SIMHADRIPURAM,0,0,0,0,0,0,0,0,0,0
ANDHRA PRADESH,KADAPA,SCHEDULED TRIBES,5.0-7.5,20,LINGALA,0,0,0,0,0,0,0,0,0,0
ANDHRA PRADESH,KADAPA,SCHEDULED TRIBES,5.0-7.5,21,PULIVENDLA,1,5,3,3,6,0,0,0,0,0
ANDHRA PRADESH,KADAPA,SCHEDULED TRIBES,5.0-7.5,22,VEMULA,0,0,0,0,0,0,0,0,0,0
ANDHRA PRADESH,KADAPA,SCHEDULED TRIBES,5.0-7.5,23,THONDUR,0,0,0,0,0,0,0,0,0,0
ANDHRA PRADESH,KADAPA,SCHEDULED TRIBES,5.0-7.5,24,VEERAPUNAYUNIPALLE,0,0,0,0,0,0,0,0,0,0
ANDHRA PRADESH,KADAPA,SCHEDULED TRIBES,5.0-7.5,25,YERRAGUNTLA,0,0,0,0,0,0,0,0,0,0
ANDHRA PRADESH,KADAPA,SCHEDULED TRIBES,5.0-7.5,26,KAMALAPURAM,0,0,0,0,0,0,0,0,0,0
ANDHRA PRADESH,KADAPA,SCHEDULED TRIBES,5.0-7.5,27,VALLUR,0,0,0,0,0,0,0,0,0,0
ANDHRA PRADESH,KADAPA,SCHEDULED TRIBES,5.0-7.5,28,CHENNUR,0,0,0,0,0,0,0,0,0,0
ANDHRA PRADESH,KADAPA,SCHEDULED TRIBES,5.0-7.5,29,ATLUR,0,0,0,0,0,0,0,0,0,0
ANDHRA PRADESH,KADAPA,SCHEDULED TRIBES,5.0-7.5,30,VONTIMITTA,0,0,0,0,0,0,0,0,0,0
ANDHRA PRADESH,KADAPA,SCHEDULED TRIBES,5.0-7.5,31,SIDHOUT,0,0,0,0,0,0,0,0,0,0
ANDHRA PRADESH,KADAPA,SCHEDULED TRIBES,5.0-7.5,32,CUDDAPAH,0,0,0,0,0,0,0,0,0,0
ANDHRA PRADESH,KADAPA,SCHEDULED TRIBES,5.0-7.5,33,CHINTHAKOMMADINNE,0,0,0,0,0,0,0,0,0,0
ANDHRA PRADESH,KADAPA,SCHEDULED TRIBES,5.0-7.5,34,PENDLIMARRI,0,0,0,0,0,0,0,0,0,0
ANDHRA PRADESH,KADAPA,SCHEDULED TRIBES,5.0-7.5,35,VEMPALLE,0,0,0,0,0,0,0,0,0,0
ANDHRA PRADESH,KADAPA,SCHEDULED TRIBES,5.0-7.5,36,CHAKRAYAPET,1,7,4,4,8,0,0,0,0,0
ANDHRA PRADESH,KADAPA,SCHEDULED TRIBES,5.0-7.5,37,GALIVEEDU,2,11,6,6,12,0,0,0,0,0
ANDHRA PRADESH,KADAPA,SCHEDULED TRIBES,5.0-7.5,38,CHINNAMANDEM,1,7,7,0,7,0,0,0,0,0
ANDHRA PRADESH,KADAPA,SCHEDULED TRIBES,5.0-7.5,39,SAMBEPALLE,1,6,3,3,6,0,0,0,0,0
ANDHRA PRADESH,KADAPA,SCHEDULED TRIBES,5.0-7.5,40,T SUNDUPALLE,1,6,3,3,6,0,0,0,0,0
ANDHRA PRADESH,KADAPA,SCHEDULED TRIBES,5.0-7.5,41,RAYACHOTI,0,0,0,0,0,0,0,0,0,0
ANDHRA PRADESH,KADAPA,SCHEDULED TRIBES,5.0-7.5,42,LAKKIREDDIPALLE,0,0,0,0,0,0,0,0,0,0
ANDHRA PRADESH,KADAPA,SCHEDULED TRIBES,5.0-7.5,43,RAMAPURAM,2,11,5,5,10,0,0,0,0,0
ANDHRA PRADESH,KADAPA,SCHEDULED TRIBES,5.0-7.5,44,VEERABALLE,0,0,0,0,0,0,0,0,0,0
ANDHRA PRADESH,KADAPA,SCHEDULED TRIBES,5.0-7.5,45,NANDALUR,0,0,0,0,0,0,0,0,0,0
ANDHRA PRADESH,KADAPA,SCHEDULED TRIBES,5.0-7.5,46,PENAGALUR,0,0,0,0,0,0,0,0,0,0
ANDHRA PRADESH,KADAPA,SCHEDULED TRIBES,5.0-7.5,47,CHITVEL,0,0,0,0,0,0,0,0,0,0
ANDHRA PRADESH,KADAPA,SCHEDULED TRIBES,5.0-7.5,48,RAJAMPET,0,0,0,0,0,0,0,0,0,0
ANDHRA PRADESH,KADAPA,SCHEDULED TRIBES,5.0-7.5,49,PULLAMPETA,1,6,3,3,6,0,0,0,0,0
ANDHRA PRADESH,KADAPA,SCHEDULED TRIBES,5.0-7.5,50,OBULAVARIPALLE,0,0,0,0,0,0,0,0,0,0
ANDHRA PRADESH,KADAPA,SCHEDULED TRIBES,5.0-7.5,51,KODUR,1,5,0,5,5,0,0,0,0,0
ANDHRA PRADESH,KADAPA,ALL SOCIAL GROUPS,5.0-7.5,1,KONDAPURAM,131,776,660,115,775,0,1,0,1,0
ANDHRA PRADESH,KADAPA,ALL SOCIAL GROUPS,5.0-7.5,2,MYLAVARAM,155,934,900,35,935,0,0,0,0,0
ANDHRA PRADESH,KADAPA,ALL SOCIAL GROUPS,5.0-7.5,3,PEDDAMUDIUM,691,4136,3344,741,4085,0,33,0,33,19
ANDHRA PRADESH,KADAPA,ALL SOCIAL GROUPS,5.0-7.5,4,RAJUPALEM,360,2162,2123,34,2157,0,0,0,0,5
ANDHRA PRADESH,KADAPA,ALL SOCIAL GROUPS,5.0-7.5,5,DUVVUR,40,226,210,0,210,0,10,0,10,6
ANDHRA PRADESH,KADAPA,ALL SOCIAL GROUPS,5.0-7.5,6,S.MYDUKUR,74,422,330,79,409,0,8,0,8,5
ANDHRA PRADESH,KADAPA,ALL SOCIAL GROUPS,5.0-7.5,7,BRAHMAMGARIMATTAM,13,67,33,34,67,0,0,0,0,0
ANDHRA PRADESH,KADAPA,ALL SOCIAL GROUPS,5.0-7.5,8,SRI AVADHUTHA KASINAYANA,66,384,105,279,384,0,0,0,0,0
ANDHRA PRADESH,KADAPA,ALL SOCIAL GROUPS,5.0-7.5,9,KALASAPADU,27,163,102,51,153,0,7,0,7,4
ANDHRA PRADESH,KADAPA,ALL SOCIAL GROUPS,5.0-7.5,10,PORUMAMILLA,31,181,173,8,181,0,0,0,0,0
ANDHRA PRADESH,KADAPA,ALL SOCIAL GROUPS,5.0-7.5,11,B.KODUR,35,203,22,3,25,0,0,0,0,178
ANDHRA PRADESH,KADAPA,ALL SOCIAL GROUPS,5.0-7.5,12,BADVEL,19,112,26,47,73,0,0,0,0,39
ANDHRA PRADESH,KADAPA,ALL SOCIAL GROUPS,5.0-7.5,13,GOPAVARAM,46,281,49,6,55,0,30,36,66,160
ANDHRA PRADESH,KADAPA,ALL SOCIAL GROUPS,5.0-7.5,14,KHAJIPET,52,295,225,70,295,0,0,0,0,0
ANDHRA PRADESH,KADAPA,ALL SOCIAL GROUPS,5.0-7.5,15,CHAPAD,49,285,272,2,274,0,0,0,0,11
ANDHRA PRADESH,KADAPA,ALL SOCIAL GROUPS,5.0-7.5,16,PRODDATUR,175,1044,1029,14,1043,0,0,0,0,0
ANDHRA PRADESH,KADAPA,ALL SOCIAL GROUPS,5.0-7.5,17,JAMMALAMADUGU,133,796,697,69,766,0,19,0,19,11
ANDHRA PRADESH,KADAPA,ALL SOCIAL GROUPS,5.0-7.5,18,MUDDANUR,171,1018,701,313,1014,0,0,1,1,1
ANDHRA PRADESH,KADAPA,ALL SOCIAL GROUPS,5.0-7.5,19,SIMHADRIPURAM,242,1442,689,620,1309,0,85,0,85,49
ANDHRA PRADESH,KADAPA,ALL SOCIAL GROUPS,5.0-7.5,20,LINGALA,127,727,727,0,727,0,0,0,0,0
ANDHRA PRADESH,KADAPA,ALL SOCIAL GROUPS,5.0-7.5,21,PULIVENDLA,164,939,936,3,939,0,0,0,0,0
ANDHRA PRADESH,KADAPA,ALL SOCIAL GROUPS,5.0-7.5,22,VEMULA,77,448,333,115,448,0,0,0,0,0
ANDHRA PRADESH,KADAPA,ALL SOCIAL GROUPS,5.0-7.5,23,THONDUR,150,872,789,83,872,0,0,0,0,0
ANDHRA PRADESH,KADAPA,ALL SOCIAL GROUPS,5.0-7.5,24,VEERAPUNAYUNIPALLE,142,833,669,164,833,0,0,0,0,0
ANDHRA PRADESH,KADAPA,ALL SOCIAL GROUPS,5.0-7.5,25,YERRAGUNTLA,189,1129,861,268,1129,0,0,0,0,0
ANDHRA PRADESH,KADAPA,ALL SOCIAL GROUPS,5.0-7.5,26,KAMALAPURAM,107,635,374,261,635,0,0,0,0,0
ANDHRA PRADESH,KADAPA,ALL SOCIAL GROUPS,5.0-7.5,27,VALLUR,43,259,161,29,190,0,44,0,44,25
ANDHRA PRADESH,KADAPA,ALL SOCIAL GROUPS,5.0-7.5,28,CHENNUR,29,178,80,65,145,0,20,0,20,12
ANDHRA PRADESH,KADAPA,ALL SOCIAL GROUPS,5.0-7.5,29,ATLUR,10,59,2,57,59,0,0,0,0,0
ANDHRA PRADESH,KADAPA,ALL SOCIAL GROUPS,5.0-7.5,30,VONTIMITTA,11,66,33,33,66,0,0,0,0,0
ANDHRA PRADESH,KADAPA,ALL SOCIAL GROUPS,5.0-7.5,31,SIDHOUT,16,95,63,0,63,0,0,20,20,12
ANDHRA PRADESH,KADAPA,ALL SOCIAL GROUPS,5.0-7.5,32,CUDDAPAH,8,43,43,0,43,0,0,0,0,0
ANDHRA PRADESH,KADAPA,ALL SOCIAL GROUPS,5.0-7.5,33,CHINTHAKOMMADINNE,39,233,230,3,233,0,0,0,0,0
ANDHRA PRADESH,KADAPA,ALL SOCIAL GROUPS,5.0-7.5,34,PENDLIMARRI,73,439,369,71,440,0,0,0,0,0
ANDHRA PRADESH,KADAPA,ALL SOCIAL GROUPS,5.0-7.5,35,VEMPALLE,169,953,953,0,953,0,0,0,0,0
ANDHRA PRADESH,KADAPA,ALL SOCIAL GROUPS,5.0-7.5,36,CHAKRAYAPET,109,653,481,88,569,0,54,0,54,31
ANDHRA PRADESH,KADAPA,ALL SOCIAL GROUPS,5.0-7.5,37,GALIVEEDU,174,1019,517,483,1000,0,10,0,10,8
ANDHRA PRADESH,KADAPA,ALL SOCIAL GROUPS,5.0-7.5,38,CHINNAMANDEM,93,557,442,33,475,0,52,0,52,30
ANDHRA PRADESH,KADAPA,ALL SOCIAL GROUPS,5.0-7.5,39,SAMBEPALLE,140,846,652,40,692,0,98,0,98,56
ANDHRA PRADESH,KADAPA,ALL SOCIAL GROUPS,5.0-7.5,40,T SUNDUPALLE,81,473,165,165,330,0,92,0,92,52
ANDHRA PRADESH,KADAPA,ALL SOCIAL GROUPS,5.0-7.5,41,RAYACHOTI,112,650,299,251,550,0,64,0,64,37
ANDHRA PRADESH,KADAPA,ALL SOCIAL GROUPS,5.0-7.5,42,LAKKIREDDIPALLE,119,704,634,62,696,0,0,0,0,8
ANDHRA PRADESH,KADAPA,ALL SOCIAL GROUPS,5.0-7.5,43,RAMAPURAM,151,892,740,136,876,0,10,0,10,6
ANDHRA PRADESH,KADAPA,ALL SOCIAL GROUPS,5.0-7.5,44,VEERABALLE,52,312,216,95,311,0,0,0,0,1
ANDHRA PRADESH,KADAPA,ALL SOCIAL GROUPS,5.0-7.5,45,NANDALUR,11,67,16,37,53,0,9,1,10,5
ANDHRA PRADESH,KADAPA,ALL SOCIAL GROUPS,5.0-7.5,46,PENAGALUR,10,61,21,16,37,1,14,1,16,8
ANDHRA PRADESH,KADAPA,ALL SOCIAL GROUPS,5.0-7.5,47,CHITVEL,29,170,0,170,170,0,0,0,0,0
ANDHRA PRADESH,KADAPA,ALL SOCIAL GROUPS,5.0-7.5,48,RAJAMPET,60,352,58,144,202,63,4,46,113,37
ANDHRA PRADESH,KADAPA,ALL SOCIAL GROUPS,5.0-7.5,49,PULLAMPETA,52,318,96,71,167,0,96,0,96,55
ANDHRA PRADESH,KADAPA,ALL SOCIAL GROUPS,5.0-7.5,50,OBULAVARIPALLE,56,329,81,50,131,0,126,0,126,72
ANDHRA PRADESH,KADAPA,ALL SOCIAL GROUPS,5.0-7.5,51,KODUR,74,436,323,113,436,0,0,0,0,0
ANDHRA PRADESH,KADAPA,INSTITUTIONAL,4.0-5.0,1,KONDAPURAM,0,0,0,0,0,0,0,0,0,0
ANDHRA PRADESH,KADAPA,INSTITUTIONAL,4.0-5.0,2,MYLAVARAM,0,0,0,0,0,0,0,0,0,0
ANDHRA PRADESH,KADAPA,INSTITUTIONAL,4.0-5.0,3,PEDDAMUDIUM,0,0,0,0,0,0,0,0,0,0
ANDHRA PRADESH,KADAPA,INSTITUTIONAL,4.0-5.0,4,RAJUPALEM,0,0,0,0,0,0,0,0,0,0
ANDHRA PRADESH,KADAPA,INSTITUTIONAL,4.0-5.0,5,DUVVUR,0,0,0,0,0,0,0,0,0,0
ANDHRA PRADESH,KADAPA,INSTITUTIONAL,4.0-5.0,6,S.MYDUKUR,0,0,0,0,0,0,0,0,0,0
ANDHRA PRADESH,KADAPA,INSTITUTIONAL,4.0-5.0,7,BRAHMAMGARIMATTAM,1,4,2,2,4,0,0,0,0,0
ANDHRA PRADESH,KADAPA,INSTITUTIONAL,4.0-5.0,8,SRI AVADHUTHA KASINAYANA,0,0,0,0,0,0,0,0,0,0
ANDHRA PRADESH,KADAPA,INSTITUTIONAL,4.0-5.0,9,KALASAPADU,0,0,0,0,0,0,0,0,0,0
ANDHRA PRADESH,KADAPA,INSTITUTIONAL,4.0-5.0,10,PORUMAMILLA,0,0,0,0,0,0,0,0,0,0
ANDHRA PRADESH,KADAPA,INSTITUTIONAL,4.0-5.0,11,B.KODUR,0,0,0,0,0,0,0,0,0,0
ANDHRA PRADESH,KADAPA,INSTITUTIONAL,4.0-5.0,12,BADVEL,0,0,0,0,0,0,0,0,0,0
ANDHRA PRADESH,KADAPA,INSTITUTIONAL,4.0-5.0,13,GOPAVARAM,0,0,0,0,0,0,0,0,0,0
ANDHRA PRADESH,KADAPA,INSTITUTIONAL,4.0-5.0,14,KHAJIPET,0,0,0,0,0,0,0,0,0,0
ANDHRA PRADESH,KADAPA,INSTITUTIONAL,4.0-5.0,15,CHAPAD,0,0,0,0,0,0,0,0,0,0
ANDHRA PRADESH,KADAPA,INSTITUTIONAL,4.0-5.0,16,PRODDATUR,0,0,0,0,0,0,0,0,0,0
ANDHRA PRADESH,KADAPA,INSTITUTIONAL,4.0-5.0,17,JAMMALAMADUGU,0,0,0,0,0,0,0,0,0,0
ANDHRA PRADESH,KADAPA,INSTITUTIONAL,4.0-5.0,18,MUDDANUR,0,0,0,0,0,0,0,0,0,0
ANDHRA PRADESH,KADAPA,INSTITUTIONAL,4.0-5.0,19,SIMHADRIPURAM,0,0,0,0,0,0,0,0,0,0
ANDHRA PRADESH,KADAPA,INSTITUTIONAL,4.0-5.0,20,LINGALA,0,0,0,0,0,0,0,0,0,0
ANDHRA PRADESH,KADAPA,INSTITUTIONAL,4.0-5.0,21,PULIVENDLA,0,0,0,0,0,0,0,0,0,0
ANDHRA PRADESH,KADAPA,INSTITUTIONAL,4.0-5.0,22,VEMULA,0,0,0,0,0,0,0,0,0,0
ANDHRA PRADESH,KADAPA,INSTITUTIONAL,4.0-5.0,23,THONDUR,0,0,0,0,0,0,0,0,0,0
ANDHRA PRADESH,KADAPA,INSTITUTIONAL,4.0-5.0,24,VEERAPUNAYUNIPALLE,0,0,0,0,0,0,0,0,0,0
ANDHRA PRADESH,KADAPA,INSTITUTIONAL,4.0-5.0,25,YERRAGUNTLA,0,0,0,0,0,0,0,0,0,0
ANDHRA PRADESH,KADAPA,INSTITUTIONAL,4.0-5.0,26,KAMALAPURAM,0,0,0,0,0,0,0,0,0,0
ANDHRA PRADESH,KADAPA,INSTITUTIONAL,4.0-5.0,27,VALLUR,0,0,0,0,0,0,0,0,0,0
ANDHRA PRADESH,KADAPA,INSTITUTIONAL,4.0-5.0,28,CHENNUR,0,0,0,0,0,0,0,0,0,0
ANDHRA PRADESH,KADAPA,INSTITUTIONAL,4.0-5.0,29,ATLUR,0,0,0,0,0,0,0,0,0,0
ANDHRA PRADESH,KADAPA,INSTITUTIONAL,4.0-5.0,30,VONTIMITTA,0,0,0,0,0,0,0,0,0,0
ANDHRA PRADESH,KADAPA,INSTITUTIONAL,4.0-5.0,31,SIDHOUT,0,0,0,0,0,0,0,0,0,0
ANDHRA PRADESH,KADAPA,INSTITUTIONAL,4.0-5.0,32,CUDDAPAH,0,0,0,0,0,0,0,0,0,0
ANDHRA PRADESH,KADAPA,INSTITUTIONAL,4.0-5.0,33,CHINTHAKOMMADINNE,0,0,0,0,0,0,0,0,0,0
ANDHRA PRADESH,KADAPA,INSTITUTIONAL,4.0-5.0,34,PENDLIMARRI,0,0,0,0,0,0,0,0,0,0
ANDHRA PRADESH,KADAPA,INSTITUTIONAL,4.0-5.0,35,VEMPALLE,0,0,0,0,0,0,0,0,0,0
ANDHRA PRADESH,KADAPA,INSTITUTIONAL,4.0-5.0,36,CHAKRAYAPET,0,0,0,0,0,0,0,0,0,0
ANDHRA PRADESH,KADAPA,INSTITUTIONAL,4.0-5.0,37,GALIVEEDU,0,0,0,0,0,0,0,0,0,0
ANDHRA PRADESH,KADAPA,INSTITUTIONAL,4.0-5.0,38,CHINNAMANDEM,0,0,0,0,0,0,0,0,0,0
ANDHRA PRADESH,KADAPA,INSTITUTIONAL,4.0-5.0,39,SAMBEPALLE,0,0,0,0,0,0,0,0,0,0
ANDHRA PRADESH,KADAPA,INSTITUTIONAL,4.0-5.0,40,T SUNDUPALLE,0,0,0,0,0,0,0,0,0,0
ANDHRA PRADESH,KADAPA,INSTITUTIONAL,4.0-5.0,41,RAYACHOTI,0,0,0,0,0,0,0,0,0,0
ANDHRA PRADESH,KADAPA,INSTITUTIONAL,4.0-5.0,42,LAKKIREDDIPALLE,0,0,0,0,0,0,0,0,0,0
ANDHRA PRADESH,KADAPA,INSTITUTIONAL,4.0-5.0,43,RAMAPURAM,0,0,0,0,0,0,0,0,0,0
ANDHRA PRADESH,KADAPA,INSTITUTIONAL,4.0-5.0,44,VEERABALLE,0,0,0,0,0,0,0,0,0,0
ANDHRA PRADESH,KADAPA,INSTITUTIONAL,4.0-5.0,45,NANDALUR,0,0,0,0,0,0,0,0,0,0
ANDHRA PRADESH,KADAPA,INSTITUTIONAL,4.0-5.0,46,PENAGALUR,0,0,0,0,0,0,0,0,0,0
ANDHRA PRADESH,KADAPA,INSTITUTIONAL,4.0-5.0,47,CHITVEL,0,0,0,0,0,0,0,0,0,0
ANDHRA PRADESH,KADAPA,INSTITUTIONAL,4.0-5.0,48,RAJAMPET,0,0,0,0,0,0,0,0,0,0
ANDHRA PRADESH,KADAPA,INSTITUTIONAL,4.0-5.0,49,PULLAMPETA,0,0,0,0,0,0,0,0,0,0
ANDHRA PRADESH,KADAPA,INSTITUTIONAL,4.0-5.0,50,OBULAVARIPALLE,0,0,0,0,0,0,0,0,0,0
ANDHRA PRADESH,KADAPA,INSTITUTIONAL,4.0-5.0,51,KODUR,0,0,0,0,0,0,0,0,0,0
ANDHRA PRADESH,KADAPA,SCHEDULED CASTE,4.0-5.0,1,KONDAPURAM,4,19,9,9,18,0,0,0,0,0
ANDHRA PRADESH,KADAPA,SCHEDULED CASTE,4.0-5.0,2,MYLAVARAM,3,12,12,0,12,0,0,0,0,0
ANDHRA PRADESH,KADAPA,SCHEDULED CASTE,4.0-5.0,3,PEDDAMUDIUM,11,49,37,0,37,0,11,0,11,0
ANDHRA PRADESH,KADAPA,SCHEDULED CASTE,4.0-5.0,4,RAJUPALEM,5,22,11,11,22,0,0,0,0,0
ANDHRA PRADESH,KADAPA,SCHEDULED CASTE,4.0-5.0,5,DUVVUR,2,8,4,4,8,0,0,0,0,0
ANDHRA PRADESH,KADAPA,SCHEDULED CASTE,4.0-5.0,6,S.MYDUKUR,0,0,0,0,0,0,0,0,0,0
ANDHRA PRADESH,KADAPA,SCHEDULED CASTE,4.0-5.0,7,BRAHMAMGARIMATTAM,0,0,0,0,0,0,0,0,0,0
ANDHRA PRADESH,KADAPA,SCHEDULED CASTE,4.0-5.0,8,SRI AVADHUTHA KASINAYANA,1,4,2,2,4,0,0,0,0,0
ANDHRA PRADESH,KADAPA,SCHEDULED CASTE,4.0-5.0,9,KALASAPADU,0,0,0,0,0,0,0,0,0,0
ANDHRA PRADESH,KADAPA,SCHEDULED CASTE,4.0-5.0,10,PORUMAMILLA,3,13,6,6,12,0,0,0,0,0
ANDHRA PRADESH,KADAPA,SCHEDULED CASTE,4.0-5.0,11,B.KODUR,0,0,0,0,0,0,0,0,0,0
ANDHRA PRADESH,KADAPA,SCHEDULED CASTE,4.0-5.0,12,BADVEL,0,0,0,0,0,0,0,0,0,0
ANDHRA PRADESH,KADAPA,SCHEDULED CASTE,4.0-5.0,13,GOPAVARAM,0,0,0,0,0,0,0,0,0,0
ANDHRA PRADESH,KADAPA,SCHEDULED CASTE,4.0-5.0,14,KHAJIPET,1,4,2,2,4,0,0,0,0,0
ANDHRA PRADESH,KADAPA,SCHEDULED CASTE,4.0-5.0,15,CHAPAD,0,0,0,0,0,0,0,0,0,0
ANDHRA PRADESH,KADAPA,SCHEDULED CASTE,4.0-5.0,16,PRODDATUR,1,4,2,2,4,0,0,0,0,0
ANDHRA PRADESH,KADAPA,SCHEDULED CASTE,4.0-5.0,17,JAMMALAMADUGU,1,4,2,2,4,0,0,0,0,0
ANDHRA PRADESH,KADAPA,SCHEDULED CASTE,4.0-5.0,18,MUDDANUR,9,41,17,22,39,0,2,0,2,0
ANDHRA PRADESH,KADAPA,SCHEDULED CASTE,4.0-5.0,19,SIMHADRIPURAM,1,5,2,2,4,0,0,0,0,0
ANDHRA PRADESH,KADAPA,SCHEDULED CASTE,4.0-5.0,20,LINGALA,3,13,13,0,13,0,0,0,0,0
ANDHRA PRADESH,KADAPA,SCHEDULED CASTE,4.0-5.0,21,PULIVENDLA,1,5,2,2,4,0,0,0,0,0
ANDHRA PRADESH,KADAPA,SCHEDULED CASTE,4.0-5.0,22,VEMULA,1,5,2,2,4,0,0,0,0,0
ANDHRA PRADESH,KADAPA,SCHEDULED CASTE,4.0-5.0,23,THONDUR,2,10,5,5,10,0,0,0,0,0
ANDHRA PRADESH,KADAPA,SCHEDULED CASTE,4.0-5.0,24,VEERAPUNAYUNIPALLE,0,0,0,0,0,0,0,0,0,0
ANDHRA PRADESH,KADAPA,SCHEDULED CASTE,4.0-5.0,25,YERRAGUNTLA,0,0,0,0,0,0,0,0,0,0
ANDHRA PRADESH,KADAPA,SCHEDULED CASTE,4.0-5.0,26,KAMALAPURAM,1,4,2,2,4,0,0,0,0,0
ANDHRA PRADESH,KADAPA,SCHEDULED CASTE,4.0-5.0,27,VALLUR,1,5,2,2,4,0,0,0,0,0
ANDHRA PRADESH,KADAPA,SCHEDULED CASTE,4.0-5.0,28,CHENNUR,0,0,0,0,0,0,0,0,0,0
ANDHRA PRADESH,KADAPA,SCHEDULED CASTE,4.0-5.0,29,ATLUR,0,0,0,0,0,0,0,0,0,0
ANDHRA PRADESH,KADAPA,SCHEDULED CASTE,4.0-5.0,30,VONTIMITTA,0,0,0,0,0,0,0,0,0,0
ANDHRA PRADESH,KADAPA,SCHEDULED CASTE,4.0-5.0,31,SIDHOUT,0,0,0,0,0,0,0,0,0,0
ANDHRA PRADESH,KADAPA,SCHEDULED CASTE,4.0-5.0,32,CUDDAPAH,1,4,2,2,4,0,0,0,0,0
ANDHRA PRADESH,KADAPA,SCHEDULED CASTE,4.0-5.0,33,CHINTHAKOMMADINNE,1,4,4,0,4,0,0,0,0,0
ANDHRA PRADESH,KADAPA,SCHEDULED CASTE,4.0-5.0,34,PENDLIMARRI,0,0,0,0,0,0,0,0,0,0
ANDHRA PRADESH,KADAPA,SCHEDULED CASTE,4.0-5.0,35,VEMPALLE,0,0,0,0,0,0,0,0,0,0
ANDHRA PRADESH,KADAPA,SCHEDULED CASTE,4.0-5.0,36,CHAKRAYAPET,0,0,0,0,0,0,0,0,0,0
ANDHRA PRADESH,KADAPA,SCHEDULED CASTE,4.0-5.0,37,GALIVEEDU,0,0,0,0,0,0,0,0,0,0
ANDHRA PRADESH,KADAPA,SCHEDULED CASTE,4.0-5.0,38,CHINNAMANDEM,1,4,2,2,4,0,0,0,0,0
ANDHRA PRADESH,KADAPA,SCHEDULED CASTE,4.0-5.0,39,SAMBEPALLE,5,22,11,11,22,0,0,0,0,0
ANDHRA PRADESH,KADAPA,SCHEDULED CASTE,4.0-5.0,40,T SUNDUPALLE,2,9,4,3,7,0,1,0,1,0
ANDHRA PRADESH,KADAPA,SCHEDULED CASTE,4.0-5.0,41,RAYACHOTI,2,9,5,0,5,0,4,0,4,0
ANDHRA PRADESH,KADAPA,SCHEDULED CASTE,4.0-5.0,42,LAKKIREDDIPALLE,2,8,4,4,8,0,0,0,0,0
ANDHRA PRADESH,KADAPA,SCHEDULED CASTE,4.0-5.0,43,RAMAPURAM,5,23,21,2,23,0,0,0,0,0
ANDHRA PRADESH,KADAPA,SCHEDULED CASTE,4.0-5.0,44,VEERABALLE,0,0,0,0,0,0,0,0,0,0
ANDHRA PRADESH,KADAPA,SCHEDULED CASTE,4.0-5.0,45,NANDALUR,0,0,0,0,0,0,0,0,0,0
ANDHRA PRADESH,KADAPA,SCHEDULED CASTE,4.0-5.0,46,PENAGALUR,0,0,0,0,0,0,0,0,0,0
ANDHRA PRADESH,KADAPA,SCHEDULED CASTE,4.0-5.0,47,CHITVEL,0,0,0,0,0,0,0,0,0,0
ANDHRA PRADESH,KADAPA,SCHEDULED CASTE,4.0-5.0,48,RAJAMPET,1,4,2,2,4,0,0,0,0,0
ANDHRA PRADESH,KADAPA,SCHEDULED CASTE,4.0-5.0,49,PULLAMPETA,0,0,0,0,0,0,0,0,0,0
ANDHRA PRADESH,KADAPA,SCHEDULED CASTE,4.0-5.0,50,OBULAVARIPALLE,0,0,0,0,0,0,0,0,0,0
ANDHRA PRADESH,KADAPA,SCHEDULED CASTE,4.0-5.0,51,KODUR,3,14,0,14,14,0,0,0,0,0
ANDHRA PRADESH,KADAPA,OTHERS,4.0-5.0,1,KONDAPURAM,153,675,607,67,674,0,1,0,1,0
ANDHRA PRADESH,KADAPA,OTHERS,4.0-5.0,2,MYLAVARAM,168,740,705,35,740,0,0,0,0,0
ANDHRA PRADESH,KADAPA,OTHERS,4.0-5.0,3,PEDDAMUDIUM,668,2998,2486,440,2926,0,45,0,45,26
ANDHRA PRADESH,KADAPA,OTHERS,4.0-5.0,4,RAJUPALEM,350,1560,1555,3,1558,0,0,0,0,2
ANDHRA PRADESH,KADAPA,OTHERS,4.0-5.0,5,DUVVUR,63,274,274,0,274,0,0,0,0,0
ANDHRA PRADESH,KADAPA,OTHERS,4.0-5.0,6,S.MYDUKUR,79,343,341,0,341,0,1,0,1,1
ANDHRA PRADESH,KADAPA,OTHERS,4.0-5.0,7,BRAHMAMGARIMATTAM,19,77,49,28,77,0,0,0,0,0
ANDHRA PRADESH,KADAPA,OTHERS,4.0-5.0,8,SRI AVADHUTHA KASINAYANA,76,336,149,186,335,0,0,0,0,0
ANDHRA PRADESH,KADAPA,OTHERS,4.0-5.0,9,KALASAPADU,20,87,63,24,87,0,0,0,0,0
ANDHRA PRADESH,KADAPA,OTHERS,4.0-5.0,10,PORUMAMILLA,62,276,162,114,276,0,0,0,0,0
ANDHRA PRADESH,KADAPA,OTHERS,4.0-5.0,11,B.KODUR,66,295,60,13,73,0,0,0,0,221
ANDHRA PRADESH,KADAPA,OTHERS,4.0-5.0,12,BADVEL,26,115,26,54,80,0,22,0,22,12
ANDHRA PRADESH,KADAPA,OTHERS,4.0-5.0,13,GOPAVARAM,51,226,104,37,141,0,0,14,14,71
ANDHRA PRADESH,KADAPA,OTHERS,4.0-5.0,14,KHAJIPET,46,207,169,38,207,0,0,0,0,0
ANDHRA PRADESH,KADAPA,OTHERS,4.0-5.0,15,CHAPAD,80,359,275,58,333,0,14,0,14,12
ANDHRA PRADESH,KADAPA,OTHERS,4.0-5.0,16,PRODDATUR,192,851,851,0,851,0,0,0,0,0
ANDHRA PRADESH,KADAPA,OTHERS,4.0-5.0,17,JAMMALAMADUGU,170,755,723,26,749,0,4,0,4,2
ANDHRA PRADESH,KADAPA,OTHERS,4.0-5.0,18,MUDDANUR,131,577,434,131,565,0,8,0,8,5
ANDHRA PRADESH,KADAPA,OTHERS,4.0-5.0,19,SIMHADRIPURAM,304,1349,762,540,1302,0,30,0,30,17
ANDHRA PRADESH,KADAPA,OTHERS,4.0-5.0,20,LINGALA,235,1047,1047,0,1047,0,0,0,0,0
ANDHRA PRADESH,KADAPA,OTHERS,4.0-5.0,21,PULIVENDLA,211,964,964,0,964,0,0,0,0,0
ANDHRA PRADESH,KADAPA,OTHERS,4.0-5.0,22,VEMULA,165,729,531,167,698,0,20,0,20,12
ANDHRA PRADESH,KADAPA,OTHERS,4.0-5.0,23,THONDUR,284,1256,1117,139,1256,0,0,0,0,0
ANDHRA PRADESH,KADAPA,OTHERS,4.0-5.0,24,VEERAPUNAYUNIPALLE,213,929,729,200,929,0,0,0,0,0
ANDHRA PRADESH,KADAPA,OTHERS,4.0-5.0,25,YERRAGUNTLA,201,894,582,313,895,0,0,0,0,0
ANDHRA PRADESH,KADAPA,OTHERS,4.0-5.0,26,KAMALAPURAM,134,589,450,139,589,0,0,0,0,0
ANDHRA PRADESH,KADAPA,OTHERS,4.0-5.0,27,VALLUR,81,360,317,22,339,0,13,0,13,8
ANDHRA PRADESH,KADAPA,OTHERS,4.0-5.0,28,CHENNUR,30,133,115,18,133,0,0,0,0,0
ANDHRA PRADESH,KADAPA,OTHERS,4.0-5.0,29,ATLUR,12,53,5,48,53,0,0,0,0,0
ANDHRA PRADESH,KADAPA,OTHERS,4.0-5.0,30,VONTIMITTA,11,49,5,23,28,0,13,0,13,8
ANDHRA PRADESH,KADAPA,OTHERS,4.0-5.0,31,SIDHOUT,31,139,130,0,130,0,0,6,6,4
ANDHRA PRADESH,KADAPA,OTHERS,4.0-5.0,32,CUDDAPAH,29,129,96,33,129,0,0,0,0,0
ANDHRA PRADESH,KADAPA,OTHERS,4.0-5.0,33,CHINTHAKOMMADINNE,60,262,232,30,262,0,0,0,0,0
ANDHRA PRADESH,KADAPA,OTHERS,4.0-5.0,34,PENDLIMARRI,83,366,331,35,366,0,0,0,0,0
ANDHRA PRADESH,KADAPA,OTHERS,4.0-5.0,35,VEMPALLE,256,1152,1101,52,1153,0,0,0,0,0
ANDHRA PRADESH,KADAPA,OTHERS,4.0-5.0,36,CHAKRAYAPET,153,673,460,153,613,5,32,0,37,21
ANDHRA PRADESH,KADAPA,OTHERS,4.0-5.0,37,GALIVEEDU,232,1021,591,394,985,0,19,0,19,16
ANDHRA PRADESH,KADAPA,OTHERS,4.0-5.0,38,CHINNAMANDEM,97,424,347,36,383,0,25,0,25,15
ANDHRA PRADESH,KADAPA,OTHERS,4.0-5.0,39,SAMBEPALLE,216,957,717,30,747,0,118,15,133,77
ANDHRA PRADESH,KADAPA,OTHERS,4.0-5.0,40,T SUNDUPALLE,120,530,229,204,433,0,61,0,61,35
ANDHRA PRADESH,KADAPA,OTHERS,4.0-5.0,41,RAYACHOTI,132,585,345,182,527,0,36,0,36,23
ANDHRA PRADESH,KADAPA,OTHERS,4.0-5.0,42,LAKKIREDDIPALLE,155,688,558,117,675,0,0,0,0,13
ANDHRA PRADESH,KADAPA,OTHERS,4.0-5.0,43,RAMAPURAM,151,668,537,108,645,0,15,0,15,9
ANDHRA PRADESH,KADAPA,OTHERS,4.0-5.0,44,VEERABALLE,79,349,274,73,347,0,0,0,0,1
ANDHRA PRADESH,KADAPA,OTHERS,4.0-5.0,45,NANDALUR,11,49,24,25,49,0,0,0,0,0
ANDHRA PRADESH,KADAPA,OTHERS,4.0-5.0,46,PENAGALUR,11,48,21,17,38,0,6,0,6,4
ANDHRA PRADESH,KADAPA,OTHERS,4.0-5.0,47,CHITVEL,45,198,0,198,198,0,0,0,0,0
ANDHRA PRADESH,KADAPA,OTHERS,4.0-5.0,48,RAJAMPET,62,272,98,174,272,0,0,0,0,0
ANDHRA PRADESH,KADAPA,OTHERS,4.0-5.0,49,PULLAMPETA,74,324,90,67,157,0,106,0,106,60
ANDHRA PRADESH,KADAPA,OTHERS,4.0-5.0,50,OBULAVARIPALLE,70,311,149,3,152,0,101,0,101,58
ANDHRA PRADESH,KADAPA,OTHERS,4.0-5.0,51,KODUR,94,415,238,177,415,0,0,0,0,0
ANDHRA PRADESH,KADAPA,SCHEDULED TRIBES,4.0-5.0,1,KONDAPURAM,4,18,9,9,18,0,0,0,0,0
ANDHRA PRADESH,KADAPA,SCHEDULED TRIBES,4.0-5.0,2,MYLAVARAM,3,13,13,0,13,0,0,0,0,0
ANDHRA PRADESH,KADAPA,SCHEDULED TRIBES,4.0-5.0,3,PEDDAMUDIUM,3,13,13,0,13,0,0,0,0,0
ANDHRA PRADESH,KADAPA,SCHEDULED TRIBES,4.0-5.0,4,RAJUPALEM,0,0,0,0,0,0,0,0,0,0
ANDHRA PRADESH,KADAPA,SCHEDULED TRIBES,4.0-5.0,5,DUVVUR,0,0,0,0,0,0,0,0,0,0
ANDHRA PRADESH,KADAPA,SCHEDULED TRIBES,4.0-5.0,6,S.MYDUKUR,0,0,0,0,0,0,0,0,0,0
ANDHRA PRADESH,KADAPA,SCHEDULED TRIBES,4.0-5.0,7,BRAHMAMGARIMATTAM,0,0,0,0,0,0,0,0,0,0
ANDHRA PRADESH,KADAPA,SCHEDULED TRIBES,4.0-5.0,8,SRI AVADHUTHA KASINAYANA,1,5,2,2,4,0,0,0,0,0
ANDHRA PRADESH,KADAPA,SCHEDULED TRIBES,4.0-5.0,9,KALASAPADU,0,0,0,0,0,0,0,0,0,0
ANDHRA PRADESH,KADAPA,SCHEDULED TRIBES,4.0-5.0,10,PORUMAMILLA,0,0,0,0,0,0,0,0,0,0
ANDHRA PRADESH,KADAPA,SCHEDULED TRIBES,4.0-5.0,11,B.KODUR,0,0,0,0,0,0,0,0,0,0
ANDHRA PRADESH,KADAPA,SCHEDULED TRIBES,4.0-5.0,12,BADVEL,0,0,0,0,0,0,0,0,0,0
ANDHRA PRADESH,KADAPA,SCHEDULED TRIBES,4.0-5.0,13,GOPAVARAM,0,0,0,0,0,0,0,0,0,0
ANDHRA PRADESH,KADAPA,SCHEDULED TRIBES,4.0-5.0,14,KHAJIPET,0,0,0,0,0,0,0,0,0,0
ANDHRA PRADESH,KADAPA,SCHEDULED TRIBES,4.0-5.0,15,CHAPAD,0,0,0,0,0,0,0,0,0,0
ANDHRA PRADESH,KADAPA,SCHEDULED TRIBES,4.0-5.0,16,PRODDATUR,0,0,0,0,0,0,0,0,0,0
ANDHRA PRADESH,KADAPA,SCHEDULED TRIBES,4.0-5.0,17,JAMMALAMADUGU,0,0,0,0,0,0,0,0,0,0
ANDHRA PRADESH,KADAPA,SCHEDULED TRIBES,4.0-5.0,18,MUDDANUR,1,4,2,2,4,0,0,0,0,0
ANDHRA PRADESH,KADAPA,SCHEDULED TRIBES,4.0-5.0,19,SIMHADRIPURAM,0,0,0,0,0,0,0,0,0,0
ANDHRA PRADESH,KADAPA,SCHEDULED TRIBES,4.0-5.0,20,LINGALA,0,0,0,0,0,0,0,0,0,0
ANDHRA PRADESH,KADAPA,SCHEDULED TRIBES,4.0-5.0,21,PULIVENDLA,1,4,2,2,4,0,0,0,0,0
ANDHRA PRADESH,KADAPA,SCHEDULED TRIBES,4.0-5.0,22,VEMULA,0,0,0,0,0,0,0,0,0,0
ANDHRA PRADESH,KADAPA,SCHEDULED TRIBES,4.0-5.0,23,THONDUR,0,0,0,0,0,0,0,0,0,0
ANDHRA PRADESH,KADAPA,SCHEDULED TRIBES,4.0-5.0,24,VEERAPUNAYUNIPALLE,0,0,0,0,0,0,0,0,0,0
ANDHRA PRADESH,KADAPA,SCHEDULED TRIBES,4.0-5.0,25,YERRAGUNTLA,0,0,0,0,0,0,0,0,0,0
ANDHRA PRADESH,KADAPA,SCHEDULED TRIBES,4.0-5.0,26,KAMALAPURAM,0,0,0,0,0,0,0,0,0,0
ANDHRA PRADESH,KADAPA,SCHEDULED TRIBES,4.0-5.0,27,VALLUR,0,0,0,0,0,0,0,0,0,0
ANDHRA PRADESH,KADAPA,SCHEDULED TRIBES,4.0-5.0,28,CHENNUR,0,0,0,0,0,0,0,0,0,0
ANDHRA PRADESH,KADAPA,SCHEDULED TRIBES,4.0-5.0,29,ATLUR,0,0,0,0,0,0,0,0,0,0
ANDHRA PRADESH,KADAPA,SCHEDULED TRIBES,4.0-5.0,30,VONTIMITTA,0,0,0,0,0,0,0,0,0,0
ANDHRA PRADESH,KADAPA,SCHEDULED TRIBES,4.0-5.0,31,SIDHOUT,0,0,0,0,0,0,0,0,0,0
ANDHRA PRADESH,KADAPA,SCHEDULED TRIBES,4.0-5.0,32,CUDDAPAH,0,0,0,0,0,0,0,0,0,0
ANDHRA PRADESH,KADAPA,SCHEDULED TRIBES,4.0-5.0,33,CHINTHAKOMMADINNE,1,4,4,0,4,0,0,0,0,0
ANDHRA PRADESH,KADAPA,SCHEDULED TRIBES,4.0-5.0,34,PENDLIMARRI,0,0,0,0,0,0,0,0,0,0
ANDHRA PRADESH,KADAPA,SCHEDULED TRIBES,4.0-5.0,35,VEMPALLE,0,0,0,0,0,0,0,0,0,0
ANDHRA PRADESH,KADAPA,SCHEDULED TRIBES,4.0-5.0,36,CHAKRAYAPET,8,38,19,19,38,0,0,0,0,0
ANDHRA PRADESH,KADAPA,SCHEDULED TRIBES,4.0-5.0,37,GALIVEEDU,1,5,2,2,4,0,0,0,0,0
ANDHRA PRADESH,KADAPA,SCHEDULED TRIBES,4.0-5.0,38,CHINNAMANDEM,0,0,0,0,0,0,0,0,0,0
ANDHRA PRADESH,KADAPA,SCHEDULED TRIBES,4.0-5.0,39,SAMBEPALLE,1,4,2,2,4,0,0,0,0,0
ANDHRA PRADESH,KADAPA,SCHEDULED TRIBES,4.0-5.0,40,T SUNDUPALLE,9,41,20,20,40,0,0,0,0,0
ANDHRA PRADESH,KADAPA,SCHEDULED TRIBES,4.0-5.0,41,RAYACHOTI,0,0,0,0,0,0,0,0,0,0
ANDHRA PRADESH,KADAPA,SCHEDULED TRIBES,4.0-5.0,42,LAKKIREDDIPALLE,1,5,2,2,4,0,0,0,0,0
ANDHRA PRADESH,KADAPA,SCHEDULED TRIBES,4.0-5.0,43,RAMAPURAM,3,13,7,7,14,0,0,0,0,0
ANDHRA PRADESH,KADAPA,SCHEDULED TRIBES,4.0-5.0,44,VEERABALLE,0,0,0,0,0,0,0,0,0,0
ANDHRA PRADESH,KADAPA,SCHEDULED TRIBES,4.0-5.0,45,NANDALUR,0,0,0,0,0,0,0,0,0,0
ANDHRA PRADESH,KADAPA,SCHEDULED TRIBES,4.0-5.0,46,PENAGALUR,0,0,0,0,0,0,0,0,0,0
ANDHRA PRADESH,KADAPA,SCHEDULED TRIBES,4.0-5.0,47,CHITVEL,0,0,0,0,0,0,0,0,0,0
ANDHRA PRADESH,KADAPA,SCHEDULED TRIBES,4.0-5.0,48,RAJAMPET,0,0,0,0,0,0,0,0,0,0
ANDHRA PRADESH,KADAPA,SCHEDULED TRIBES,4.0-5.0,49,PULLAMPETA,0,0,0,0,0,0,0,0,0,0
ANDHRA PRADESH,KADAPA,SCHEDULED TRIBES,4.0-5.0,50,OBULAVARIPALLE,1,4,2,2,4,0,0,0,0,0
ANDHRA PRADESH,KADAPA,SCHEDULED TRIBES,4.0-5.0,51,KODUR,3,13,4,9,13,0,0,0,0,0
ANDHRA PRADESH,KADAPA,ALL SOCIAL GROUPS,4.0-5.0,1,KONDAPURAM,161,711,625,85,710,0,1,0,1,0
ANDHRA PRADESH,KADAPA,ALL SOCIAL GROUPS,4.0-5.0,2,MYLAVARAM,174,765,730,35,765,0,0,0,0,0
ANDHRA PRADESH,KADAPA,ALL SOCIAL GROUPS,4.0-5.0,3,PEDDAMUDIUM,682,3060,2537,440,2977,0,57,0,57,26
ANDHRA PRADESH,KADAPA,ALL SOCIAL GROUPS,4.0-5.0,4,RAJUPALEM,355,1583,1566,14,1580,0,0,0,0,2
ANDHRA PRADESH,KADAPA,ALL SOCIAL GROUPS,4.0-5.0,5,DUVVUR,65,283,279,4,283,0,0,0,0,0
ANDHRA PRADESH,KADAPA,ALL SOCIAL GROUPS,4.0-5.0,6,S.MYDUKUR,79,343,341,0,341,0,1,0,1,1
ANDHRA PRADESH,KADAPA,ALL SOCIAL GROUPS,4.0-5.0,7,BRAHMAMGARIMATTAM,20,81,51,30,81,0,0,0,0,0
ANDHRA PRADESH,KADAPA,ALL SOCIAL GROUPS,4.0-5.0,8,SRI AVADHUTHA KASINAYANA,78,345,154,191,345,0,0,0,0,0
ANDHRA PRADESH,KADAPA,ALL SOCIAL GROUPS,4.0-5.0,9,KALASAPADU,20,87,63,24,87,0,0,0,0,0
ANDHRA PRADESH,KADAPA,ALL SOCIAL GROUPS,4.0-5.0,10,PORUMAMILLA,65,289,169,120,289,0,0,0,0,0
ANDHRA PRADESH,KADAPA,ALL SOCIAL GROUPS,4.0-5.0,11,B.KODUR,66,295,60,13,73,0,0,0,0,221
ANDHRA PRADESH,KADAPA,ALL SOCIAL GROUPS,4.0-5.0,12,BADVEL,26,115,26,54,80,0,22,0,22,12
ANDHRA PRADESH,KADAPA,ALL SOCIAL GROUPS,4.0-5.0,13,GOPAVARAM,51,226,104,37,141,0,0,14,14,71
ANDHRA PRADESH,KADAPA,ALL SOCIAL GROUPS,4.0-5.0,14,KHAJIPET,47,211,171,40,211,0,0,0,0,0
ANDHRA PRADESH,KADAPA,ALL SOCIAL GROUPS,4.0-5.0,15,CHAPAD,80,359,275,58,333,0,14,0,14,12
ANDHRA PRADESH,KADAPA,ALL SOCIAL GROUPS,4.0-5.0,16,PRODDATUR,193,855,853,2,855,0,0,0,0,0
ANDHRA PRADESH,KADAPA,ALL SOCIAL GROUPS,4.0-5.0,17,JAMMALAMADUGU,171,759,725,28,753,0,4,0,4,2
ANDHRA PRADESH,KADAPA,ALL SOCIAL GROUPS,4.0-5.0,18,MUDDANUR,141,622,453,155,608,0,10,0,10,5
ANDHRA PRADESH,KADAPA,ALL SOCIAL GROUPS,4.0-5.0,19,SIMHADRIPURAM,305,1354,764,542,1306,0,30,0,30,17
ANDHRA PRADESH,KADAPA,ALL SOCIAL GROUPS,4.0-5.0,20,LINGALA,238,1061,1061,0,1061,0,0,0,0,0
ANDHRA PRADESH,KADAPA,ALL SOCIAL GROUPS,4.0-5.0,21,PULIVENDLA,213,973,968,5,973,0,0,0,0,0
ANDHRA PRADESH,KADAPA,ALL SOCIAL GROUPS,4.0-5.0,22,VEMULA,166,734,533,169,702,0,20,0,20,12
ANDHRA PRADESH,KADAPA,ALL SOCIAL GROUPS,4.0-5.0,23,THONDUR,286,1266,1122,144,1266,0,0,0,0,0
ANDHRA PRADESH,KADAPA,ALL SOCIAL GROUPS,4.0-5.0,24,VEERAPUNAYUNIPALLE,213,929,729,200,929,0,0,0,0,0
ANDHRA PRADESH,KADAPA,ALL SOCIAL GROUPS,4.0-5.0,25,YERRAGUNTLA,201,894,582,313,895,0,0,0,0,0
ANDHRA PRADESH,KADAPA,ALL SOCIAL GROUPS,4.0-5.0,26,KAMALAPURAM,135,593,452,141,593,0,0,0,0,0
ANDHRA PRADESH,KADAPA,ALL SOCIAL GROUPS,4.0-5.0,27,VALLUR,82,365,319,25,344,0,13,0,13,8
ANDHRA PRADESH,KADAPA,ALL SOCIAL GROUPS,4.0-5.0,28,CHENNUR,30,133,115,18,133,0,0,0,0,0
ANDHRA PRADESH,KADAPA,ALL SOCIAL GROUPS,4.0-5.0,29,ATLUR,12,53,5,48,53,0,0,0,0,0
ANDHRA PRADESH,KADAPA,ALL SOCIAL GROUPS,4.0-5.0,30,VONTIMITTA,11,49,5,23,28,0,13,0,13,8
ANDHRA PRADESH,KADAPA,ALL SOCIAL GROUPS,4.0-5.0,31,SIDHOUT,31,139,130,0,130,0,0,6,6,4
ANDHRA PRADESH,KADAPA,ALL SOCIAL GROUPS,4.0-5.0,32,CUDDAPAH,30,133,98,35,133,0,0,0,0,0
ANDHRA PRADESH,KADAPA,ALL SOCIAL GROUPS,4.0-5.0,33,CHINTHAKOMMADINNE,62,271,241,30,271,0,0,0,0,0
ANDHRA PRADESH,KADAPA,ALL SOCIAL GROUPS,4.0-5.0,34,PENDLIMARRI,83,366,331,35,366,0,0,0,0,0
ANDHRA PRADESH,KADAPA,ALL SOCIAL GROUPS,4.0-5.0,35,VEMPALLE,256,1152,1101,52,1153,0,0,0,0,0
ANDHRA PRADESH,KADAPA,ALL SOCIAL GROUPS,4.0-5.0,36,CHAKRAYAPET,161,710,479,172,651,5,32,0,37,21
ANDHRA PRADESH,KADAPA,ALL SOCIAL GROUPS,4.0-5.0,37,GALIVEEDU,233,1026,593,397,990,0,19,0,19,16
ANDHRA PRADESH,KADAPA,ALL SOCIAL GROUPS,4.0-5.0,38,CHINNAMANDEM,98,428,349,38,387,0,25,0,25,15
ANDHRA PRADESH,KADAPA,ALL SOCIAL GROUPS,4.0-5.0,39,SAMBEPALLE,222,983,730,43,773,0,118,15,133,77
ANDHRA PRADESH,KADAPA,ALL SOCIAL GROUPS,4.0-5.0,40,T SUNDUPALLE,131,579,254,228,482,0,63,0,63,35
ANDHRA PRADESH,KADAPA,ALL SOCIAL GROUPS,4.0-5.0,41,RAYACHOTI,134,594,350,182,532,0,40,0,40,23
ANDHRA PRADESH,KADAPA,ALL SOCIAL GROUPS,4.0-5.0,42,LAKKIREDDIPALLE,158,701,565,124,689,0,0,0,0,13
ANDHRA PRADESH,KADAPA,ALL SOCIAL GROUPS,4.0-5.0,43,RAMAPURAM,159,705,565,116,681,0,15,0,15,9
ANDHRA PRADESH,KADAPA,ALL SOCIAL GROUPS,4.0-5.0,44,VEERABALLE,79,349,274,73,347,0,0,0,0,1
ANDHRA PRADESH,KADAPA,ALL SOCIAL GROUPS,4.0-5.0,45,NANDALUR,11,49,24,25,49,0,0,0,0,0
ANDHRA PRADESH,KADAPA,ALL SOCIAL GROUPS,4.0-5.0,46,PENAGALUR,11,48,21,17,38,0,6,0,6,4
ANDHRA PRADESH,KADAPA,ALL SOCIAL GROUPS,4.0-5.0,47,CHITVEL,45,198,0,198,198,0,0,0,0,0
ANDHRA PRADESH,KADAPA,ALL SOCIAL GROUPS,4.0-5.0,48,RAJAMPET,63,276,100,176,276,0,0,0,0,0
ANDHRA PRADESH,KADAPA,ALL SOCIAL GROUPS,4.0-5.0,49,PULLAMPETA,74,324,90,67,157,0,106,0,106,60
ANDHRA PRADESH,KADAPA,ALL SOCIAL GROUPS,4.0-5.0,50,OBULAVARIPALLE,71,315,151,5,156,0,101,0,101,58
ANDHRA PRADESH,KADAPA,ALL SOCIAL GROUPS,4.0-5.0,51,KODUR,100,441,242,199,441,0,0,0,0,0
ANDHRA PRADESH,KADAPA,INSTITUTIONAL,10.0-20.0,1,KONDAPURAM,0,0,0,0,0,0,0,0,0,0
ANDHRA PRADESH,KADAPA,INSTITUTIONAL,10.0-20.0,2,MYLAVARAM,0,0,0,0,0,0,0,0,0,0
ANDHRA PRADESH,KADAPA,INSTITUTIONAL,10.0-20.0,3,PEDDAMUDIUM,0,0,0,0,0,0,0,0,0,0
ANDHRA PRADESH,KADAPA,INSTITUTIONAL,10.0-20.0,4,RAJUPALEM,0,0,0,0,0,0,0,0,0,0
ANDHRA PRADESH,KADAPA,INSTITUTIONAL,10.0-20.0,5,DUVVUR,0,0,0,0,0,0,0,0,0,0
ANDHRA PRADESH,KADAPA,INSTITUTIONAL,10.0-20.0,6,S.MYDUKUR,0,0,0,0,0,0,0,0,0,0
ANDHRA PRADESH,KADAPA,INSTITUTIONAL,10.0-20.0,7,BRAHMAMGARIMATTAM,0,0,0,0,0,0,0,0,0,0
ANDHRA PRADESH,KADAPA,INSTITUTIONAL,10.0-20.0,8,SRI AVADHUTHA KASINAYANA,0,0,0,0,0,0,0,0,0,0
ANDHRA PRADESH,KADAPA,INSTITUTIONAL,10.0-20.0,9,KALASAPADU,0,0,0,0,0,0,0,0,0,0
ANDHRA PRADESH,KADAPA,INSTITUTIONAL,10.0-20.0,10,PORUMAMILLA,0,0,0,0,0,0,0,0,0,0
ANDHRA PRADESH,KADAPA,INSTITUTIONAL,10.0-20.0,11,B.KODUR,0,0,0,0,0,0,0,0,0,0
ANDHRA PRADESH,KADAPA,INSTITUTIONAL,10.0-20.0,12,BADVEL,0,0,0,0,0,0,0,0,0,0
ANDHRA PRADESH,KADAPA,INSTITUTIONAL,10.0-20.0,13,GOPAVARAM,0,0,0,0,0,0,0,0,0,0
ANDHRA PRADESH,KADAPA,INSTITUTIONAL,10.0-20.0,14,KHAJIPET,0,0,0,0,0,0,0,0,0,0
ANDHRA PRADESH,KADAPA,INSTITUTIONAL,10.0-20.0,15,CHAPAD,0,0,0,0,0,0,0,0,0,0
ANDHRA PRADESH,KADAPA,INSTITUTIONAL,10.0-20.0,16,PRODDATUR,1,18,16,2,18,0,0,0,0,0
ANDHRA PRADESH,KADAPA,INSTITUTIONAL,10.0-20.0,17,JAMMALAMADUGU,0,0,0,0,0,0,0,0,0,0
ANDHRA PRADESH,KADAPA,INSTITUTIONAL,10.0-20.0,18,MUDDANUR,0,0,0,0,0,0,0,0,0,0
ANDHRA PRADESH,KADAPA,INSTITUTIONAL,10.0-20.0,19,SIMHADRIPURAM,0,0,0,0,0,0,0,0,0,0
ANDHRA PRADESH,KADAPA,INSTITUTIONAL,10.0-20.0,20,LINGALA,0,0,0,0,0,0,0,0,0,0
ANDHRA PRADESH,KADAPA,INSTITUTIONAL,10.0-20.0,21,PULIVENDLA,0,0,0,0,0,0,0,0,0,0
ANDHRA PRADESH,KADAPA,INSTITUTIONAL,10.0-20.0,22,VEMULA,0,0,0,0,0,0,0,0,0,0
ANDHRA PRADESH,KADAPA,INSTITUTIONAL,10.0-20.0,23,THONDUR,0,0,0,0,0,0,0,0,0,0
ANDHRA PRADESH,KADAPA,INSTITUTIONAL,10.0-20.0,24,VEERAPUNAYUNIPALLE,0,0,0,0,0,0,0,0,0,0
ANDHRA PRADESH,KADAPA,INSTITUTIONAL,10.0-20.0,25,YERRAGUNTLA,0,0,0,0,0,0,0,0,0,0
ANDHRA PRADESH,KADAPA,INSTITUTIONAL,10.0-20.0,26,KAMALAPURAM,0,0,0,0,0,0,0,0,0,0
ANDHRA PRADESH,KADAPA,INSTITUTIONAL,10.0-20.0,27,VALLUR,0,0,0,0,0,0,0,0,0,0
ANDHRA PRADESH,KADAPA,INSTITUTIONAL,10.0-20.0,28,CHENNUR,0,0,0,0,0,0,0,0,0,0
ANDHRA PRADESH,KADAPA,INSTITUTIONAL,10.0-20.0,29,ATLUR,0,0,0,0,0,0,0,0,0,0
ANDHRA PRADESH,KADAPA,INSTITUTIONAL,10.0-20.0,30,VONTIMITTA,0,0,0,0,0,0,0,0,0,0
ANDHRA PRADESH,KADAPA,INSTITUTIONAL,10.0-20.0,31,SIDHOUT,0,0,0,0,0,0,0,0,0,0
ANDHRA PRADESH,KADAPA,INSTITUTIONAL,10.0-20.0,32,CUDDAPAH,0,0,0,0,0,0,0,0,0,0
ANDHRA PRADESH,KADAPA,INSTITUTIONAL,10.0-20.0,33,CHINTHAKOMMADINNE,0,0,0,0,0,0,0,0,0,0
ANDHRA PRADESH,KADAPA,INSTITUTIONAL,10.0-20.0,34,PENDLIMARRI,0,0,0,0,0,0,0,0,0,0
ANDHRA PRADESH,KADAPA,INSTITUTIONAL,10.0-20.0,35,VEMPALLE,0,0,0,0,0,0,0,0,0,0
ANDHRA PRADESH,KADAPA,INSTITUTIONAL,10.0-20.0,36,CHAKRAYAPET,0,0,0,0,0,0,0,0,0,0
ANDHRA PRADESH,KADAPA,INSTITUTIONAL,10.0-20.0,37,GALIVEEDU,0,0,0,0,0,0,0,0,0,0
ANDHRA PRADESH,KADAPA,INSTITUTIONAL,10.0-20.0,38,CHINNAMANDEM,0,0,0,0,0,0,0,0,0,0
ANDHRA PRADESH,KADAPA,INSTITUTIONAL,10.0-20.0,39,SAMBEPALLE,0,0,0,0,0,0,0,0,0,0
ANDHRA PRADESH,KADAPA,INSTITUTIONAL,10.0-20.0,40,T SUNDUPALLE,0,0,0,0,0,0,0,0,0,0
ANDHRA PRADESH,KADAPA,INSTITUTIONAL,10.0-20.0,41,RAYACHOTI,0,0,0,0,0,0,0,0,0,0
ANDHRA PRADESH,KADAPA,INSTITUTIONAL,10.0-20.0,42,LAKKIREDDIPALLE,0,0,0,0,0,0,0,0,0,0
ANDHRA PRADESH,KADAPA,INSTITUTIONAL,10.0-20.0,43,RAMAPURAM,0,0,0,0,0,0,0,0,0,0
ANDHRA PRADESH,KADAPA,INSTITUTIONAL,10.0-20.0,44,VEERABALLE,0,0,0,0,0,0,0,0,0,0
ANDHRA PRADESH,KADAPA,INSTITUTIONAL,10.0-20.0,45,NANDALUR,0,0,0,0,0,0,0,0,0,0
ANDHRA PRADESH,KADAPA,INSTITUTIONAL,10.0-20.0,46,PENAGALUR,0,0,0,0,0,0,0,0,0,0
ANDHRA PRADESH,KADAPA,INSTITUTIONAL,10.0-20.0,47,CHITVEL,0,0,0,0,0,0,0,0,0,0
ANDHRA PRADESH,KADAPA,INSTITUTIONAL,10.0-20.0,48,RAJAMPET,0,0,0,0,0,0,0,0,0,0
ANDHRA PRADESH,KADAPA,INSTITUTIONAL,10.0-20.0,49,PULLAMPETA,0,0,0,0,0,0,0,0,0,0
ANDHRA PRADESH,KADAPA,INSTITUTIONAL,10.0-20.0,50,OBULAVARIPALLE,0,0,0,0,0,0,0,0,0,0
ANDHRA PRADESH,KADAPA,INSTITUTIONAL,10.0-20.0,51,KODUR,0,0,0,0,0,0,0,0,0,0
ANDHRA PRADESH,KADAPA,SCHEDULED CASTE,10.0-20.0,1,KONDAPURAM,4,44,19,26,45,0,0,0,0,0
ANDHRA PRADESH,KADAPA,SCHEDULED CASTE,10.0-20.0,2,MYLAVARAM,0,0,0,0,0,0,0,0,0,0
ANDHRA PRADESH,KADAPA,SCHEDULED CASTE,10.0-20.0,3,PEDDAMUDIUM,2,26,13,13,26,0,0,0,0,0
ANDHRA PRADESH,KADAPA,SCHEDULED CASTE,10.0-20.0,4,RAJUPALEM,0,0,0,0,0,0,0,0,0,0
ANDHRA PRADESH,KADAPA,SCHEDULED CASTE,10.0-20.0,5,DUVVUR,0,0,0,0,0,0,0,0,0,0
ANDHRA PRADESH,KADAPA,SCHEDULED CASTE,10.0-20.0,6,S.MYDUKUR,0,0,0,0,0,0,0,0,0,0
ANDHRA PRADESH,KADAPA,SCHEDULED CASTE,10.0-20.0,7,BRAHMAMGARIMATTAM,0,0,0,0,0,0,0,0,0,0
ANDHRA PRADESH,KADAPA,SCHEDULED CASTE,10.0-20.0,8,SRI AVADHUTHA KASINAYANA,0,0,0,0,0,0,0,0,0,0
ANDHRA PRADESH,KADAPA,SCHEDULED CASTE,10.0-20.0,9,KALASAPADU,0,0,0,0,0,0,0,0,0,0
ANDHRA PRADESH,KADAPA,SCHEDULED CASTE,10.0-20.0,10,PORUMAMILLA,0,0,0,0,0,0,0,0,0,0
ANDHRA PRADESH,KADAPA,SCHEDULED CASTE,10.0-20.0,11,B.KODUR,0,0,0,0,0,0,0,0,0,0
ANDHRA PRADESH,KADAPA,SCHEDULED CASTE,10.0-20.0,12,BADVEL,1,13,6,6,12,0,0,0,0,0
ANDHRA PRADESH,KADAPA,SCHEDULED CASTE,10.0-20.0,13,GOPAVARAM,1,11,5,5,10,0,0,0,0,0
ANDHRA PRADESH,KADAPA,SCHEDULED CASTE,10.0-20.0,14,KHAJIPET,0,0,0,0,0,0,0,0,0,0
ANDHRA PRADESH,KADAPA,SCHEDULED CASTE,10.0-20.0,15,CHAPAD,0,0,0,0,0,0,0,0,0,0
ANDHRA PRADESH,KADAPA,SCHEDULED CASTE,10.0-20.0,16,PRODDATUR,0,0,0,0,0,0,0,0,0,0
ANDHRA PRADESH,KADAPA,SCHEDULED CASTE,10.0-20.0,17,JAMMALAMADUGU,0,0,0,0,0,0,0,0,0,0
ANDHRA PRADESH,KADAPA,SCHEDULED CASTE,10.0-20.0,18,MUDDANUR,0,0,0,0,0,0,0,0,0,0
ANDHRA PRADESH,KADAPA,SCHEDULED CASTE,10.0-20.0,19,SIMHADRIPURAM,11,128,96,32,128,0,0,0,0,0
ANDHRA PRADESH,KADAPA,SCHEDULED CASTE,10.0-20.0,20,LINGALA,0,0,0,0,0,0,0,0,0,0
ANDHRA PRADESH,KADAPA,SCHEDULED CASTE,10.0-20.0,21,PULIVENDLA,0,0,0,0,0,0,0,0,0,0
ANDHRA PRADESH,KADAPA,SCHEDULED CASTE,10.0-20.0,22,VEMULA,0,0,0,0,0,0,0,0,0,0
ANDHRA PRADESH,KADAPA,SCHEDULED CASTE,10.0-20.0,23,THONDUR,0,0,0,0,0,0,0,0,0,0
ANDHRA PRADESH,KADAPA,SCHEDULED CASTE,10.0-20.0,24,VEERAPUNAYUNIPALLE,0,0,0,0,0,0,0,0,0,0
ANDHRA PRADESH,KADAPA,SCHEDULED CASTE,10.0-20.0,25,YERRAGUNTLA,0,0,0,0,0,0,0,0,0,0
ANDHRA PRADESH,KADAPA,SCHEDULED CASTE,10.0-20.0,26,KAMALAPURAM,0,0,0,0,0,0,0,0,0,0
ANDHRA PRADESH,KADAPA,SCHEDULED CASTE,10.0-20.0,27,VALLUR,0,0,0,0,0,0,0,0,0,0
ANDHRA PRADESH,KADAPA,SCHEDULED CASTE,10.0-20.0,28,CHENNUR,0,0,0,0,0,0,0,0,0,0
ANDHRA PRADESH,KADAPA,SCHEDULED CASTE,10.0-20.0,29,ATLUR,0,0,0,0,0,0,0,0,0,0
ANDHRA PRADESH,KADAPA,SCHEDULED CASTE,10.0-20.0,30,VONTIMITTA,0,0,0,0,0,0,0,0,0,0
ANDHRA PRADESH,KADAPA,SCHEDULED CASTE,10.0-20.0,31,SIDHOUT,0,0,0,0,0,0,0,0,0,0
ANDHRA PRADESH,KADAPA,SCHEDULED CASTE,10.0-20.0,32,CUDDAPAH,0,0,0,0,0,0,0,0,0,0
ANDHRA PRADESH,KADAPA,SCHEDULED CASTE,10.0-20.0,33,CHINTHAKOMMADINNE,0,0,0,0,0,0,0,0,0,0
ANDHRA PRADESH,KADAPA,SCHEDULED CASTE,10.0-20.0,34,PENDLIMARRI,0,0,0,0,0,0,0,0,0,0
ANDHRA PRADESH,KADAPA,SCHEDULED CASTE,10.0-20.0,35,VEMPALLE,0,0,0,0,0,0,0,0,0,0
ANDHRA PRADESH,KADAPA,SCHEDULED CASTE,10.0-20.0,36,CHAKRAYAPET,0,0,0,0,0,0,0,0,0,0
ANDHRA PRADESH,KADAPA,SCHEDULED CASTE,10.0-20.0,37,GALIVEEDU,0,0,0,0,0,0,0,0,0,0
ANDHRA PRADESH,KADAPA,SCHEDULED CASTE,10.0-20.0,38,CHINNAMANDEM,0,0,0,0,0,0,0,0,0,0
ANDHRA PRADESH,KADAPA,SCHEDULED CASTE,10.0-20.0,39,SAMBEPALLE,0,0,0,0,0,0,0,0,0,0
ANDHRA PRADESH,KADAPA,SCHEDULED CASTE,10.0-20.0,40,T SUNDUPALLE,1,15,7,7,14,0,0,0,0,0
ANDHRA PRADESH,KADAPA,SCHEDULED CASTE,10.0-20.0,41,RAYACHOTI,0,0,0,0,0,0,0,0,0,0
ANDHRA PRADESH,KADAPA,SCHEDULED CASTE,10.0-20.0,42,LAKKIREDDIPALLE,1,17,8,8,16,0,0,0,0,0
ANDHRA PRADESH,KADAPA,SCHEDULED CASTE,10.0-20.0,43,RAMAPURAM,0,0,0,0,0,0,0,0,0,0
ANDHRA PRADESH,KADAPA,SCHEDULED CASTE,10.0-20.0,44,VEERABALLE,0,0,0,0,0,0,0,0,0,0
ANDHRA PRADESH,KADAPA,SCHEDULED CASTE,10.0-20.0,45,NANDALUR,0,0,0,0,0,0,0,0,0,0
ANDHRA PRADESH,KADAPA,SCHEDULED CASTE,10.0-20.0,46,PENAGALUR,0,0,0,0,0,0,0,0,0,0
ANDHRA PRADESH,KADAPA,SCHEDULED CASTE,10.0-20.0,47,CHITVEL,0,0,0,0,0,0,0,0,0,0
ANDHRA PRADESH,KADAPA,SCHEDULED CASTE,10.0-20.0,48,RAJAMPET,0,0,0,0,0,0,0,0,0,0
ANDHRA PRADESH,KADAPA,SCHEDULED CASTE,10.0-20.0,49,PULLAMPETA,0,0,0,0,0,0,0,0,0,0
ANDHRA PRADESH,KADAPA,SCHEDULED CASTE,10.0-20.0,50,OBULAVARIPALLE,0,0,0,0,0,0,0,0,0,0
ANDHRA PRADESH,KADAPA,SCHEDULED CASTE,10.0-20.0,51,KODUR,0,0,0,0,0,0,0,0,0,0
ANDHRA PRADESH,KADAPA,OTHERS,10.0-20.0,1,KONDAPURAM,18,222,113,109,222,0,0,0,0,0
ANDHRA PRADESH,KADAPA,OTHERS,10.0-20.0,2,MYLAVARAM,36,447,419,28,447,0,0,0,0,0
ANDHRA PRADESH,KADAPA,OTHERS,10.0-20.0,3,PEDDAMUDIUM,120,1458,1047,343,1390,0,43,0,43,25
ANDHRA PRADESH,KADAPA,OTHERS,10.0-20.0,4,RAJUPALEM,36,443,443,0,443,0,0,0,0,0
ANDHRA PRADESH,KADAPA,OTHERS,10.0-20.0,5,DUVVUR,1,11,11,0,11,0,0,0,0,0
ANDHRA PRADESH,KADAPA,OTHERS,10.0-20.0,6,S.MYDUKUR,6,74,37,37,74,0,0,0,0,0
ANDHRA PRADESH,KADAPA,OTHERS,10.0-20.0,7,BRAHMAMGARIMATTAM,3,33,16,16,32,0,0,0,0,0
ANDHRA PRADESH,KADAPA,OTHERS,10.0-20.0,8,SRI AVADHUTHA KASINAYANA,16,205,46,158,204,0,0,0,0,0
ANDHRA PRADESH,KADAPA,OTHERS,10.0-20.0,9,KALASAPADU,1,11,5,5,10,0,0,0,0,0
ANDHRA PRADESH,KADAPA,OTHERS,10.0-20.0,10,PORUMAMILLA,10,142,52,90,142,0,0,0,0,0
ANDHRA PRADESH,KADAPA,OTHERS,10.0-20.0,11,B.KODUR,4,53,27,27,54,0,0,0,0,0
ANDHRA PRADESH,KADAPA,OTHERS,10.0-20.0,12,BADVEL,7,97,7,0,7,0,58,0,58,33
ANDHRA PRADESH,KADAPA,OTHERS,10.0-20.0,13,GOPAVARAM,9,111,56,56,112,0,0,0,0,0
ANDHRA PRADESH,KADAPA,OTHERS,10.0-20.0,14,KHAJIPET,2,21,17,4,21,0,0,0,0,0
ANDHRA PRADESH,KADAPA,OTHERS,10.0-20.0,15,CHAPAD,4,48,46,0,46,0,0,0,0,3
ANDHRA PRADESH,KADAPA,OTHERS,10.0-20.0,16,PRODDATUR,21,252,252,0,252,0,0,0,0,0
ANDHRA PRADESH,KADAPA,OTHERS,10.0-20.0,17,JAMMALAMADUGU,32,399,399,0,399,0,0,0,0,0
ANDHRA PRADESH,KADAPA,OTHERS,10.0-20.0,18,MUDDANUR,17,192,41,150,191,0,0,0,0,0
ANDHRA PRADESH,KADAPA,OTHERS,10.0-20.0,19,SIMHADRIPURAM,117,1374,1010,349,1359,0,9,0,9,5
ANDHRA PRADESH,KADAPA,OTHERS,10.0-20.0,20,LINGALA,6,70,70,0,70,0,0,0,0,0
ANDHRA PRADESH,KADAPA,OTHERS,10.0-20.0,21,PULIVENDLA,9,105,53,53,106,0,0,0,0,0
ANDHRA PRADESH,KADAPA,OTHERS,10.0-20.0,22,VEMULA,7,84,84,0,84,0,0,0,0,0
ANDHRA PRADESH,KADAPA,OTHERS,10.0-20.0,23,THONDUR,13,157,157,0,157,0,0,0,0,0
ANDHRA PRADESH,KADAPA,OTHERS,10.0-20.0,24,VEERAPUNAYUNIPALLE,17,210,133,77,210,0,0,0,0,0
ANDHRA PRADESH,KADAPA,OTHERS,10.0-20.0,25,YERRAGUNTLA,34,428,363,65,428,0,0,0,0,0
ANDHRA PRADESH,KADAPA,OTHERS,10.0-20.0,26,KAMALAPURAM,16,198,101,97,198,0,0,0,0,0
ANDHRA PRADESH,KADAPA,OTHERS,10.0-20.0,27,VALLUR,2,23,12,12,24,0,0,0,0,0
ANDHRA PRADESH,KADAPA,OTHERS,10.0-20.0,28,CHENNUR,7,81,3,0,3,0,50,0,50,28
ANDHRA PRADESH,KADAPA,OTHERS,10.0-20.0,29,ATLUR,1,13,7,7,14,0,0,0,0,0
ANDHRA PRADESH,KADAPA,OTHERS,10.0-20.0,30,VONTIMITTA,5,65,33,33,66,0,0,0,0,0
ANDHRA PRADESH,KADAPA,OTHERS,10.0-20.0,31,SIDHOUT,1,13,7,7,14,0,0,0,0,0
ANDHRA PRADESH,KADAPA,OTHERS,10.0-20.0,32,CUDDAPAH,5,72,52,20,72,0,0,0,0,0
ANDHRA PRADESH,KADAPA,OTHERS,10.0-20.0,33,CHINTHAKOMMADINNE,7,97,97,0,97,0,0,0,0,0
ANDHRA PRADESH,KADAPA,OTHERS,10.0-20.0,34,PENDLIMARRI,3,38,19,19,38,0,0,0,0,0
ANDHRA PRADESH,KADAPA,OTHERS,10.0-20.0,35,VEMPALLE,6,83,31,52,83,0,0,0,0,0
ANDHRA PRADESH,KADAPA,OTHERS,10.0-20.0,36,CHAKRAYAPET,19,227,227,0,227,0,0,0,0,0
ANDHRA PRADESH,KADAPA,OTHERS,10.0-20.0,37,GALIVEEDU,27,342,126,206,332,0,6,0,6,4
ANDHRA PRADESH,KADAPA,OTHERS,10.0-20.0,38,CHINNAMANDEM,7,81,57,11,68,0,8,0,8,5
ANDHRA PRADESH,KADAPA,OTHERS,10.0-20.0,39,SAMBEPALLE,18,237,195,11,206,0,20,0,20,11
ANDHRA PRADESH,KADAPA,OTHERS,10.0-20.0,40,T SUNDUPALLE,15,183,91,91,182,0,0,0,0,0
ANDHRA PRADESH,KADAPA,OTHERS,10.0-20.0,41,RAYACHOTI,11,147,25,42,67,0,51,0,51,29
ANDHRA PRADESH,KADAPA,OTHERS,10.0-20.0,42,LAKKIREDDIPALLE,21,257,129,129,258,0,0,0,0,0
ANDHRA PRADESH,KADAPA,OTHERS,10.0-20.0,43,RAMAPURAM,8,100,50,50,100,0,0,0,0,0
ANDHRA PRADESH,KADAPA,OTHERS,10.0-20.0,44,VEERABALLE,11,138,109,29,138,0,0,0,0,0
ANDHRA PRADESH,KADAPA,OTHERS,10.0-20.0,45,NANDALUR,2,30,12,15,27,0,1,0,1,1
ANDHRA PRADESH,KADAPA,OTHERS,10.0-20.0,46,PENAGALUR,1,10,4,3,7,0,2,0,2,1
ANDHRA PRADESH,KADAPA,OTHERS,10.0-20.0,47,CHITVEL,11,148,74,74,148,0,0,0,0,0
ANDHRA PRADESH,KADAPA,OTHERS,10.0-20.0,48,RAJAMPET,9,121,29,29,58,29,0,18,47,16
ANDHRA PRADESH,KADAPA,OTHERS,10.0-20.0,49,PULLAMPETA,4,43,12,6,18,0,16,0,16,9
ANDHRA PRADESH,KADAPA,OTHERS,10.0-20.0,50,OBULAVARIPALLE,7,86,43,43,86,0,0,0,0,0
ANDHRA PRADESH,KADAPA,OTHERS,10.0-20.0,51,KODUR,26,336,336,0,336,0,0,0,0,0
ANDHRA PRADESH,KADAPA,SCHEDULED TRIBES,10.0-20.0,1,KONDAPURAM,0,0,0,0,0,0,0,0,0,0
ANDHRA PRADESH,KADAPA,SCHEDULED TRIBES,10.0-20.0,2,MYLAVARAM,0,0,0,0,0,0,0,0,0,0
ANDHRA PRADESH,KADAPA,SCHEDULED TRIBES,10.0-20.0,3,PEDDAMUDIUM,0,0,0,0,0,0,0,0,0,0
ANDHRA PRADESH,KADAPA,SCHEDULED TRIBES,10.0-20.0,4,RAJUPALEM,0,0,0,0,0,0,0,0,0,0
ANDHRA PRADESH,KADAPA,SCHEDULED TRIBES,10.0-20.0,5,DUVVUR,0,0,0,0,0,0,0,0,0,0
ANDHRA PRADESH,KADAPA,SCHEDULED TRIBES,10.0-20.0,6,S.MYDUKUR,0,0,0,0,0,0,0,0,0,0
ANDHRA PRADESH,KADAPA,SCHEDULED TRIBES,10.0-20.0,7,BRAHMAMGARIMATTAM,0,0,0,0,0,0,0,0,0,0
ANDHRA PRADESH,KADAPA,SCHEDULED TRIBES,10.0-20.0,8,SRI AVADHUTHA KASINAYANA,0,0,0,0,0,0,0,0,0,0
ANDHRA PRADESH,KADAPA,SCHEDULED TRIBES,10.0-20.0,9,KALASAPADU,0,0,0,0,0,0,0,0,0,0
ANDHRA PRADESH,KADAPA,SCHEDULED TRIBES,10.0-20.0,10,PORUMAMILLA,0,0,0,0,0,0,0,0,0,0
ANDHRA PRADESH,KADAPA,SCHEDULED TRIBES,10.0-20.0,11,B.KODUR,0,0,0,0,0,0,0,0,0,0
ANDHRA PRADESH,KADAPA,SCHEDULED TRIBES,10.0-20.0,12,BADVEL,0,0,0,0,0,0,0,0,0,0
ANDHRA PRADESH,KADAPA,SCHEDULED TRIBES,10.0-20.0,13,GOPAVARAM,0,0,0,0,0,0,0,0,0,0
ANDHRA PRADESH,KADAPA,SCHEDULED TRIBES,10.0-20.0,14,KHAJIPET,0,0,0,0,0,0,0,0,0,0
ANDHRA PRADESH,KADAPA,SCHEDULED TRIBES,10.0-20.0,15,CHAPAD,0,0,0,0,0,0,0,0,0,0
ANDHRA PRADESH,KADAPA,SCHEDULED TRIBES,10.0-20.0,16,PRODDATUR,0,0,0,0,0,0,0,0,0,0
ANDHRA PRADESH,KADAPA,SCHEDULED TRIBES,10.0-20.0,17,JAMMALAMADUGU,0,0,0,0,0,0,0,0,0,0
ANDHRA PRADESH,KADAPA,SCHEDULED TRIBES,10.0-20.0,18,MUDDANUR,0,0,0,0,0,0,0,0,0,0
ANDHRA PRADESH,KADAPA,SCHEDULED TRIBES,10.0-20.0,19,SIMHADRIPURAM,2,20,10,10,20,0,0,0,0,0
ANDHRA PRADESH,KADAPA,SCHEDULED TRIBES,10.0-20.0,20,LINGALA,0,0,0,0,0,0,0,0,0,0
ANDHRA PRADESH,KADAPA,SCHEDULED TRIBES,10.0-20.0,21,PULIVENDLA,0,0,0,0,0,0,0,0,0,0
ANDHRA PRADESH,KADAPA,SCHEDULED TRIBES,10.0-20.0,22,VEMULA,0,0,0,0,0,0,0,0,0,0
ANDHRA PRADESH,KADAPA,SCHEDULED TRIBES,10.0-20.0,23,THONDUR,0,0,0,0,0,0,0,0,0,0
ANDHRA PRADESH,KADAPA,SCHEDULED TRIBES,10.0-20.0,24,VEERAPUNAYUNIPALLE,0,0,0,0,0,0,0,0,0,0
ANDHRA PRADESH,KADAPA,SCHEDULED TRIBES,10.0-20.0,25,YERRAGUNTLA,0,0,0,0,0,0,0,0,0,0
ANDHRA PRADESH,KADAPA,SCHEDULED TRIBES,10.0-20.0,26,KAMALAPURAM,0,0,0,0,0,0,0,0,0,0
ANDHRA PRADESH,KADAPA,SCHEDULED TRIBES,10.0-20.0,27,VALLUR,0,0,0,0,0,0,0,0,0,0
ANDHRA PRADESH,KADAPA,SCHEDULED TRIBES,10.0-20.0,28,CHENNUR,0,0,0,0,0,0,0,0,0,0
ANDHRA PRADESH,KADAPA,SCHEDULED TRIBES,10.0-20.0,29,ATLUR,0,0,0,0,0,0,0,0,0,0
ANDHRA PRADESH,KADAPA,SCHEDULED TRIBES,10.0-20.0,30,VONTIMITTA,0,0,0,0,0,0,0,0,0,0
ANDHRA PRADESH,KADAPA,SCHEDULED TRIBES,10.0-20.0,31,SIDHOUT,0,0,0,0,0,0,0,0,0,0
ANDHRA PRADESH,KADAPA,SCHEDULED TRIBES,10.0-20.0,32,CUDDAPAH,0,0,0,0,0,0,0,0,0,0
ANDHRA PRADESH,KADAPA,SCHEDULED TRIBES,10.0-20.0,33,CHINTHAKOMMADINNE,0,0,0,0,0,0,0,0,0,0
ANDHRA PRADESH,KADAPA,SCHEDULED TRIBES,10.0-20.0,34,PENDLIMARRI,0,0,0,0,0,0,0,0,0,0
ANDHRA PRADESH,KADAPA,SCHEDULED TRIBES,10.0-20.0,35,VEMPALLE,0,0,0,0,0,0,0,0,0,0
ANDHRA PRADESH,KADAPA,SCHEDULED TRIBES,10.0-20.0,36,CHAKRAYAPET,0,0,0,0,0,0,0,0,0,0
ANDHRA PRADESH,KADAPA,SCHEDULED TRIBES,10.0-20.0,37,GALIVEEDU,0,0,0,0,0,0,0,0,0,0
ANDHRA PRADESH,KADAPA,SCHEDULED TRIBES,10.0-20.0,38,CHINNAMANDEM,0,0,0,0,0,0,0,0,0,0
ANDHRA PRADESH,KADAPA,SCHEDULED TRIBES,10.0-20.0,39,SAMBEPALLE,0,0,0,0,0,0,0,0,0,0
ANDHRA PRADESH,KADAPA,SCHEDULED TRIBES,10.0-20.0,40,T SUNDUPALLE,0,0,0,0,0,0,0,0,0,0
ANDHRA PRADESH,KADAPA,SCHEDULED TRIBES,10.0-20.0,41,RAYACHOTI,0,0,0,0,0,0,0,0,0,0
ANDHRA PRADESH,KADAPA,SCHEDULED TRIBES,10.0-20.0,42,LAKKIREDDIPALLE,1,15,7,7,14,0,0,0,0,0
ANDHRA PRADESH,KADAPA,SCHEDULED TRIBES,10.0-20.0,43,RAMAPURAM,1,11,5,5,10,0,0,0,0,0
ANDHRA PRADESH,KADAPA,SCHEDULED TRIBES,10.0-20.0,44,VEERABALLE,0,0,0,0,0,0,0,0,0,0
ANDHRA PRADESH,KADAPA,SCHEDULED TRIBES,10.0-20.0,45,NANDALUR,0,0,0,0,0,0,0,0,0,0
ANDHRA PRADESH,KADAPA,SCHEDULED TRIBES,10.0-20.0,46,PENAGALUR,0,0,0,0,0,0,0,0,0,0
ANDHRA PRADESH,KADAPA,SCHEDULED TRIBES,10.0-20.0,47,CHITVEL,0,0,0,0,0,0,0,0,0,0
ANDHRA PRADESH,KADAPA,SCHEDULED TRIBES,10.0-20.0,48,RAJAMPET,0,0,0,0,0,0,0,0,0,0
ANDHRA PRADESH,KADAPA,SCHEDULED TRIBES,10.0-20.0,49,PULLAMPETA,0,0,0,0,0,0,0,0,0,0
ANDHRA PRADESH,KADAPA,SCHEDULED TRIBES,10.0-20.0,50,OBULAVARIPALLE,0,0,0,0,0,0,0,0,0,0
ANDHRA PRADESH,KADAPA,SCHEDULED TRIBES,10.0-20.0,51,KODUR,1,11,5,5,10,0,0,0,0,0
ANDHRA PRADESH,KADAPA,ALL SOCIAL GROUPS,10.0-20.0,1,KONDAPURAM,22,266,132,134,266,0,0,0,0,0
ANDHRA PRADESH,KADAPA,ALL SOCIAL GROUPS,10.0-20.0,2,MYLAVARAM,36,447,419,28,447,0,0,0,0,0
ANDHRA PRADESH,KADAPA,ALL SOCIAL GROUPS,10.0-20.0,3,PEDDAMUDIUM,122,1483,1060,356,1416,0,43,0,43,25
ANDHRA PRADESH,KADAPA,ALL SOCIAL GROUPS,10.0-20.0,4,RAJUPALEM,36,443,443,0,443,0,0,0,0,0
ANDHRA PRADESH,KADAPA,ALL SOCIAL GROUPS,10.0-20.0,5,DUVVUR,1,11,11,0,11,0,0,0,0,0
ANDHRA PRADESH,KADAPA,ALL SOCIAL GROUPS,10.0-20.0,6,S.MYDUKUR,6,74,37,37,74,0,0,0,0,0
ANDHRA PRADESH,KADAPA,ALL SOCIAL GROUPS,10.0-20.0,7,BRAHMAMGARIMATTAM,3,33,16,16,32,0,0,0,0,0
ANDHRA PRADESH,KADAPA,ALL SOCIAL GROUPS,10.0-20.0,8,SRI AVADHUTHA KASINAYANA,16,205,46,158,204,0,0,0,0,0
ANDHRA PRADESH,KADAPA,ALL SOCIAL GROUPS,10.0-20.0,9,KALASAPADU,1,11,5,5,10,0,0,0,0,0
ANDHRA PRADESH,KADAPA,ALL SOCIAL GROUPS,10.0-20.0,10,PORUMAMILLA,10,142,52,90,142,0,0,0,0,0
ANDHRA PRADESH,KADAPA,ALL SOCIAL GROUPS,10.0-20.0,11,B.KODUR,4,53,27,27,54,0,0,0,0,0
ANDHRA PRADESH,KADAPA,ALL SOCIAL GROUPS,10.0-20.0,12,BADVEL,8,110,13,6,19,0,58,0,58,33
ANDHRA PRADESH,KADAPA,ALL SOCIAL GROUPS,10.0-20.0,13,GOPAVARAM,10,122,61,61,122,0,0,0,0,0
ANDHRA PRADESH,KADAPA,ALL SOCIAL GROUPS,10.0-20.0,14,KHAJIPET,2,21,17,4,21,0,0,0,0,0
ANDHRA PRADESH,KADAPA,ALL SOCIAL GROUPS,10.0-20.0,15,CHAPAD,4,48,46,0,46,0,0,0,0,3
ANDHRA PRADESH,KADAPA,ALL SOCIAL GROUPS,10.0-20.0,16,PRODDATUR,22,270,268,2,270,0,0,0,0,0
ANDHRA PRADESH,KADAPA,ALL SOCIAL GROUPS,10.0-20.0,17,JAMMALAMADUGU,32,399,399,0,399,0,0,0,0,0
ANDHRA PRADESH,KADAPA,ALL SOCIAL GROUPS,10.0-20.0,18,MUDDANUR,17,192,41,150,191,0,0,0,0,0
ANDHRA PRADESH,KADAPA,ALL SOCIAL GROUPS,10.0-20.0,19,SIMHADRIPURAM,130,1523,1117,392,1509,0,9,0,9,5
ANDHRA PRADESH,KADAPA,ALL SOCIAL GROUPS,10.0-20.0,20,LINGALA,6,70,70,0,70,0,0,0,0,0
ANDHRA PRADESH,KADAPA,ALL SOCIAL GROUPS,10.0-20.0,21,PULIVENDLA,9,105,53,53,106,0,0,0,0,0
ANDHRA PRADESH,KADAPA,ALL SOCIAL GROUPS,10.0-20.0,22,VEMULA,7,84,84,0,84,0,0,0,0,0
ANDHRA PRADESH,KADAPA,ALL SOCIAL GROUPS,10.0-20.0,23,THONDUR,13,157,157,0,157,0,0,0,0,0
ANDHRA PRADESH,KADAPA,ALL SOCIAL GROUPS,10.0-20.0,24,VEERAPUNAYUNIPALLE,17,210,133,77,210,0,0,0,0,0
ANDHRA PRADESH,KADAPA,ALL SOCIAL GROUPS,10.0-20.0,25,YERRAGUNTLA,34,428,363,65,428,0,0,0,0,0
ANDHRA PRADESH,KADAPA,ALL SOCIAL GROUPS,10.0-20.0,26,KAMALAPURAM,16,198,101,97,198,0,0,0,0,0
ANDHRA PRADESH,KADAPA,ALL SOCIAL GROUPS,10.0-20.0,27,VALLUR,2,23,12,12,24,0,0,0,0,0
ANDHRA PRADESH,KADAPA,ALL SOCIAL GROUPS,10.0-20.0,28,CHENNUR,7,81,3,0,3,0,50,0,50,28
ANDHRA PRADESH,KADAPA,ALL SOCIAL GROUPS,10.0-20.0,29,ATLUR,1,13,7,7,14,0,0,0,0,0
ANDHRA PRADESH,KADAPA,ALL SOCIAL GROUPS,10.0-20.0,30,VONTIMITTA,5,65,33,33,66,0,0,0,0,0
ANDHRA PRADESH,KADAPA,ALL SOCIAL GROUPS,10.0-20.0,31,SIDHOUT,1,13,7,7,14,0,0,0,0,0
ANDHRA PRADESH,KADAPA,ALL SOCIAL GROUPS,10.0-20.0,32,CUDDAPAH,5,72,52,20,72,0,0,0,0,0
ANDHRA PRADESH,KADAPA,ALL SOCIAL GROUPS,10.0-20.0,33,CHINTHAKOMMADINNE,7,97,97,0,97,0,0,0,0,0
ANDHRA PRADESH,KADAPA,ALL SOCIAL GROUPS,10.0-20.0,34,PENDLIMARRI,3,38,19,19,38,0,0,0,0,0
ANDHRA PRADESH,KADAPA,ALL SOCIAL GROUPS,10.0-20.0,35,VEMPALLE,6,83,31,52,83,0,0,0,0,0
ANDHRA PRADESH,KADAPA,ALL SOCIAL GROUPS,10.0-20.0,36,CHAKRAYAPET,19,227,227,0,227,0,0,0,0,0
ANDHRA PRADESH,KADAPA,ALL SOCIAL GROUPS,10.0-20.0,37,GALIVEEDU,27,342,126,206,332,0,6,0,6,4
ANDHRA PRADESH,KADAPA,ALL SOCIAL GROUPS,10.0-20.0,38,CHINNAMANDEM,7,81,57,11,68,0,8,0,8,5
ANDHRA PRADESH,KADAPA,ALL SOCIAL GROUPS,10.0-20.0,39,SAMBEPALLE,18,237,195,11,206,0,20,0,20,11
ANDHRA PRADESH,KADAPA,ALL SOCIAL GROUPS,10.0-20.0,40,T SUNDUPALLE,16,197,99,99,198,0,0,0,0,0
ANDHRA PRADESH,KADAPA,ALL SOCIAL GROUPS,10.0-20.0,41,RAYACHOTI,11,147,25,42,67,0,51,0,51,29
ANDHRA PRADESH,KADAPA,ALL SOCIAL GROUPS,10.0-20.0,42,LAKKIREDDIPALLE,23,289,144,144,288,0,0,0,0,0
ANDHRA PRADESH,KADAPA,ALL SOCIAL GROUPS,10.0-20.0,43,RAMAPURAM,9,111,55,55,110,0,0,0,0,0
ANDHRA PRADESH,KADAPA,ALL SOCIAL GROUPS,10.0-20.0,44,VEERABALLE,11,138,109,29,138,0,0,0,0,0
ANDHRA PRADESH,KADAPA,ALL SOCIAL GROUPS,10.0-20.0,45,NANDALUR,2,30,12,15,27,0,1,0,1,1
ANDHRA PRADESH,KADAPA,ALL SOCIAL GROUPS,10.0-20.0,46,PENAGALUR,1,10,4,3,7,0,2,0,2,1
ANDHRA PRADESH,KADAPA,ALL SOCIAL GROUPS,10.0-20.0,47,CHITVEL,11,148,74,74,148,0,0,0,0,0
ANDHRA PRADESH,KADAPA,ALL SOCIAL GROUPS,10.0-20.0,48,RAJAMPET,9,121,29,29,58,29,0,18,47,16
ANDHRA PRADESH,KADAPA,ALL SOCIAL GROUPS,10.0-20.0,49,PULLAMPETA,4,43,12,6,18,0,16,0,16,9
ANDHRA PRADESH,KADAPA,ALL SOCIAL GROUPS,10.0-20.0,50,OBULAVARIPALLE,7,86,43,43,86,0,0,0,0,0
ANDHRA PRADESH,KADAPA,ALL SOCIAL GROUPS,10.0-20.0,51,KODUR,27,346,341,5,346,0,0,0,0,0
ANDHRA PRADESH,KADAPA,INSTITUTIONAL,7.5-10.0,1,KONDAPURAM,0,0,0,0,0,0,0,0,0,0
ANDHRA PRADESH,KADAPA,INSTITUTIONAL,7.5-10.0,2,MYLAVARAM,0,0,0,0,0,0,0,0,0,0
ANDHRA PRADESH,KADAPA,INSTITUTIONAL,7.5-10.0,3,PEDDAMUDIUM,0,0,0,0,0,0,0,0,0,0
ANDHRA PRADESH,KADAPA,INSTITUTIONAL,7.5-10.0,4,RAJUPALEM,0,0,0,0,0,0,0,0,0,0
ANDHRA PRADESH,KADAPA,INSTITUTIONAL,7.5-10.0,5,DUVVUR,0,0,0,0,0,0,0,0,0,0
ANDHRA PRADESH,KADAPA,INSTITUTIONAL,7.5-10.0,6,S.MYDUKUR,0,0,0,0,0,0,0,0,0,0
ANDHRA PRADESH,KADAPA,INSTITUTIONAL,7.5-10.0,7,BRAHMAMGARIMATTAM,0,0,0,0,0,0,0,0,0,0
ANDHRA PRADESH,KADAPA,INSTITUTIONAL,7.5-10.0,8,SRI AVADHUTHA KASINAYANA,0,0,0,0,0,0,0,0,0,0
ANDHRA PRADESH,KADAPA,INSTITUTIONAL,7.5-10.0,9,KALASAPADU,0,0,0,0,0,0,0,0,0,0
ANDHRA PRADESH,KADAPA,INSTITUTIONAL,7.5-10.0,10,PORUMAMILLA,0,0,0,0,0,0,0,0,0,0
ANDHRA PRADESH,KADAPA,INSTITUTIONAL,7.5-10.0,11,B.KODUR,0,0,0,0,0,0,0,0,0,0
ANDHRA PRADESH,KADAPA,INSTITUTIONAL,7.5-10.0,12,BADVEL,0,0,0,0,0,0,0,0,0,0
ANDHRA PRADESH,KADAPA,INSTITUTIONAL,7.5-10.0,13,GOPAVARAM,0,0,0,0,0,0,0,0,0,0
ANDHRA PRADESH,KADAPA,INSTITUTIONAL,7.5-10.0,14,KHAJIPET,0,0,0,0,0,0,0,0,0,0
ANDHRA PRADESH,KADAPA,INSTITUTIONAL,7.5-10.0,15,CHAPAD,0,0,0,0,0,0,0,0,0,0
ANDHRA PRADESH,KADAPA,INSTITUTIONAL,7.5-10.0,16,PRODDATUR,0,0,0,0,0,0,0,0,0,0
ANDHRA PRADESH,KADAPA,INSTITUTIONAL,7.5-10.0,17,JAMMALAMADUGU,0,0,0,0,0,0,0,0,0,0
ANDHRA PRADESH,KADAPA,INSTITUTIONAL,7.5-10.0,18,MUDDANUR,0,0,0,0,0,0,0,0,0,0
ANDHRA PRADESH,KADAPA,INSTITUTIONAL,7.5-10.0,19,SIMHADRIPURAM,0,0,0,0,0,0,0,0,0,0
ANDHRA PRADESH,KADAPA,INSTITUTIONAL,7.5-10.0,20,LINGALA,0,0,0,0,0,0,0,0,0,0
ANDHRA PRADESH,KADAPA,INSTITUTIONAL,7.5-10.0,21,PULIVENDLA,0,0,0,0,0,0,0,0,0,0
ANDHRA PRADESH,KADAPA,INSTITUTIONAL,7.5-10.0,22,VEMULA,0,0,0,0,0,0,0,0,0,0
ANDHRA PRADESH,KADAPA,INSTITUTIONAL,7.5-10.0,23,THONDUR,0,0,0,0,0,0,0,0,0,0
ANDHRA PRADESH,KADAPA,INSTITUTIONAL,7.5-10.0,24,VEERAPUNAYUNIPALLE,0,0,0,0,0,0,0,0,0,0
ANDHRA PRADESH,KADAPA,INSTITUTIONAL,7.5-10.0,25,YERRAGUNTLA,0,0,0,0,0,0,0,0,0,0
ANDHRA PRADESH,KADAPA,INSTITUTIONAL,7.5-10.0,26,KAMALAPURAM,0,0,0,0,0,0,0,0,0,0
ANDHRA PRADESH,KADAPA,INSTITUTIONAL,7.5-10.0,27,VALLUR,0,0,0,0,0,0,0,0,0,0
ANDHRA PRADESH,KADAPA,INSTITUTIONAL,7.5-10.0,28,CHENNUR,0,0,0,0,0,0,0,0,0,0
ANDHRA PRADESH,KADAPA,INSTITUTIONAL,7.5-10.0,29,ATLUR,0,0,0,0,0,0,0,0,0,0
ANDHRA PRADESH,KADAPA,INSTITUTIONAL,7.5-10.0,30,VONTIMITTA,0,0,0,0,0,0,0,0,0,0
ANDHRA PRADESH,KADAPA,INSTITUTIONAL,7.5-10.0,31,SIDHOUT,0,0,0,0,0,0,0,0,0,0
ANDHRA PRADESH,KADAPA,INSTITUTIONAL,7.5-10.0,32,CUDDAPAH,0,0,0,0,0,0,0,0,0,0
ANDHRA PRADESH,KADAPA,INSTITUTIONAL,7.5-10.0,33,CHINTHAKOMMADINNE,0,0,0,0,0,0,0,0,0,0
ANDHRA PRADESH,KADAPA,INSTITUTIONAL,7.5-10.0,34,PENDLIMARRI,0,0,0,0,0,0,0,0,0,0
ANDHRA PRADESH,KADAPA,INSTITUTIONAL,7.5-10.0,35,VEMPALLE,0,0,0,0,0,0,0,0,0,0
ANDHRA PRADESH,KADAPA,INSTITUTIONAL,7.5-10.0,36,CHAKRAYAPET,0,0,0,0,0,0,0,0,0,0
ANDHRA PRADESH,KADAPA,INSTITUTIONAL,7.5-10.0,37,GALIVEEDU,0,0,0,0,0,0,0,0,0,0
ANDHRA PRADESH,KADAPA,INSTITUTIONAL,7.5-10.0,38,CHINNAMANDEM,0,0,0,0,0,0,0,0,0,0
ANDHRA PRADESH,KADAPA,INSTITUTIONAL,7.5-10.0,39,SAMBEPALLE,0,0,0,0,0,0,0,0,0,0
ANDHRA PRADESH,KADAPA,INSTITUTIONAL,7.5-10.0,40,T SUNDUPALLE,0,0,0,0,0,0,0,0,0,0
ANDHRA PRADESH,KADAPA,INSTITUTIONAL,7.5-10.0,41,RAYACHOTI,0,0,0,0,0,0,0,0,0,0
ANDHRA PRADESH,KADAPA,INSTITUTIONAL,7.5-10.0,42,LAKKIREDDIPALLE,0,0,0,0,0,0,0,0,0,0
ANDHRA PRADESH,KADAPA,INSTITUTIONAL,7.5-10.0,43,RAMAPURAM,0,0,0,0,0,0,0,0,0,0
ANDHRA PRADESH,KADAPA,INSTITUTIONAL,7.5-10.0,44,VEERABALLE,0,0,0,0,0,0,0,0,0,0
ANDHRA PRADESH,KADAPA,INSTITUTIONAL,7.5-10.0,45,NANDALUR,0,0,0,0,0,0,0,0,0,0
ANDHRA PRADESH,KADAPA,INSTITUTIONAL,7.5-10.0,46,PENAGALUR,0,0,0,0,0,0,0,0,0,0
ANDHRA PRADESH,KADAPA,INSTITUTIONAL,7.5-10.0,47,CHITVEL,0,0,0,0,0,0,0,0,0,0
ANDHRA PRADESH,KADAPA,INSTITUTIONAL,7.5-10.0,48,RAJAMPET,0,0,0,0,0,0,0,0,0,0
ANDHRA PRADESH,KADAPA,INSTITUTIONAL,7.5-10.0,49,PULLAMPETA,0,0,0,0,0,0,0,0,0,0
ANDHRA PRADESH,KADAPA,INSTITUTIONAL,7.5-10.0,50,OBULAVARIPALLE,0,0,0,0,0,0,0,0,0,0
ANDHRA PRADESH,KADAPA,INSTITUTIONAL,7.5-10.0,51,KODUR,0,0,0,0,0,0,0,0,0,0
ANDHRA PRADESH,KADAPA,SCHEDULED CASTE,7.5-10.0,1,KONDAPURAM,4,35,17,17,34,0,0,0,0,0
ANDHRA PRADESH,KADAPA,SCHEDULED CASTE,7.5-10.0,2,MYLAVARAM,1,8,4,4,8,0,0,0,0,0
ANDHRA PRADESH,KADAPA,SCHEDULED CASTE,7.5-10.0,3,PEDDAMUDIUM,0,0,0,0,0,0,0,0,0,0
ANDHRA PRADESH,KADAPA,SCHEDULED CASTE,7.5-10.0,4,RAJUPALEM,0,0,0,0,0,0,0,0,0,0
ANDHRA PRADESH,KADAPA,SCHEDULED CASTE,7.5-10.0,5,DUVVUR,0,0,0,0,0,0,0,0,0,0
ANDHRA PRADESH,KADAPA,SCHEDULED CASTE,7.5-10.0,6,S.MYDUKUR,1,10,0,10,10,0,0,0,0,0
ANDHRA PRADESH,KADAPA,SCHEDULED CASTE,7.5-10.0,7,BRAHMAMGARIMATTAM,0,0,0,0,0,0,0,0,0,0
ANDHRA PRADESH,KADAPA,SCHEDULED CASTE,7.5-10.0,8,SRI AVADHUTHA KASINAYANA,0,0,0,0,0,0,0,0,0,0
ANDHRA PRADESH,KADAPA,SCHEDULED CASTE,7.5-10.0,9,KALASAPADU,0,0,0,0,0,0,0,0,0,0
ANDHRA PRADESH,KADAPA,SCHEDULED CASTE,7.5-10.0,10,PORUMAMILLA,0,0,0,0,0,0,0,0,0,0
ANDHRA PRADESH,KADAPA,SCHEDULED CASTE,7.5-10.0,11,B.KODUR,0,0,0,0,0,0,0,0,0,0
ANDHRA PRADESH,KADAPA,SCHEDULED CASTE,7.5-10.0,12,BADVEL,1,9,4,4,8,0,0,0,0,0
ANDHRA PRADESH,KADAPA,SCHEDULED CASTE,7.5-10.0,13,GOPAVARAM,0,0,0,0,0,0,0,0,0,0
ANDHRA PRADESH,KADAPA,SCHEDULED CASTE,7.5-10.0,14,KHAJIPET,0,0,0,0,0,0,0,0,0,0
ANDHRA PRADESH,KADAPA,SCHEDULED CASTE,7.5-10.0,15,CHAPAD,0,0,0,0,0,0,0,0,0,0
ANDHRA PRADESH,KADAPA,SCHEDULED CASTE,7.5-10.0,16,PRODDATUR,0,0,0,0,0,0,0,0,0,0
ANDHRA PRADESH,KADAPA,SCHEDULED CASTE,7.5-10.0,17,JAMMALAMADUGU,0,0,0,0,0,0,0,0,0,0
ANDHRA PRADESH,KADAPA,SCHEDULED CASTE,7.5-10.0,18,MUDDANUR,1,8,8,0,8,0,0,0,0,0
ANDHRA PRADESH,KADAPA,SCHEDULED CASTE,7.5-10.0,19,SIMHADRIPURAM,1,10,5,5,10,0,0,0,0,0
ANDHRA PRADESH,KADAPA,SCHEDULED CASTE,7.5-10.0,20,LINGALA,0,0,0,0,0,0,0,0,0,0
ANDHRA PRADESH,KADAPA,SCHEDULED CASTE,7.5-10.0,21,PULIVENDLA,0,0,0,0,0,0,0,0,0,0
ANDHRA PRADESH,KADAPA,SCHEDULED CASTE,7.5-10.0,22,VEMULA,0,0,0,0,0,0,0,0,0,0
ANDHRA PRADESH,KADAPA,SCHEDULED CASTE,7.5-10.0,23,THONDUR,0,0,0,0,0,0,0,0,0,0
ANDHRA PRADESH,KADAPA,SCHEDULED CASTE,7.5-10.0,24,VEERAPUNAYUNIPALLE,0,0,0,0,0,0,0,0,0,0
ANDHRA PRADESH,KADAPA,SCHEDULED CASTE,7.5-10.0,25,YERRAGUNTLA,0,0,0,0,0,0,0,0,0,0
ANDHRA PRADESH,KADAPA,SCHEDULED CASTE,7.5-10.0,26,KAMALAPURAM,0,0,0,0,0,0,0,0,0,0
ANDHRA PRADESH,KADAPA,SCHEDULED CASTE,7.5-10.0,27,VALLUR,0,0,0,0,0,0,0,0,0,0
ANDHRA PRADESH,KADAPA,SCHEDULED CASTE,7.5-10.0,28,CHENNUR,0,0,0,0,0,0,0,0,0,0
ANDHRA PRADESH,KADAPA,SCHEDULED CASTE,7.5-10.0,29,ATLUR,0,0,0,0,0,0,0,0,0,0
ANDHRA PRADESH,KADAPA,SCHEDULED CASTE,7.5-10.0,30,VONTIMITTA,0,0,0,0,0,0,0,0,0,0
ANDHRA PRADESH,KADAPA,SCHEDULED CASTE,7.5-10.0,31,SIDHOUT,0,0,0,0,0,0,0,0,0,0
ANDHRA PRADESH,KADAPA,SCHEDULED CASTE,7.5-10.0,32,CUDDAPAH,0,0,0,0,0,0,0,0,0,0
ANDHRA PRADESH,KADAPA,SCHEDULED CASTE,7.5-10.0,33,CHINTHAKOMMADINNE,0,0,0,0,0,0,0,0,0,0
ANDHRA PRADESH,KADAPA,SCHEDULED CASTE,7.5-10.0,34,PENDLIMARRI,0,0,0,0,0,0,0,0,0,0
ANDHRA PRADESH,KADAPA,SCHEDULED CASTE,7.5-10.0,35,VEMPALLE,0,0,0,0,0,0,0,0,0,0
ANDHRA PRADESH,KADAPA,SCHEDULED CASTE,7.5-10.0,36,CHAKRAYAPET,0,0,0,0,0,0,0,0,0,0
ANDHRA PRADESH,KADAPA,SCHEDULED CASTE,7.5-10.0,37,GALIVEEDU,0,0,0,0,0,0,0,0,0,0
ANDHRA PRADESH,KADAPA,SCHEDULED CASTE,7.5-10.0,38,CHINNAMANDEM,0,0,0,0,0,0,0,0,0,0
ANDHRA PRADESH,KADAPA,SCHEDULED CASTE,7.5-10.0,39,SAMBEPALLE,0,0,0,0,0,0,0,0,0,0
ANDHRA PRADESH,KADAPA,SCHEDULED CASTE,7.5-10.0,40,T SUNDUPALLE,0,0,0,0,0,0,0,0,0,0
ANDHRA PRADESH,KADAPA,SCHEDULED CASTE,7.5-10.0,41,RAYACHOTI,0,0,0,0,0,0,0,0,0,0
ANDHRA PRADESH,KADAPA,SCHEDULED CASTE,7.5-10.0,42,LAKKIREDDIPALLE,0,0,0,0,0,0,0,0,0,0
ANDHRA PRADESH,KADAPA,SCHEDULED CASTE,7.5-10.0,43,RAMAPURAM,0,0,0,0,0,0,0,0,0,0
ANDHRA PRADESH,KADAPA,SCHEDULED CASTE,7.5-10.0,44,VEERABALLE,1,9,4,4,8,0,0,0,0,0
ANDHRA PRADESH,KADAPA,SCHEDULED CASTE,7.5-10.0,45,NANDALUR,0,0,0,0,0,0,0,0,0,0
ANDHRA PRADESH,KADAPA,SCHEDULED CASTE,7.5-10.0,46,PENAGALUR,0,0,0,0,0,0,0,0,0,0
ANDHRA PRADESH,KADAPA,SCHEDULED CASTE,7.5-10.0,47,CHITVEL,0,0,0,0,0,0,0,0,0,0
ANDHRA PRADESH,KADAPA,SCHEDULED CASTE,7.5-10.0,48,RAJAMPET,0,0,0,0,0,0,0,0,0,0
ANDHRA PRADESH,KADAPA,SCHEDULED CASTE,7.5-10.0,49,PULLAMPETA,1,8,4,4,8,0,0,0,0,0
ANDHRA PRADESH,KADAPA,SCHEDULED CASTE,7.5-10.0,50,OBULAVARIPALLE,0,0,0,0,0,0,0,0,0,0
ANDHRA PRADESH,KADAPA,SCHEDULED CASTE,7.5-10.0,51,KODUR,0,0,0,0,0,0,0,0,0,0
ANDHRA PRADESH,KADAPA,OTHERS,7.5-10.0,1,KONDAPURAM,32,276,226,48,274,0,1,0,1,1
ANDHRA PRADESH,KADAPA,OTHERS,7.5-10.0,2,MYLAVARAM,57,482,482,0,482,0,0,0,0,0
ANDHRA PRADESH,KADAPA,OTHERS,7.5-10.0,3,PEDDAMUDIUM,245,2101,1896,201,2097,0,2,0,2,1
ANDHRA PRADESH,KADAPA,OTHERS,7.5-10.0,4,RAJUPALEM,91,771,771,0,771,0,0,0,0,0
ANDHRA PRADESH,KADAPA,OTHERS,7.5-10.0,5,DUVVUR,7,60,60,0,60,0,0,0,0,0
ANDHRA PRADESH,KADAPA,OTHERS,7.5-10.0,6,S.MYDUKUR,9,80,80,0,80,0,0,0,0,0
ANDHRA PRADESH,KADAPA,OTHERS,7.5-10.0,7,BRAHMAMGARIMATTAM,4,31,5,25,30,0,0,0,0,0
ANDHRA PRADESH,KADAPA,OTHERS,7.5-10.0,8,SRI AVADHUTHA KASINAYANA,20,174,8,165,173,0,0,0,0,0
ANDHRA PRADESH,KADAPA,OTHERS,7.5-10.0,9,KALASAPADU,2,18,9,9,18,0,0,0,0,0
ANDHRA PRADESH,KADAPA,OTHERS,7.5-10.0,10,PORUMAMILLA,10,88,42,46,88,0,0,0,0,0
ANDHRA PRADESH,KADAPA,OTHERS,7.5-10.0,11,B.KODUR,7,57,29,29,58,0,0,0,0,0
ANDHRA PRADESH,KADAPA,OTHERS,7.5-10.0,12,BADVEL,8,67,4,0,4,0,40,0,40,23
ANDHRA PRADESH,KADAPA,OTHERS,7.5-10.0,13,GOPAVARAM,12,103,52,52,104,0,0,0,0,0
ANDHRA PRADESH,KADAPA,OTHERS,7.5-10.0,14,KHAJIPET,5,41,21,21,42,0,0,0,0,0
ANDHRA PRADESH,KADAPA,OTHERS,7.5-10.0,15,CHAPAD,6,54,53,0,53,0,0,0,0,1
ANDHRA PRADESH,KADAPA,OTHERS,7.5-10.0,16,PRODDATUR,52,442,442,0,442,0,0,0,0,0
ANDHRA PRADESH,KADAPA,OTHERS,7.5-10.0,17,JAMMALAMADUGU,46,391,391,0,391,0,0,0,0,0
ANDHRA PRADESH,KADAPA,OTHERS,7.5-10.0,18,MUDDANUR,31,268,153,100,253,0,9,0,9,5
ANDHRA PRADESH,KADAPA,OTHERS,7.5-10.0,19,SIMHADRIPURAM,54,453,240,191,431,0,14,0,14,8
ANDHRA PRADESH,KADAPA,OTHERS,7.5-10.0,20,LINGALA,18,153,153,0,153,0,0,0,0,0
ANDHRA PRADESH,KADAPA,OTHERS,7.5-10.0,21,PULIVENDLA,14,124,62,62,124,0,0,0,0,0
ANDHRA PRADESH,KADAPA,OTHERS,7.5-10.0,22,VEMULA,9,75,38,38,76,0,0,0,0,0
ANDHRA PRADESH,KADAPA,OTHERS,7.5-10.0,23,THONDUR,22,188,188,0,188,0,0,0,0,0
ANDHRA PRADESH,KADAPA,OTHERS,7.5-10.0,24,VEERAPUNAYUNIPALLE,23,194,159,35,194,0,0,0,0,0
ANDHRA PRADESH,KADAPA,OTHERS,7.5-10.0,25,YERRAGUNTLA,58,492,394,98,492,0,0,0,0,0
ANDHRA PRADESH,KADAPA,OTHERS,7.5-10.0,26,KAMALAPURAM,22,186,127,59,186,0,0,0,0,0
ANDHRA PRADESH,KADAPA,OTHERS,7.5-10.0,27,VALLUR,5,41,23,16,39,0,1,0,1,1
ANDHRA PRADESH,KADAPA,OTHERS,7.5-10.0,28,CHENNUR,8,64,52,11,63,0,0,0,0,0
ANDHRA PRADESH,KADAPA,OTHERS,7.5-10.0,29,ATLUR,2,18,9,9,18,0,0,0,0,0
ANDHRA PRADESH,KADAPA,OTHERS,7.5-10.0,30,VONTIMITTA,4,36,18,18,36,0,0,0,0,0
ANDHRA PRADESH,KADAPA,OTHERS,7.5-10.0,31,SIDHOUT,3,26,13,13,26,0,0,0,0,0
ANDHRA PRADESH,KADAPA,OTHERS,7.5-10.0,32,CUDDAPAH,5,43,29,14,43,0,0,0,0,0
ANDHRA PRADESH,KADAPA,OTHERS,7.5-10.0,33,CHINTHAKOMMADINNE,13,110,110,0,110,0,0,0,0,0
ANDHRA PRADESH,KADAPA,OTHERS,7.5-10.0,34,PENDLIMARRI,16,136,136,0,136,0,0,0,0,0
ANDHRA PRADESH,KADAPA,OTHERS,7.5-10.0,35,VEMPALLE,9,74,37,37,74,0,0,0,0,0
ANDHRA PRADESH,KADAPA,OTHERS,7.5-10.0,36,CHAKRAYAPET,16,135,96,39,135,0,0,0,0,0
ANDHRA PRADESH,KADAPA,OTHERS,7.5-10.0,37,GALIVEEDU,43,362,297,62,359,0,1,0,1,2
ANDHRA PRADESH,KADAPA,OTHERS,7.5-10.0,38,CHINNAMANDEM,7,56,54,0,54,0,1,0,1,1
ANDHRA PRADESH,KADAPA,OTHERS,7.5-10.0,39,SAMBEPALLE,21,176,142,11,153,0,15,0,15,9
ANDHRA PRADESH,KADAPA,OTHERS,7.5-10.0,40,T SUNDUPALLE,10,83,64,18,82,0,0,0,0,0
ANDHRA PRADESH,KADAPA,OTHERS,7.5-10.0,41,RAYACHOTI,12,102,27,75,102,0,0,0,0,0
ANDHRA PRADESH,KADAPA,OTHERS,7.5-10.0,42,LAKKIREDDIPALLE,34,289,144,145,289,0,0,0,0,0
ANDHRA PRADESH,KADAPA,OTHERS,7.5-10.0,43,RAMAPURAM,14,117,75,31,106,0,7,0,7,4
ANDHRA PRADESH,KADAPA,OTHERS,7.5-10.0,44,VEERABALLE,13,106,70,35,105,0,0,0,0,1
ANDHRA PRADESH,KADAPA,OTHERS,7.5-10.0,45,NANDALUR,4,32,9,18,27,0,3,1,4,1
ANDHRA PRADESH,KADAPA,OTHERS,7.5-10.0,46,PENAGALUR,0,0,0,0,0,0,0,0,0,0
ANDHRA PRADESH,KADAPA,OTHERS,7.5-10.0,47,CHITVEL,3,26,13,13,26,0,0,0,0,0
ANDHRA PRADESH,KADAPA,OTHERS,7.5-10.0,48,RAJAMPET,13,111,56,36,92,6,4,5,15,4
ANDHRA PRADESH,KADAPA,OTHERS,7.5-10.0,49,PULLAMPETA,17,146,29,26,55,0,58,0,58,33
ANDHRA PRADESH,KADAPA,OTHERS,7.5-10.0,50,OBULAVARIPALLE,12,102,97,5,102,0,0,0,0,0
ANDHRA PRADESH,KADAPA,OTHERS,7.5-10.0,51,KODUR,21,180,119,61,180,0,0,0,0,0
ANDHRA PRADESH,KADAPA,SCHEDULED TRIBES,7.5-10.0,1,KONDAPURAM,0,0,0,0,0,0,0,0,0,0
ANDHRA PRADESH,KADAPA,SCHEDULED TRIBES,7.5-10.0,2,MYLAVARAM,0,0,0,0,0,0,0,0,0,0
ANDHRA PRADESH,KADAPA,SCHEDULED TRIBES,7.5-10.0,3,PEDDAMUDIUM,0,0,0,0,0,0,0,0,0,0
ANDHRA PRADESH,KADAPA,SCHEDULED TRIBES,7.5-10.0,4,RAJUPALEM,0,0,0,0,0,0,0,0,0,0
ANDHRA PRADESH,KADAPA,SCHEDULED TRIBES,7.5-10.0,5,DUVVUR,0,0,0,0,0,0,0,0,0,0
ANDHRA PRADESH,KADAPA,SCHEDULED TRIBES,7.5-10.0,6,S.MYDUKUR,0,0,0,0,0,0,0,0,0,0
ANDHRA PRADESH,KADAPA,SCHEDULED TRIBES,7.5-10.0,7,BRAHMAMGARIMATTAM,0,0,0,0,0,0,0,0,0,0
ANDHRA PRADESH,KADAPA,SCHEDULED TRIBES,7.5-10.0,8,SRI AVADHUTHA KASINAYANA,0,0,0,0,0,0,0,0,0,0
ANDHRA PRADESH,KADAPA,SCHEDULED TRIBES,7.5-10.0,9,KALASAPADU,0,0,0,0,0,0,0,0,0,0
ANDHRA PRADESH,KADAPA,SCHEDULED TRIBES,7.5-10.0,10,PORUMAMILLA,1,9,4,4,8,0,0,0,0,0
ANDHRA PRADESH,KADAPA,SCHEDULED TRIBES,7.5-10.0,11,B.KODUR,0,0,0,0,0,0,0,0,0,0
ANDHRA PRADESH,KADAPA,SCHEDULED TRIBES,7.5-10.0,12,BADVEL,0,0,0,0,0,0,0,0,0,0
ANDHRA PRADESH,KADAPA,SCHEDULED TRIBES,7.5-10.0,13,GOPAVARAM,0,0,0,0,0,0,0,0,0,0
ANDHRA PRADESH,KADAPA,SCHEDULED TRIBES,7.5-10.0,14,KHAJIPET,0,0,0,0,0,0,0,0,0,0
ANDHRA PRADESH,KADAPA,SCHEDULED TRIBES,7.5-10.0,15,CHAPAD,0,0,0,0,0,0,0,0,0,0
ANDHRA PRADESH,KADAPA,SCHEDULED TRIBES,7.5-10.0,16,PRODDATUR,0,0,0,0,0,0,0,0,0,0
ANDHRA PRADESH,KADAPA,SCHEDULED TRIBES,7.5-10.0,17,JAMMALAMADUGU,0,0,0,0,0,0,0,0,0,0
ANDHRA PRADESH,KADAPA,SCHEDULED TRIBES,7.5-10.0,18,MUDDANUR,0,0,0,0,0,0,0,0,0,0
ANDHRA PRADESH,KADAPA,SCHEDULED TRIBES,7.5-10.0,19,SIMHADRIPURAM,0,0,0,0,0,0,0,0,0,0
ANDHRA PRADESH,KADAPA,SCHEDULED TRIBES,7.5-10.0,20,LINGALA,0,0,0,0,0,0,0,0,0,0
ANDHRA PRADESH,KADAPA,SCHEDULED TRIBES,7.5-10.0,21,PULIVENDLA,0,0,0,0,0,0,0,0,0,0
ANDHRA PRADESH,KADAPA,SCHEDULED TRIBES,7.5-10.0,22,VEMULA,0,0,0,0,0,0,0,0,0,0
ANDHRA PRADESH,KADAPA,SCHEDULED TRIBES,7.5-10.0,23,THONDUR,0,0,0,0,0,0,0,0,0,0
ANDHRA PRADESH,KADAPA,SCHEDULED TRIBES,7.5-10.0,24,VEERAPUNAYUNIPALLE,0,0,0,0,0,0,0,0,0,0
ANDHRA PRADESH,KADAPA,SCHEDULED TRIBES,7.5-10.0,25,YERRAGUNTLA,0,0,0,0,0,0,0,0,0,0
ANDHRA PRADESH,KADAPA,SCHEDULED TRIBES,7.5-10.0,26,KAMALAPURAM,0,0,0,0,0,0,0,0,0,0
ANDHRA PRADESH,KADAPA,SCHEDULED TRIBES,7.5-10.0,27,VALLUR,0,0,0,0,0,0,0,0,0,0
ANDHRA PRADESH,KADAPA,SCHEDULED TRIBES,7.5-10.0,28,CHENNUR,0,0,0,0,0,0,0,0,0,0
ANDHRA PRADESH,KADAPA,SCHEDULED TRIBES,7.5-10.0,29,ATLUR,0,0,0,0,0,0,0,0,0,0
ANDHRA PRADESH,KADAPA,SCHEDULED TRIBES,7.5-10.0,30,VONTIMITTA,0,0,0,0,0,0,0,0,0,0
ANDHRA PRADESH,KADAPA,SCHEDULED TRIBES,7.5-10.0,31,SIDHOUT,0,0,0,0,0,0,0,0,0,0
ANDHRA PRADESH,KADAPA,SCHEDULED TRIBES,7.5-10.0,32,CUDDAPAH,0,0,0,0,0,0,0,0,0,0
ANDHRA PRADESH,KADAPA,SCHEDULED TRIBES,7.5-10.0,33,CHINTHAKOMMADINNE,0,0,0,0,0,0,0,0,0,0
ANDHRA PRADESH,KADAPA,SCHEDULED TRIBES,7.5-10.0,34,PENDLIMARRI,0,0,0,0,0,0,0,0,0,0
ANDHRA PRADESH,KADAPA,SCHEDULED TRIBES,7.5-10.0,35,VEMPALLE,0,0,0,0,0,0,0,0,0,0
ANDHRA PRADESH,KADAPA,SCHEDULED TRIBES,7.5-10.0,36,CHAKRAYAPET,0,0,0,0,0,0,0,0,0,0
ANDHRA PRADESH,KADAPA,SCHEDULED TRIBES,7.5-10.0,37,GALIVEEDU,0,0,0,0,0,0,0,0,0,0
ANDHRA PRADESH,KADAPA,SCHEDULED TRIBES,7.5-10.0,38,CHINNAMANDEM,1,8,8,0,8,0,0,0,0,0
ANDHRA PRADESH,KADAPA,SCHEDULED TRIBES,7.5-10.0,39,SAMBEPALLE,0,0,0,0,0,0,0,0,0,0
ANDHRA PRADESH,KADAPA,SCHEDULED TRIBES,7.5-10.0,40,T SUNDUPALLE,0,0,0,0,0,0,0,0,0,0
ANDHRA PRADESH,KADAPA,SCHEDULED TRIBES,7.5-10.0,41,RAYACHOTI,0,0,0,0,0,0,0,0,0,0
ANDHRA PRADESH,KADAPA,SCHEDULED TRIBES,7.5-10.0,42,LAKKIREDDIPALLE,0,0,0,0,0,0,0,0,0,0
ANDHRA PRADESH,KADAPA,SCHEDULED TRIBES,7.5-10.0,43,RAMAPURAM,1,8,4,4,8,0,0,0,0,0
ANDHRA PRADESH,KADAPA,SCHEDULED TRIBES,7.5-10.0,44,VEERABALLE,0,0,0,0,0,0,0,0,0,0
ANDHRA PRADESH,KADAPA,SCHEDULED TRIBES,7.5-10.0,45,NANDALUR,0,0,0,0,0,0,0,0,0,0
ANDHRA PRADESH,KADAPA,SCHEDULED TRIBES,7.5-10.0,46,PENAGALUR,0,0,0,0,0,0,0,0,0,0
ANDHRA PRADESH,KADAPA,SCHEDULED TRIBES,7.5-10.0,47,CHITVEL,0,0,0,0,0,0,0,0,0,0
ANDHRA PRADESH,KADAPA,SCHEDULED TRIBES,7.5-10.0,48,RAJAMPET,0,0,0,0,0,0,0,0,0,0
ANDHRA PRADESH,KADAPA,SCHEDULED TRIBES,7.5-10.0,49,PULLAMPETA,0,0,0,0,0,0,0,0,0,0
ANDHRA PRADESH,KADAPA,SCHEDULED TRIBES,7.5-10.0,50,OBULAVARIPALLE,0,0,0,0,0,0,0,0,0,0
ANDHRA PRADESH,KADAPA,SCHEDULED TRIBES,7.5-10.0,51,KODUR,0,0,0,0,0,0,0,0,0,0
ANDHRA PRADESH,KADAPA,ALL SOCIAL GROUPS,7.5-10.0,1,KONDAPURAM,36,310,243,65,308,0,1,0,1,1
ANDHRA PRADESH,KADAPA,ALL SOCIAL GROUPS,7.5-10.0,2,MYLAVARAM,58,490,486,4,490,0,0,0,0,0
ANDHRA PRADESH,KADAPA,ALL SOCIAL GROUPS,7.5-10.0,3,PEDDAMUDIUM,245,2101,1896,201,2097,0,2,0,2,1
ANDHRA PRADESH,KADAPA,ALL SOCIAL GROUPS,7.5-10.0,4,RAJUPALEM,91,771,771,0,771,0,0,0,0,0
ANDHRA PRADESH,KADAPA,ALL SOCIAL GROUPS,7.5-10.0,5,DUVVUR,7,60,60,0,60,0,0,0,0,0
ANDHRA PRADESH,KADAPA,ALL SOCIAL GROUPS,7.5-10.0,6,S.MYDUKUR,10,90,80,10,90,0,0,0,0,0
ANDHRA PRADESH,KADAPA,ALL SOCIAL GROUPS,7.5-10.0,7,BRAHMAMGARIMATTAM,4,31,5,25,30,0,0,0,0,0
ANDHRA PRADESH,KADAPA,ALL SOCIAL GROUPS,7.5-10.0,8,SRI AVADHUTHA KASINAYANA,20,174,8,165,173,0,0,0,0,0
ANDHRA PRADESH,KADAPA,ALL SOCIAL GROUPS,7.5-10.0,9,KALASAPADU,2,18,9,9,18,0,0,0,0,0
ANDHRA PRADESH,KADAPA,ALL SOCIAL GROUPS,7.5-10.0,10,PORUMAMILLA,11,97,47,50,97,0,0,0,0,0
ANDHRA PRADESH,KADAPA,ALL SOCIAL GROUPS,7.5-10.0,11,B.KODUR,7,57,29,29,58,0,0,0,0,0
ANDHRA PRADESH,KADAPA,ALL SOCIAL GROUPS,7.5-10.0,12,BADVEL,9,76,8,4,12,0,40,0,40,23
ANDHRA PRADESH,KADAPA,ALL SOCIAL GROUPS,7.5-10.0,13,GOPAVARAM,12,103,52,52,104,0,0,0,0,0
ANDHRA PRADESH,KADAPA,ALL SOCIAL GROUPS,7.5-10.0,14,KHAJIPET,5,41,21,21,42,0,0,0,0,0
ANDHRA PRADESH,KADAPA,ALL SOCIAL GROUPS,7.5-10.0,15,CHAPAD,6,54,53,0,53,0,0,0,0,1
ANDHRA PRADESH,KADAPA,ALL SOCIAL GROUPS,7.5-10.0,16,PRODDATUR,52,442,442,0,442,0,0,0,0,0
ANDHRA PRADESH,KADAPA,ALL SOCIAL GROUPS,7.5-10.0,17,JAMMALAMADUGU,46,391,391,0,391,0,0,0,0,0
ANDHRA PRADESH,KADAPA,ALL SOCIAL GROUPS,7.5-10.0,18,MUDDANUR,32,275,161,100,261,0,9,0,9,5
ANDHRA PRADESH,KADAPA,ALL SOCIAL GROUPS,7.5-10.0,19,SIMHADRIPURAM,55,462,245,195,440,0,14,0,14,8
ANDHRA PRADESH,KADAPA,ALL SOCIAL GROUPS,7.5-10.0,20,LINGALA,18,153,153,0,153,0,0,0,0,0
ANDHRA PRADESH,KADAPA,ALL SOCIAL GROUPS,7.5-10.0,21,PULIVENDLA,14,124,62,62,124,0,0,0,0,0
ANDHRA PRADESH,KADAPA,ALL SOCIAL GROUPS,7.5-10.0,22,VEMULA,9,75,38,38,76,0,0,0,0,0
ANDHRA PRADESH,KADAPA,ALL SOCIAL GROUPS,7.5-10.0,23,THONDUR,22,188,188,0,188,0,0,0,0,0
ANDHRA PRADESH,KADAPA,ALL SOCIAL GROUPS,7.5-10.0,24,VEERAPUNAYUNIPALLE,23,194,159,35,194,0,0,0,0,0
ANDHRA PRADESH,KADAPA,ALL SOCIAL GROUPS,7.5-10.0,25,YERRAGUNTLA,58,492,394,98,492,0,0,0,0,0
ANDHRA PRADESH,KADAPA,ALL SOCIAL GROUPS,7.5-10.0,26,KAMALAPURAM,22,186,127,59,186,0,0,0,0,0
ANDHRA PRADESH,KADAPA,ALL SOCIAL GROUPS,7.5-10.0,27,VALLUR,5,41,23,16,39,0,1,0,1,1
ANDHRA PRADESH,KADAPA,ALL SOCIAL GROUPS,7.5-10.0,28,CHENNUR,8,64,52,11,63,0,0,0,0,0
ANDHRA PRADESH,KADAPA,ALL SOCIAL GROUPS,7.5-10.0,29,ATLUR,2,18,9,9,18,0,0,0,0,0
ANDHRA PRADESH,KADAPA,ALL SOCIAL GROUPS,7.5-10.0,30,VONTIMITTA,4,36,18,18,36,0,0,0,0,0
ANDHRA PRADESH,KADAPA,ALL SOCIAL GROUPS,7.5-10.0,31,SIDHOUT,3,26,13,13,26,0,0,0,0,0
ANDHRA PRADESH,KADAPA,ALL SOCIAL GROUPS,7.5-10.0,32,CUDDAPAH,5,43,29,14,43,0,0,0,0,0
ANDHRA PRADESH,KADAPA,ALL SOCIAL GROUPS,7.5-10.0,33,CHINTHAKOMMADINNE,13,110,110,0,110,0,0,0,0,0
ANDHRA PRADESH,KADAPA,ALL SOCIAL GROUPS,7.5-10.0,34,PENDLIMARRI,16,136,136,0,136,0,0,0,0,0
ANDHRA PRADESH,KADAPA,ALL SOCIAL GROUPS,7.5-10.0,35,VEMPALLE,9,74,37,37,74,0,0,0,0,0
ANDHRA PRADESH,KADAPA,ALL SOCIAL GROUPS,7.5-10.0,36,CHAKRAYAPET,16,135,96,39,135,0,0,0,0,0
ANDHRA PRADESH,KADAPA,ALL SOCIAL GROUPS,7.5-10.0,37,GALIVEEDU,43,362,297,62,359,0,1,0,1,2
ANDHRA PRADESH,KADAPA,ALL SOCIAL GROUPS,7.5-10.0,38,CHINNAMANDEM,8,64,62,0,62,0,1,0,1,1
ANDHRA PRADESH,KADAPA,ALL SOCIAL GROUPS,7.5-10.0,39,SAMBEPALLE,21,176,142,11,153,0,15,0,15,9
ANDHRA PRADESH,KADAPA,ALL SOCIAL GROUPS,7.5-10.0,40,T SUNDUPALLE,10,83,64,18,82,0,0,0,0,0
ANDHRA PRADESH,KADAPA,ALL SOCIAL GROUPS,7.5-10.0,41,RAYACHOTI,12,102,27,75,102,0,0,0,0,0
ANDHRA PRADESH,KADAPA,ALL SOCIAL GROUPS,7.5-10.0,42,LAKKIREDDIPALLE,34,289,144,145,289,0,0,0,0,0
ANDHRA PRADESH,KADAPA,ALL SOCIAL GROUPS,7.5-10.0,43,RAMAPURAM,15,125,79,35,114,0,7,0,7,4
ANDHRA PRADESH,KADAPA,ALL SOCIAL GROUPS,7.5-10.0,44,VEERABALLE,14,115,75,40,115,0,0,0,0,1
ANDHRA PRADESH,KADAPA,ALL SOCIAL GROUPS,7.5-10.0,45,NANDALUR,4,32,9,18,27,0,3,1,4,1
ANDHRA PRADESH,KADAPA,ALL SOCIAL GROUPS,7.5-10.0,46,PENAGALUR,0,0,0,0,0,0,0,0,0,0
ANDHRA PRADESH,KADAPA,ALL SOCIAL GROUPS,7.5-10.0,47,CHITVEL,3,26,13,13,26,0,0,0,0,0
ANDHRA PRADESH,KADAPA,ALL SOCIAL GROUPS,7.5-10.0,48,RAJAMPET,13,111,56,36,92,6,4,5,15,4
ANDHRA PRADESH,KADAPA,ALL SOCIAL GROUPS,7.5-10.0,49,PULLAMPETA,18,153,33,29,62,0,58,0,58,33
ANDHRA PRADESH,KADAPA,ALL SOCIAL GROUPS,7.5-10.0,50,OBULAVARIPALLE,12,102,97,5,102,0,0,0,0,0
ANDHRA PRADESH,KADAPA,ALL SOCIAL GROUPS,7.5-10.0,51,KODUR,21,180,119,61,180,0,0,0,0,0
ANDHRA PRADESH,KURNOOL,INSTITUTIONAL,ALL CLASSES,1,MANTRALAYAM,0,0,0,0,0,0,0,0,0,0
ANDHRA PRADESH,KURNOOL,INSTITUTIONAL,ALL CLASSES,2,KOSIGI,0,0,0,0,0,0,0,0,0,0
ANDHRA PRADESH,KURNOOL,INSTITUTIONAL,ALL CLASSES,3,KOWTHALAM,0,0,0,0,0,0,0,0,0,0
ANDHRA PRADESH,KURNOOL,INSTITUTIONAL,ALL CLASSES,4,PEDDA KADUBUR,0,0,0,0,0,0,0,0,0,0
ANDHRA PRADESH,KURNOOL,INSTITUTIONAL,ALL CLASSES,5,YEMMIGANUR,6,581,290,291,581,0,0,0,0,0
ANDHRA PRADESH,KURNOOL,INSTITUTIONAL,ALL CLASSES,6,NANDAVARAM,0,0,0,0,0,0,0,0,0,0
ANDHRA PRADESH,KURNOOL,INSTITUTIONAL,ALL CLASSES,7,C.BELAGAL,0,0,0,0,0,0,0,0,0,0
ANDHRA PRADESH,KURNOOL,INSTITUTIONAL,ALL CLASSES,8,GUDUR,0,0,0,0,0,0,0,0,0,0
ANDHRA PRADESH,KURNOOL,INSTITUTIONAL,ALL CLASSES,9,KALLUR,0,0,0,0,0,0,0,0,0,0
ANDHRA PRADESH,KURNOOL,INSTITUTIONAL,ALL CLASSES,10,KURNOOL,3,112,112,0,112,0,0,0,0,0
ANDHRA PRADESH,KURNOOL,INSTITUTIONAL,ALL CLASSES,11,NANDIKOTKUR,14,134,53,82,135,0,0,0,0,0
ANDHRA PRADESH,KURNOOL,INSTITUTIONAL,ALL CLASSES,12,PAGIDYALA,0,0,0,0,0,0,0,0,0,0
ANDHRA PRADESH,KURNOOL,INSTITUTIONAL,ALL CLASSES,13,JUPADU BUNGALOW,3,515,257,258,515,0,0,0,0,0
ANDHRA PRADESH,KURNOOL,INSTITUTIONAL,ALL CLASSES,14,KOTHAPALLE,0,0,0,0,0,0,0,0,0,0
ANDHRA PRADESH,KURNOOL,INSTITUTIONAL,ALL CLASSES,15,ATMAKUR,0,0,0,0,0,0,0,0,0,0
ANDHRA PRADESH,KURNOOL,INSTITUTIONAL,ALL CLASSES,16,PAMULAPADU,0,0,0,0,0,0,0,0,0,0
ANDHRA PRADESH,KURNOOL,INSTITUTIONAL,ALL CLASSES,17,MIDTHUR,0,0,0,0,0,0,0,0,0,0
ANDHRA PRADESH,KURNOOL,INSTITUTIONAL,ALL CLASSES,18,ORVAKAL,5,45,25,20,45,0,0,0,0,0
ANDHRA PRADESH,KURNOOL,INSTITUTIONAL,ALL CLASSES,19,KODUMUR,0,0,0,0,0,0,0,0,0,0
ANDHRA PRADESH,KURNOOL,INSTITUTIONAL,ALL CLASSES,20,GONEGANDLA,0,0,0,0,0,0,0,0,0,0
ANDHRA PRADESH,KURNOOL,INSTITUTIONAL,ALL CLASSES,21,ADONI,0,0,0,0,0,0,0,0,0,0
ANDHRA PRADESH,KURNOOL,INSTITUTIONAL,ALL CLASSES,22,HOLAGUNDA,0,0,0,0,0,0,0,0,0,0
ANDHRA PRADESH,KURNOOL,INSTITUTIONAL,ALL CLASSES,23,HALAHARVI,0,0,0,0,0,0,0,0,0,0
ANDHRA PRADESH,KURNOOL,INSTITUTIONAL,ALL CLASSES,24,ALUR,0,0,0,0,0,0,0,0,0,0
ANDHRA PRADESH,KURNOOL,INSTITUTIONAL,ALL CLASSES,25,ASPARI,0,0,0,0,0,0,0,0,0,0
ANDHRA PRADESH,KURNOOL,INSTITUTIONAL,ALL CLASSES,26,DEVANAKONDA,0,0,0,0,0,0,0,0,0,0
ANDHRA PRADESH,KURNOOL,INSTITUTIONAL,ALL CLASSES,27,KRISHNAGIRI,0,0,0,0,0,0,0,0,0,0
ANDHRA PRADESH,KURNOOL,INSTITUTIONAL,ALL CLASSES,28,VELDURTHI,0,0,0,0,0,0,0,0,0,0
ANDHRA PRADESH,KURNOOL,INSTITUTIONAL,ALL CLASSES,29,BETHAMCHERLA,0,0,0,0,0,0,0,0,0,0
ANDHRA PRADESH,KURNOOL,INSTITUTIONAL,ALL CLASSES,30,PANYAM,19,148,101,47,148,0,0,0,0,0
ANDHRA PRADESH,KURNOOL,INSTITUTIONAL,ALL CLASSES,31,GADIVEMULA,0,0,0,0,0,0,0,0,0,0
ANDHRA PRADESH,KURNOOL,INSTITUTIONAL,ALL CLASSES,32,VELGODE,0,0,0,0,0,0,0,0,0,0
ANDHRA PRADESH,KURNOOL,INSTITUTIONAL,ALL CLASSES,33,BANDI ATMAKUR,0,0,0,0,0,0,0,0,0,0
ANDHRA PRADESH,KURNOOL,INSTITUTIONAL,ALL CLASSES,34,NANDYAL,3,83,41,42,83,0,0,0,0,0
ANDHRA PRADESH,KURNOOL,INSTITUTIONAL,ALL CLASSES,35,MAHANANDI,0,0,0,0,0,0,0,0,0,0
ANDHRA PRADESH,KURNOOL,INSTITUTIONAL,ALL CLASSES,36,SIRVEL,0,0,0,0,0,0,0,0,0,0
ANDHRA PRADESH,KURNOOL,INSTITUTIONAL,ALL CLASSES,37,GOSPADU,0,0,0,0,0,0,0,0,0,0
ANDHRA PRADESH,KURNOOL,INSTITUTIONAL,ALL CLASSES,38,BANAGANAPALLE,0,0,0,0,0,0,0,0,0,0
ANDHRA PRADESH,KURNOOL,INSTITUTIONAL,ALL CLASSES,39,DHONE,0,0,0,0,0,0,0,0,0,0
ANDHRA PRADESH,KURNOOL,INSTITUTIONAL,ALL CLASSES,40,PATTIKONDA,0,0,0,0,0,0,0,0,0,0
ANDHRA PRADESH,KURNOOL,INSTITUTIONAL,ALL CLASSES,41,CHIPPAGIRI,0,0,0,0,0,0,0,0,0,0
ANDHRA PRADESH,KURNOOL,INSTITUTIONAL,ALL CLASSES,42,MADDIKERA (EAST),0,0,0,0,0,0,0,0,0,0
ANDHRA PRADESH,KURNOOL,INSTITUTIONAL,ALL CLASSES,43,TUGGALI,0,0,0,0,0,0,0,0,0,0
ANDHRA PRADESH,KURNOOL,INSTITUTIONAL,ALL CLASSES,44,PEAPALLY,0,0,0,0,0,0,0,0,0,0
ANDHRA PRADESH,KURNOOL,INSTITUTIONAL,ALL CLASSES,45,OWK,0,0,0,0,0,0,0,0,0,0
ANDHRA PRADESH,KURNOOL,INSTITUTIONAL,ALL CLASSES,46,KOILKUNTLA,0,0,0,0,0,0,0,0,0,0
ANDHRA PRADESH,KURNOOL,INSTITUTIONAL,ALL CLASSES,47,RUDRAVARAM,0,0,0,0,0,0,0,0,0,0
ANDHRA PRADESH,KURNOOL,INSTITUTIONAL,ALL CLASSES,48,ALLAGADDA,0,0,0,0,0,0,0,0,0,0
ANDHRA PRADESH,KURNOOL,INSTITUTIONAL,ALL CLASSES,49,DORNIPADU,0,0,0,0,0,0,0,0,0,0
ANDHRA PRADESH,KURNOOL,INSTITUTIONAL,ALL CLASSES,50,SANJAMALA,0,0,0,0,0,0,0,0,0,0
ANDHRA PRADESH,KURNOOL,INSTITUTIONAL,ALL CLASSES,51,KOLIMIGUNDLA,0,0,0,0,0,0,0,0,0,0
ANDHRA PRADESH,KURNOOL,INSTITUTIONAL,ALL CLASSES,52,UYYALAWADA,0,0,0,0,0,0,0,0,0,0
ANDHRA PRADESH,KURNOOL,INSTITUTIONAL,ALL CLASSES,53,CHAGALAMARRI,0,0,0,0,0,0,0,0,0,0
ANDHRA PRADESH,KURNOOL,INSTITUTIONAL,ALL CLASSES,54,CHAGALAMARRI,0,0,0,0,0,0,0,0,0,0
ANDHRA PRADESH,KURNOOL,SCHEDULED CASTE,ALL CLASSES,1,MANTRALAYAM,1256,1345,1241,104,1345,0,0,0,0,0
ANDHRA PRADESH,KURNOOL,SCHEDULED CASTE,ALL CLASSES,2,KOSIGI,1010,1004,921,83,1004,0,0,0,0,0
ANDHRA PRADESH,KURNOOL,SCHEDULED CASTE,ALL CLASSES,3,KOWTHALAM,2174,2729,2715,14,2729,0,0,0,0,0
ANDHRA PRADESH,KURNOOL,SCHEDULED CASTE,ALL CLASSES,4,PEDDA KADUBUR,1711,2021,1872,149,2021,0,0,0,0,0
ANDHRA PRADESH,KURNOOL,SCHEDULED CASTE,ALL CLASSES,5,YEMMIGANUR,2215,2164,2083,71,2154,0,10,0,10,0
ANDHRA PRADESH,KURNOOL,SCHEDULED CASTE,ALL CLASSES,6,NANDAVARAM,1948,2169,2049,48,2097,7,58,0,65,7
ANDHRA PRADESH,KURNOOL,SCHEDULED CASTE,ALL CLASSES,7,C.BELAGAL,1752,1476,1460,16,1476,0,0,0,0,0
ANDHRA PRADESH,KURNOOL,SCHEDULED CASTE,ALL CLASSES,8,GUDUR,1139,1004,953,52,1005,0,0,0,0,0
ANDHRA PRADESH,KURNOOL,SCHEDULED CASTE,ALL CLASSES,9,KALLUR,1643,1744,1671,73,1744,0,0,0,0,0
ANDHRA PRADESH,KURNOOL,SCHEDULED CASTE,ALL CLASSES,10,KURNOOL,2276,2336,2294,42,2336,0,0,0,0,0
ANDHRA PRADESH,KURNOOL,SCHEDULED CASTE,ALL CLASSES,11,NANDIKOTKUR,1327,1097,978,116,1094,1,1,0,2,1
ANDHRA PRADESH,KURNOOL,SCHEDULED CASTE,ALL CLASSES,12,PAGIDYALA,763,649,307,330,637,0,12,0,12,0
ANDHRA PRADESH,KURNOOL,SCHEDULED CASTE,ALL CLASSES,13,JUPADU BUNGALOW,1576,1770,1631,117,1748,0,22,0,22,0
ANDHRA PRADESH,KURNOOL,SCHEDULED CASTE,ALL CLASSES,14,KOTHAPALLE,1597,1944,1642,302,1944,0,0,0,0,0
ANDHRA PRADESH,KURNOOL,SCHEDULED CASTE,ALL CLASSES,15,ATMAKUR,2057,1577,1555,22,1577,0,0,0,0,0
ANDHRA PRADESH,KURNOOL,SCHEDULED CASTE,ALL CLASSES,16,PAMULAPADU,1979,1745,1724,21,1745,0,0,0,0,0
ANDHRA PRADESH,KURNOOL,SCHEDULED CASTE,ALL CLASSES,17,MIDTHUR,1886,2775,2682,92,2774,0,0,0,0,0
ANDHRA PRADESH,KURNOOL,SCHEDULED CASTE,ALL CLASSES,18,ORVAKAL,1688,1636,976,660,1636,0,0,0,0,0
ANDHRA PRADESH,KURNOOL,SCHEDULED CASTE,ALL CLASSES,19,KODUMUR,1138,1098,1090,8,1098,0,0,0,0,0
ANDHRA PRADESH,KURNOOL,SCHEDULED CASTE,ALL CLASSES,20,GONEGANDLA,2010,2442,2019,423,2442,0,0,0,0,0
ANDHRA PRADESH,KURNOOL,SCHEDULED CASTE,ALL CLASSES,21,ADONI,2260,2650,2552,98,2650,0,0,0,0,0
ANDHRA PRADESH,KURNOOL,SCHEDULED CASTE,ALL CLASSES,22,HOLAGUNDA,1368,1708,1238,467,1705,0,3,0,3,0
ANDHRA PRADESH,KURNOOL,SCHEDULED CASTE,ALL CLASSES,23,HALAHARVI,942,1347,985,362,1347,0,0,0,0,0
ANDHRA PRADESH,KURNOOL,SCHEDULED CASTE,ALL CLASSES,24,ALUR,1850,3194,3127,58,3185,0,10,0,10,0
ANDHRA PRADESH,KURNOOL,SCHEDULED CASTE,ALL CLASSES,25,ASPARI,734,1738,1146,592,1738,0,0,0,0,0
ANDHRA PRADESH,KURNOOL,SCHEDULED CASTE,ALL CLASSES,26,DEVANAKONDA,2220,3346,3233,112,3345,0,0,0,0,0
ANDHRA PRADESH,KURNOOL,SCHEDULED CASTE,ALL CLASSES,27,KRISHNAGIRI,1369,2325,2091,234,2325,0,0,0,0,0
ANDHRA PRADESH,KURNOOL,SCHEDULED CASTE,ALL CLASSES,28,VELDURTHI,1781,2107,1707,398,2105,1,0,0,1,1
ANDHRA PRADESH,KURNOOL,SCHEDULED CASTE,ALL CLASSES,29,BETHAMCHERLA,1414,1542,1539,3,1542,0,0,0,0,0
ANDHRA PRADESH,KURNOOL,SCHEDULED CASTE,ALL CLASSES,30,PANYAM,1346,1144,872,267,1139,0,5,0,5,0
ANDHRA PRADESH,KURNOOL,SCHEDULED CASTE,ALL CLASSES,31,GADIVEMULA,1402,1586,1240,275,1515,0,71,0,71,0
ANDHRA PRADESH,KURNOOL,SCHEDULED CASTE,ALL CLASSES,32,VELGODE,1158,1114,1111,3,1114,0,0,0,0,0
ANDHRA PRADESH,KURNOOL,SCHEDULED CASTE,ALL CLASSES,33,BANDI ATMAKUR,1466,1026,976,43,1019,1,1,2,4,3
ANDHRA PRADESH,KURNOOL,SCHEDULED CASTE,ALL CLASSES,34,NANDYAL,1194,844,819,24,843,0,0,0,0,0
ANDHRA PRADESH,KURNOOL,SCHEDULED CASTE,ALL CLASSES,35,MAHANANDI,611,641,565,42,607,0,2,12,14,20
ANDHRA PRADESH,KURNOOL,SCHEDULED CASTE,ALL CLASSES,36,SIRVEL,1319,1059,987,72,1059,0,0,0,0,0
ANDHRA PRADESH,KURNOOL,SCHEDULED CASTE,ALL CLASSES,37,GOSPADU,1431,762,760,2,762,0,0,0,0,0
ANDHRA PRADESH,KURNOOL,SCHEDULED CASTE,ALL CLASSES,38,BANAGANAPALLE,1515,1467,1223,245,1468,0,0,0,0,0
ANDHRA PRADESH,KURNOOL,SCHEDULED CASTE,ALL CLASSES,39,DHONE,1383,2041,1983,58,2041,0,0,0,0,0
ANDHRA PRADESH,KURNOOL,SCHEDULED CASTE,ALL CLASSES,40,PATTIKONDA,1365,2073,1845,228,2073,0,0,0,0,0
ANDHRA PRADESH,KURNOOL,SCHEDULED CASTE,ALL CLASSES,41,CHIPPAGIRI,1028,1650,1627,24,1651,0,0,0,0,0
ANDHRA PRADESH,KURNOOL,SCHEDULED CASTE,ALL CLASSES,42,MADDIKERA (EAST),596,848,830,18,848,0,0,0,0,0
ANDHRA PRADESH,KURNOOL,SCHEDULED CASTE,ALL CLASSES,43,TUGGALI,1382,2534,2526,8,2534,0,0,0,0,0
ANDHRA PRADESH,KURNOOL,SCHEDULED CASTE,ALL CLASSES,44,PEAPALLY,1417,1784,1691,93,1784,0,0,0,0,0
ANDHRA PRADESH,KURNOOL,SCHEDULED CASTE,ALL CLASSES,45,OWK,1376,1534,1381,153,1534,0,0,0,0,0
ANDHRA PRADESH,KURNOOL,SCHEDULED CASTE,ALL CLASSES,46,KOILKUNTLA,1257,1144,1144,0,1144,0,0,0,0,0
ANDHRA PRADESH,KURNOOL,SCHEDULED CASTE,ALL CLASSES,47,RUDRAVARAM,1640,1937,1906,31,1937,0,0,0,0,0
ANDHRA PRADESH,KURNOOL,SCHEDULED CASTE,ALL CLASSES,48,ALLAGADDA,1276,1103,729,374,1103,0,0,0,0,0
ANDHRA PRADESH,KURNOOL,SCHEDULED CASTE,ALL CLASSES,49,DORNIPADU,758,658,550,108,658,0,0,0,0,0
ANDHRA PRADESH,KURNOOL,SCHEDULED CASTE,ALL CLASSES,50,SANJAMALA,988,1177,1173,4,1177,0,0,0,0,0
ANDHRA PRADESH,KURNOOL,SCHEDULED CASTE,ALL CLASSES,51,KOLIMIGUNDLA,779,1150,1118,32,1150,0,0,0,0,0
ANDHRA PRADESH,KURNOOL,SCHEDULED CASTE,ALL CLASSES,52,UYYALAWADA,891,906,884,23,907,0,0,0,0,0
ANDHRA PRADESH,KURNOOL,SCHEDULED CASTE,ALL CLASSES,53,CHAGALAMARRI,1835,2008,939,1069,2008,0,0,0,0,0
ANDHRA PRADESH,KURNOOL,SCHEDULED CASTE,ALL CLASSES,54,CHAGALAMARRI,1835,2008,939,1069,2008,0,0,0,0,0
ANDHRA PRADESH,KURNOOL,OTHERS,ALL CLASSES,1,MANTRALAYAM,8905,12672,11240,1432,12672,0,0,0,0,0
ANDHRA PRADESH,KURNOOL,OTHERS,ALL CLASSES,2,KOSIGI,10907,15883,13698,2185,15883,0,0,0,0,0
ANDHRA PRADESH,KURNOOL,OTHERS,ALL CLASSES,3,KOWTHALAM,15583,29891,29891,0,29891,0,0,0,0,0
ANDHRA PRADESH,KURNOOL,OTHERS,ALL CLASSES,4,PEDDA KADUBUR,8834,14983,13851,1132,14983,0,0,0,0,0
ANDHRA PRADESH,KURNOOL,OTHERS,ALL CLASSES,5,YEMMIGANUR,13090,21275,20289,336,20625,39,377,12,428,221
ANDHRA PRADESH,KURNOOL,OTHERS,ALL CLASSES,6,NANDAVARAM,12387,21115,20371,364,20735,44,199,0,243,138
ANDHRA PRADESH,KURNOOL,OTHERS,ALL CLASSES,7,C.BELAGAL,10347,12985,12826,159,12985,0,0,0,0,0
ANDHRA PRADESH,KURNOOL,OTHERS,ALL CLASSES,8,GUDUR,8331,11969,11189,780,11969,0,0,0,0,0
ANDHRA PRADESH,KURNOOL,OTHERS,ALL CLASSES,9,KALLUR,12319,19085,18583,502,19085,0,0,0,0,0
ANDHRA PRADESH,KURNOOL,OTHERS,ALL CLASSES,10,KURNOOL,12464,20379,20182,197,20379,0,0,0,0,0
ANDHRA PRADESH,KURNOOL,OTHERS,ALL CLASSES,11,NANDIKOTKUR,7351,11399,9641,1550,11191,65,56,9,130,77
ANDHRA PRADESH,KURNOOL,OTHERS,ALL CLASSES,12,PAGIDYALA,4430,5665,3870,1726,5596,0,36,0,36,33
ANDHRA PRADESH,KURNOOL,OTHERS,ALL CLASSES,13,JUPADU BUNGALOW,7406,11899,9893,1761,11654,0,156,0,156,89
ANDHRA PRADESH,KURNOOL,OTHERS,ALL CLASSES,14,KOTHAPALLE,5455,8057,7014,1043,8057,0,0,0,0,0
ANDHRA PRADESH,KURNOOL,OTHERS,ALL CLASSES,15,ATMAKUR,7956,9161,9051,110,9161,0,0,0,0,0
ANDHRA PRADESH,KURNOOL,OTHERS,ALL CLASSES,16,PAMULAPADU,8697,9759,9206,553,9759,0,0,0,0,0
ANDHRA PRADESH,KURNOOL,OTHERS,ALL CLASSES,17,MIDTHUR,10312,21451,21166,285,21451,0,0,0,0,0
ANDHRA PRADESH,KURNOOL,OTHERS,ALL CLASSES,18,ORVAKAL,12271,19781,16204,3577,19781,0,0,0,0,0
ANDHRA PRADESH,KURNOOL,OTHERS,ALL CLASSES,19,KODUMUR,10599,17056,16813,243,17056,0,0,0,0,0
ANDHRA PRADESH,KURNOOL,OTHERS,ALL CLASSES,20,GONEGANDLA,12356,18324,16252,2073,18325,0,0,0,0,0
ANDHRA PRADESH,KURNOOL,OTHERS,ALL CLASSES,21,ADONI,19681,35484,34730,754,35484,0,0,0,0,0
ANDHRA PRADESH,KURNOOL,OTHERS,ALL CLASSES,22,HOLAGUNDA,9881,22101,14121,7783,21904,0,126,0,126,71
ANDHRA PRADESH,KURNOOL,OTHERS,ALL CLASSES,23,HALAHARVI,10541,21134,20869,264,21133,0,0,0,0,0
ANDHRA PRADESH,KURNOOL,OTHERS,ALL CLASSES,24,ALUR,10566,28041,25713,1907,27620,0,269,0,269,152
ANDHRA PRADESH,KURNOOL,OTHERS,ALL CLASSES,25,ASPARI,15430,35369,27261,8108,35369,0,0,0,0,0
ANDHRA PRADESH,KURNOOL,OTHERS,ALL CLASSES,26,DEVANAKONDA,13740,28213,27052,1161,28213,0,0,0,0,0
ANDHRA PRADESH,KURNOOL,OTHERS,ALL CLASSES,27,KRISHNAGIRI,10940,26026,23727,2299,26026,0,0,0,0,0
ANDHRA PRADESH,KURNOOL,OTHERS,ALL CLASSES,28,VELDURTHI,10181,18502,13665,4821,18486,10,0,0,10,6
ANDHRA PRADESH,KURNOOL,OTHERS,ALL CLASSES,29,BETHAMCHERLA,8200,14242,13419,824,14243,0,0,0,0,0
ANDHRA PRADESH,KURNOOL,OTHERS,ALL CLASSES,30,PANYAM,9209,14718,10355,4161,14516,0,129,0,129,74
ANDHRA PRADESH,KURNOOL,OTHERS,ALL CLASSES,31,GADIVEMULA,8308,12770,12100,294,12394,0,240,0,240,137
ANDHRA PRADESH,KURNOOL,OTHERS,ALL CLASSES,32,VELGODE,6762,9651,9615,36,9651,0,0,0,0,0
ANDHRA PRADESH,KURNOOL,OTHERS,ALL CLASSES,33,BANDI ATMAKUR,10921,13090,12649,383,13032,12,16,13,41,18
ANDHRA PRADESH,KURNOOL,OTHERS,ALL CLASSES,34,NANDYAL,13443,15264,15114,148,15262,0,0,0,0,3
ANDHRA PRADESH,KURNOOL,OTHERS,ALL CLASSES,35,MAHANANDI,5414,7044,6826,32,6858,16,14,92,122,64
ANDHRA PRADESH,KURNOOL,OTHERS,ALL CLASSES,36,SIRVEL,10611,14349,12451,1898,14349,0,0,0,0,0
ANDHRA PRADESH,KURNOOL,OTHERS,ALL CLASSES,37,GOSPADU,8122,11387,11341,45,11386,0,0,0,0,0
ANDHRA PRADESH,KURNOOL,OTHERS,ALL CLASSES,38,BANAGANAPALLE,16264,26672,19892,6780,26672,0,0,0,0,0
ANDHRA PRADESH,KURNOOL,OTHERS,ALL CLASSES,39,DHONE,12495,25399,24882,517,25399,0,0,0,0,0
ANDHRA PRADESH,KURNOOL,OTHERS,ALL CLASSES,40,PATTIKONDA,9330,20810,18242,2568,20810,0,0,0,0,0
ANDHRA PRADESH,KURNOOL,OTHERS,ALL CLASSES,41,CHIPPAGIRI,10521,27049,26798,251,27049,0,0,0,0,0
ANDHRA PRADESH,KURNOOL,OTHERS,ALL CLASSES,42,MADDIKERA (EAST),9638,20437,19910,527,20437,0,0,0,0,0
ANDHRA PRADESH,KURNOOL,OTHERS,ALL CLASSES,43,TUGGALI,10224,23351,22773,578,23351,0,0,0,0,0
ANDHRA PRADESH,KURNOOL,OTHERS,ALL CLASSES,44,PEAPALLY,12917,22656,20956,1700,22656,0,0,0,0,0
ANDHRA PRADESH,KURNOOL,OTHERS,ALL CLASSES,45,OWK,7774,14545,14039,507,14546,0,0,0,0,0
ANDHRA PRADESH,KURNOOL,OTHERS,ALL CLASSES,46,KOILKUNTLA,8785,16146,16058,88,16146,0,0,0,0,0
ANDHRA PRADESH,KURNOOL,OTHERS,ALL CLASSES,47,RUDRAVARAM,10984,17980,17409,571,17980,0,0,0,0,0
ANDHRA PRADESH,KURNOOL,OTHERS,ALL CLASSES,48,ALLAGADDA,13384,17253,9437,7816,17253,0,0,0,0,0
ANDHRA PRADESH,KURNOOL,OTHERS,ALL CLASSES,49,DORNIPADU,6199,10214,9158,1056,10214,0,0,0,0,0
ANDHRA PRADESH,KURNOOL,OTHERS,ALL CLASSES,50,SANJAMALA,9427,19443,19334,109,19443,0,0,0,0,0
ANDHRA PRADESH,KURNOOL,OTHERS,ALL CLASSES,51,KOLIMIGUNDLA,6305,13728,13569,160,13729,0,0,0,0,0
ANDHRA PRADESH,KURNOOL,OTHERS,ALL CLASSES,52,UYYALAWADA,7839,17323,17269,53,17322,0,0,0,0,0
ANDHRA PRADESH,KURNOOL,OTHERS,ALL CLASSES,53,CHAGALAMARRI,9986,11992,5822,6170,11992,0,0,0,0,0
ANDHRA PRADESH,KURNOOL,OTHERS,ALL CLASSES,54,CHAGALAMARRI,9986,11992,5822,6170,11992,0,0,0,0,0
ANDHRA PRADESH,KURNOOL,SCHEDULED TRIBES,ALL CLASSES,1,MANTRALAYAM,95,88,77,11,88,0,0,0,0,0
ANDHRA PRADESH,KURNOOL,SCHEDULED TRIBES,ALL CLASSES,2,KOSIGI,88,99,50,50,100,0,0,0,0,0
ANDHRA PRADESH,KURNOOL,SCHEDULED TRIBES,ALL CLASSES,3,KOWTHALAM,371,492,456,36,492,0,0,0,0,0
ANDHRA PRADESH,KURNOOL,SCHEDULED TRIBES,ALL CLASSES,4,PEDDA KADUBUR,15,22,11,10,21,0,0,0,0,0
ANDHRA PRADESH,KURNOOL,SCHEDULED TRIBES,ALL CLASSES,5,YEMMIGANUR,12,8,4,4,8,0,0,0,0,0
ANDHRA PRADESH,KURNOOL,SCHEDULED TRIBES,ALL CLASSES,6,NANDAVARAM,16,16,12,5,17,0,0,0,0,0
ANDHRA PRADESH,KURNOOL,SCHEDULED TRIBES,ALL CLASSES,7,C.BELAGAL,15,14,7,7,14,0,0,0,0,0
ANDHRA PRADESH,KURNOOL,SCHEDULED TRIBES,ALL CLASSES,8,GUDUR,1,4,2,2,4,0,0,0,0,0
ANDHRA PRADESH,KURNOOL,SCHEDULED TRIBES,ALL CLASSES,9,KALLUR,242,365,353,12,365,0,0,0,0,0
ANDHRA PRADESH,KURNOOL,SCHEDULED TRIBES,ALL CLASSES,10,KURNOOL,213,315,227,88,315,0,0,0,0,0
ANDHRA PRADESH,KURNOOL,SCHEDULED TRIBES,ALL CLASSES,11,NANDIKOTKUR,112,87,80,7,87,0,0,0,0,0
ANDHRA PRADESH,KURNOOL,SCHEDULED TRIBES,ALL CLASSES,12,PAGIDYALA,11,6,3,3,6,0,0,0,0,0
ANDHRA PRADESH,KURNOOL,SCHEDULED TRIBES,ALL CLASSES,13,JUPADU BUNGALOW,72,83,64,6,70,0,10,0,10,2
ANDHRA PRADESH,KURNOOL,SCHEDULED TRIBES,ALL CLASSES,14,KOTHAPALLE,223,262,165,98,263,0,0,0,0,0
ANDHRA PRADESH,KURNOOL,SCHEDULED TRIBES,ALL CLASSES,15,ATMAKUR,520,476,453,24,477,0,0,0,0,0
ANDHRA PRADESH,KURNOOL,SCHEDULED TRIBES,ALL CLASSES,16,PAMULAPADU,296,250,224,26,250,0,0,0,0,0
ANDHRA PRADESH,KURNOOL,SCHEDULED TRIBES,ALL CLASSES,17,MIDTHUR,17,22,11,11,22,0,0,0,0,0
ANDHRA PRADESH,KURNOOL,SCHEDULED TRIBES,ALL CLASSES,18,ORVAKAL,396,535,293,242,535,0,0,0,0,0
ANDHRA PRADESH,KURNOOL,SCHEDULED TRIBES,ALL CLASSES,19,KODUMUR,13,11,5,5,10,0,0,0,0,0
ANDHRA PRADESH,KURNOOL,SCHEDULED TRIBES,ALL CLASSES,20,GONEGANDLA,172,218,140,78,218,0,0,0,0,0
ANDHRA PRADESH,KURNOOL,SCHEDULED TRIBES,ALL CLASSES,21,ADONI,36,46,43,4,47,0,0,0,0,0
ANDHRA PRADESH,KURNOOL,SCHEDULED TRIBES,ALL CLASSES,22,HOLAGUNDA,222,265,222,43,265,0,0,0,0,0
ANDHRA PRADESH,KURNOOL,SCHEDULED TRIBES,ALL CLASSES,23,HALAHARVI,14,26,13,13,26,0,0,0,0,0
ANDHRA PRADESH,KURNOOL,SCHEDULED TRIBES,ALL CLASSES,24,ALUR,216,355,355,0,355,0,0,0,0,0
ANDHRA PRADESH,KURNOOL,SCHEDULED TRIBES,ALL CLASSES,25,ASPARI,77,128,78,50,128,0,0,0,0,0
ANDHRA PRADESH,KURNOOL,SCHEDULED TRIBES,ALL CLASSES,26,DEVANAKONDA,102,161,149,12,161,0,0,0,0,0
ANDHRA PRADESH,KURNOOL,SCHEDULED TRIBES,ALL CLASSES,27,KRISHNAGIRI,255,482,456,25,481,0,0,0,0,0
ANDHRA PRADESH,KURNOOL,SCHEDULED TRIBES,ALL CLASSES,28,VELDURTHI,68,102,51,51,102,0,0,0,0,0
ANDHRA PRADESH,KURNOOL,SCHEDULED TRIBES,ALL CLASSES,29,BETHAMCHERLA,433,503,443,60,503,0,0,0,0,0
ANDHRA PRADESH,KURNOOL,SCHEDULED TRIBES,ALL CLASSES,30,PANYAM,202,153,61,92,153,0,0,0,0,0
ANDHRA PRADESH,KURNOOL,SCHEDULED TRIBES,ALL CLASSES,31,GADIVEMULA,447,624,601,23,624,0,0,0,0,0
ANDHRA PRADESH,KURNOOL,SCHEDULED TRIBES,ALL CLASSES,32,VELGODE,204,171,164,7,171,0,0,0,0,0
ANDHRA PRADESH,KURNOOL,SCHEDULED TRIBES,ALL CLASSES,33,BANDI ATMAKUR,364,250,224,26,250,0,0,0,0,0
ANDHRA PRADESH,KURNOOL,SCHEDULED TRIBES,ALL CLASSES,34,NANDYAL,45,21,20,1,21,0,0,0,0,0
ANDHRA PRADESH,KURNOOL,SCHEDULED TRIBES,ALL CLASSES,35,MAHANANDI,85,63,31,31,62,0,0,0,0,0
ANDHRA PRADESH,KURNOOL,SCHEDULED TRIBES,ALL CLASSES,36,SIRVEL,204,176,153,23,176,0,0,0,0,0
ANDHRA PRADESH,KURNOOL,SCHEDULED TRIBES,ALL CLASSES,37,GOSPADU,50,24,16,8,24,0,0,0,0,0
ANDHRA PRADESH,KURNOOL,SCHEDULED TRIBES,ALL CLASSES,38,BANAGANAPALLE,933,1133,692,441,1133,0,0,0,0,0
ANDHRA PRADESH,KURNOOL,SCHEDULED TRIBES,ALL CLASSES,39,DHONE,640,1259,1143,117,1260,0,0,0,0,0
ANDHRA PRADESH,KURNOOL,SCHEDULED TRIBES,ALL CLASSES,40,PATTIKONDA,888,1575,1184,391,1575,0,0,0,0,0
ANDHRA PRADESH,KURNOOL,SCHEDULED TRIBES,ALL CLASSES,41,CHIPPAGIRI,19,58,53,5,58,0,0,0,0,0
ANDHRA PRADESH,KURNOOL,SCHEDULED TRIBES,ALL CLASSES,42,MADDIKERA (EAST),107,159,153,6,159,0,0,0,0,0
ANDHRA PRADESH,KURNOOL,SCHEDULED TRIBES,ALL CLASSES,43,TUGGALI,1059,2021,1962,59,2021,0,0,0,0,0
ANDHRA PRADESH,KURNOOL,SCHEDULED TRIBES,ALL CLASSES,44,PEAPALLY,483,649,591,58,649,0,0,0,0,0
ANDHRA PRADESH,KURNOOL,SCHEDULED TRIBES,ALL CLASSES,45,OWK,747,949,726,223,949,0,0,0,0,0
ANDHRA PRADESH,KURNOOL,SCHEDULED TRIBES,ALL CLASSES,46,KOILKUNTLA,97,110,77,33,110,0,0,0,0,0
ANDHRA PRADESH,KURNOOL,SCHEDULED TRIBES,ALL CLASSES,47,RUDRAVARAM,272,302,297,5,302,0,0,0,0,0
ANDHRA PRADESH,KURNOOL,SCHEDULED TRIBES,ALL CLASSES,48,ALLAGADDA,290,266,186,80,266,0,0,0,0,0
ANDHRA PRADESH,KURNOOL,SCHEDULED TRIBES,ALL CLASSES,49,DORNIPADU,45,37,19,19,38,0,0,0,0,0
ANDHRA PRADESH,KURNOOL,SCHEDULED TRIBES,ALL CLASSES,50,SANJAMALA,80,91,57,34,91,0,0,0,0,0
ANDHRA PRADESH,KURNOOL,SCHEDULED TRIBES,ALL CLASSES,51,KOLIMIGUNDLA,180,200,173,27,200,0,0,0,0,0
ANDHRA PRADESH,KURNOOL,SCHEDULED TRIBES,ALL CLASSES,52,UYYALAWADA,23,35,23,11,34,0,0,0,0,0
ANDHRA PRADESH,KURNOOL,SCHEDULED TRIBES,ALL CLASSES,53,CHAGALAMARRI,544,654,402,252,654,0,0,0,0,0
ANDHRA PRADESH,KURNOOL,SCHEDULED TRIBES,ALL CLASSES,54,CHAGALAMARRI,544,654,402,252,654,0,0,0,0,0
ANDHRA PRADESH,KURNOOL,ALL SOCIAL GROUPS,ALL CLASSES,1,MANTRALAYAM,10256,14104,12558,1546,14104,0,0,0,0,0
ANDHRA PRADESH,KURNOOL,ALL SOCIAL GROUPS,ALL CLASSES,2,KOSIGI,12005,16986,14668,2318,16986,0,0,0,0,0
ANDHRA PRADESH,KURNOOL,ALL SOCIAL GROUPS,ALL CLASSES,3,KOWTHALAM,18128,33112,33062,50,33112,0,0,0,0,0
ANDHRA PRADESH,KURNOOL,ALL SOCIAL GROUPS,ALL CLASSES,4,PEDDA KADUBUR,10560,17026,15734,1292,17026,0,0,0,0,0
ANDHRA PRADESH,KURNOOL,ALL SOCIAL GROUPS,ALL CLASSES,5,YEMMIGANUR,15323,24028,22668,702,23370,39,387,12,438,221
ANDHRA PRADESH,KURNOOL,ALL SOCIAL GROUPS,ALL CLASSES,6,NANDAVARAM,14351,23300,22431,416,22847,51,256,0,307,145
ANDHRA PRADESH,KURNOOL,ALL SOCIAL GROUPS,ALL CLASSES,7,C.BELAGAL,12114,14475,14293,182,14475,0,0,0,0,0
ANDHRA PRADESH,KURNOOL,ALL SOCIAL GROUPS,ALL CLASSES,8,GUDUR,9471,12977,12143,833,12976,0,0,0,0,0
ANDHRA PRADESH,KURNOOL,ALL SOCIAL GROUPS,ALL CLASSES,9,KALLUR,14204,21194,20607,587,21194,0,0,0,0,0
ANDHRA PRADESH,KURNOOL,ALL SOCIAL GROUPS,ALL CLASSES,10,KURNOOL,14956,23142,22815,327,23142,0,0,0,0,0
ANDHRA PRADESH,KURNOOL,ALL SOCIAL GROUPS,ALL CLASSES,11,NANDIKOTKUR,8804,12718,10752,1755,12507,67,57,9,133,79
ANDHRA PRADESH,KURNOOL,ALL SOCIAL GROUPS,ALL CLASSES,12,PAGIDYALA,5204,6320,4180,2059,6239,0,48,0,48,33
ANDHRA PRADESH,KURNOOL,ALL SOCIAL GROUPS,ALL CLASSES,13,JUPADU BUNGALOW,9057,14267,11845,2142,13987,0,188,0,188,91
ANDHRA PRADESH,KURNOOL,ALL SOCIAL GROUPS,ALL CLASSES,14,KOTHAPALLE,7275,10264,8821,1443,10264,0,0,0,0,0
ANDHRA PRADESH,KURNOOL,ALL SOCIAL GROUPS,ALL CLASSES,15,ATMAKUR,10533,11214,11059,155,11214,0,0,0,0,0
ANDHRA PRADESH,KURNOOL,ALL SOCIAL GROUPS,ALL CLASSES,16,PAMULAPADU,10972,11754,11154,600,11754,0,0,0,0,0
ANDHRA PRADESH,KURNOOL,ALL SOCIAL GROUPS,ALL CLASSES,17,MIDTHUR,12215,24248,23860,388,24248,0,0,0,0,0
ANDHRA PRADESH,KURNOOL,ALL SOCIAL GROUPS,ALL CLASSES,18,ORVAKAL,14360,21997,17498,4499,21997,0,0,0,0,0
ANDHRA PRADESH,KURNOOL,ALL SOCIAL GROUPS,ALL CLASSES,19,KODUMUR,11750,18165,17908,257,18165,0,0,0,0,0
ANDHRA PRADESH,KURNOOL,ALL SOCIAL GROUPS,ALL CLASSES,20,GONEGANDLA,14538,20984,18411,2573,20984,0,0,0,0,0
ANDHRA PRADESH,KURNOOL,ALL SOCIAL GROUPS,ALL CLASSES,21,ADONI,21977,38181,37325,856,38181,0,0,0,0,0
ANDHRA PRADESH,KURNOOL,ALL SOCIAL GROUPS,ALL CLASSES,22,HOLAGUNDA,11471,24074,15581,8293,23874,0,129,0,129,71
ANDHRA PRADESH,KURNOOL,ALL SOCIAL GROUPS,ALL CLASSES,23,HALAHARVI,11497,22507,21867,639,22506,0,0,0,0,0
ANDHRA PRADESH,KURNOOL,ALL SOCIAL GROUPS,ALL CLASSES,24,ALUR,12632,31591,29195,1965,31160,0,279,0,279,152
ANDHRA PRADESH,KURNOOL,ALL SOCIAL GROUPS,ALL CLASSES,25,ASPARI,16241,37235,28486,8749,37235,0,0,0,0,0
ANDHRA PRADESH,KURNOOL,ALL SOCIAL GROUPS,ALL CLASSES,26,DEVANAKONDA,16062,31720,30434,1286,31720,0,0,0,0,0
ANDHRA PRADESH,KURNOOL,ALL SOCIAL GROUPS,ALL CLASSES,27,KRISHNAGIRI,12564,28833,26275,2559,28834,0,0,0,0,0
ANDHRA PRADESH,KURNOOL,ALL SOCIAL GROUPS,ALL CLASSES,28,VELDURTHI,12030,20711,15423,5270,20693,10,0,0,10,6
ANDHRA PRADESH,KURNOOL,ALL SOCIAL GROUPS,ALL CLASSES,29,BETHAMCHERLA,10047,16287,15401,887,16288,0,0,0,0,0
ANDHRA PRADESH,KURNOOL,ALL SOCIAL GROUPS,ALL CLASSES,30,PANYAM,10776,16163,11388,4567,15955,0,134,0,134,74
ANDHRA PRADESH,KURNOOL,ALL SOCIAL GROUPS,ALL CLASSES,31,GADIVEMULA,10157,14980,13940,592,14532,0,311,0,311,137
ANDHRA PRADESH,KURNOOL,ALL SOCIAL GROUPS,ALL CLASSES,32,VELGODE,8124,10936,10890,46,10936,0,0,0,0,0
ANDHRA PRADESH,KURNOOL,ALL SOCIAL GROUPS,ALL CLASSES,33,BANDI ATMAKUR,12751,14365,13848,453,14301,12,17,14,43,21
ANDHRA PRADESH,KURNOOL,ALL SOCIAL GROUPS,ALL CLASSES,34,NANDYAL,14685,16212,15995,215,16210,0,0,0,0,3
ANDHRA PRADESH,KURNOOL,ALL SOCIAL GROUPS,ALL CLASSES,35,MAHANANDI,6110,7748,7423,105,7528,16,16,104,136,84
ANDHRA PRADESH,KURNOOL,ALL SOCIAL GROUPS,ALL CLASSES,36,SIRVEL,12134,15584,13590,1993,15583,0,0,0,0,0
ANDHRA PRADESH,KURNOOL,ALL SOCIAL GROUPS,ALL CLASSES,37,GOSPADU,9603,12172,12117,55,12172,0,0,0,0,0
ANDHRA PRADESH,KURNOOL,ALL SOCIAL GROUPS,ALL CLASSES,38,BANAGANAPALLE,18712,29272,21806,7466,29272,0,0,0,0,0
ANDHRA PRADESH,KURNOOL,ALL SOCIAL GROUPS,ALL CLASSES,39,DHONE,14518,28699,28007,692,28699,0,0,0,0,0
ANDHRA PRADESH,KURNOOL,ALL SOCIAL GROUPS,ALL CLASSES,40,PATTIKONDA,11583,24457,21270,3187,24457,0,0,0,0,0
ANDHRA PRADESH,KURNOOL,ALL SOCIAL GROUPS,ALL CLASSES,41,CHIPPAGIRI,11568,28758,28478,280,28758,0,0,0,0,0
ANDHRA PRADESH,KURNOOL,ALL SOCIAL GROUPS,ALL CLASSES,42,MADDIKERA (EAST),10341,21443,20892,551,21443,0,0,0,0,0
ANDHRA PRADESH,KURNOOL,ALL SOCIAL GROUPS,ALL CLASSES,43,TUGGALI,12665,27907,27261,645,27906,0,0,0,0,0
ANDHRA PRADESH,KURNOOL,ALL SOCIAL GROUPS,ALL CLASSES,44,PEAPALLY,14817,25089,23238,1851,25089,0,0,0,0,0
ANDHRA PRADESH,KURNOOL,ALL SOCIAL GROUPS,ALL CLASSES,45,OWK,9897,17028,16145,883,17028,0,0,0,0,0
ANDHRA PRADESH,KURNOOL,ALL SOCIAL GROUPS,ALL CLASSES,46,KOILKUNTLA,10139,17400,17279,121,17400,0,0,0,0,0
ANDHRA PRADESH,KURNOOL,ALL SOCIAL GROUPS,ALL CLASSES,47,RUDRAVARAM,12896,20218,19611,607,20218,0,0,0,0,0
ANDHRA PRADESH,KURNOOL,ALL SOCIAL GROUPS,ALL CLASSES,48,ALLAGADDA,14950,18622,10352,8270,18622,0,0,0,0,0
ANDHRA PRADESH,KURNOOL,ALL SOCIAL GROUPS,ALL CLASSES,49,DORNIPADU,7002,10909,9727,1182,10909,0,0,0,0,0
ANDHRA PRADESH,KURNOOL,ALL SOCIAL GROUPS,ALL CLASSES,50,SANJAMALA,10495,20711,20565,146,20711,0,0,0,0,0
ANDHRA PRADESH,KURNOOL,ALL SOCIAL GROUPS,ALL CLASSES,51,KOLIMIGUNDLA,7264,15079,14860,219,15079,0,0,0,0,0
ANDHRA PRADESH,KURNOOL,ALL SOCIAL GROUPS,ALL CLASSES,52,UYYALAWADA,8753,18264,18176,88,18264,0,0,0,0,0
ANDHRA PRADESH,KURNOOL,ALL SOCIAL GROUPS,ALL CLASSES,53,CHAGALAMARRI,12365,14653,7162,7491,14653,0,0,0,0,0
ANDHRA PRADESH,KURNOOL,ALL SOCIAL GROUPS,ALL CLASSES,54,CHAGALAMARRI,12365,14653,7162,7491,14653,0,0,0,0,0
ANDHRA PRADESH,KURNOOL,INSTITUTIONAL,20.0 & ABOVE,1,MANTRALAYAM,0,0,0,0,0,0,0,0,0,0
ANDHRA PRADESH,KURNOOL,INSTITUTIONAL,20.0 & ABOVE,2,KOSIGI,0,0,0,0,0,0,0,0,0,0
ANDHRA PRADESH,KURNOOL,INSTITUTIONAL,20.0 & ABOVE,3,KOWTHALAM,0,0,0,0,0,0,0,0,0,0
ANDHRA PRADESH,KURNOOL,INSTITUTIONAL,20.0 & ABOVE,4,PEDDA KADUBUR,0,0,0,0,0,0,0,0,0,0
ANDHRA PRADESH,KURNOOL,INSTITUTIONAL,20.0 & ABOVE,5,YEMMIGANUR,4,566,283,283,566,0,0,0,0,0
ANDHRA PRADESH,KURNOOL,INSTITUTIONAL,20.0 & ABOVE,6,NANDAVARAM,0,0,0,0,0,0,0,0,0,0
ANDHRA PRADESH,KURNOOL,INSTITUTIONAL,20.0 & ABOVE,7,C.BELAGAL,0,0,0,0,0,0,0,0,0,0
ANDHRA PRADESH,KURNOOL,INSTITUTIONAL,20.0 & ABOVE,8,GUDUR,0,0,0,0,0,0,0,0,0,0
ANDHRA PRADESH,KURNOOL,INSTITUTIONAL,20.0 & ABOVE,9,KALLUR,0,0,0,0,0,0,0,0,0,0
ANDHRA PRADESH,KURNOOL,INSTITUTIONAL,20.0 & ABOVE,10,KURNOOL,3,112,112,0,112,0,0,0,0,0
ANDHRA PRADESH,KURNOOL,INSTITUTIONAL,20.0 & ABOVE,11,NANDIKOTKUR,2,64,32,32,64,0,0,0,0,0
ANDHRA PRADESH,KURNOOL,INSTITUTIONAL,20.0 & ABOVE,12,PAGIDYALA,0,0,0,0,0,0,0,0,0,0
ANDHRA PRADESH,KURNOOL,INSTITUTIONAL,20.0 & ABOVE,13,JUPADU BUNGALOW,3,515,257,258,515,0,0,0,0,0
ANDHRA PRADESH,KURNOOL,INSTITUTIONAL,20.0 & ABOVE,14,KOTHAPALLE,0,0,0,0,0,0,0,0,0,0
ANDHRA PRADESH,KURNOOL,INSTITUTIONAL,20.0 & ABOVE,15,ATMAKUR,0,0,0,0,0,0,0,0,0,0
ANDHRA PRADESH,KURNOOL,INSTITUTIONAL,20.0 & ABOVE,16,PAMULAPADU,0,0,0,0,0,0,0,0,0,0
ANDHRA PRADESH,KURNOOL,INSTITUTIONAL,20.0 & ABOVE,17,MIDTHUR,0,0,0,0,0,0,0,0,0,0
ANDHRA PRADESH,KURNOOL,INSTITUTIONAL,20.0 & ABOVE,18,ORVAKAL,0,0,0,0,0,0,0,0,0,0
ANDHRA PRADESH,KURNOOL,INSTITUTIONAL,20.0 & ABOVE,19,KODUMUR,0,0,0,0,0,0,0,0,0,0
ANDHRA PRADESH,KURNOOL,INSTITUTIONAL,20.0 & ABOVE,20,GONEGANDLA,0,0,0,0,0,0,0,0,0,0
ANDHRA PRADESH,KURNOOL,INSTITUTIONAL,20.0 & ABOVE,21,ADONI,0,0,0,0,0,0,0,0,0,0
ANDHRA PRADESH,KURNOOL,INSTITUTIONAL,20.0 & ABOVE,22,HOLAGUNDA,0,0,0,0,0,0,0,0,0,0
ANDHRA PRADESH,KURNOOL,INSTITUTIONAL,20.0 & ABOVE,23,HALAHARVI,0,0,0,0,0,0,0,0,0,0
ANDHRA PRADESH,KURNOOL,INSTITUTIONAL,20.0 & ABOVE,24,ALUR,0,0,0,0,0,0,0,0,0,0
ANDHRA PRADESH,KURNOOL,INSTITUTIONAL,20.0 & ABOVE,25,ASPARI,0,0,0,0,0,0,0,0,0,0
ANDHRA PRADESH,KURNOOL,INSTITUTIONAL,20.0 & ABOVE,26,DEVANAKONDA,0,0,0,0,0,0,0,0,0,0
ANDHRA PRADESH,KURNOOL,INSTITUTIONAL,20.0 & ABOVE,27,KRISHNAGIRI,0,0,0,0,0,0,0,0,0,0
ANDHRA PRADESH,KURNOOL,INSTITUTIONAL,20.0 & ABOVE,28,VELDURTHI,0,0,0,0,0,0,0,0,0,0
ANDHRA PRADESH,KURNOOL,INSTITUTIONAL,20.0 & ABOVE,29,BETHAMCHERLA,0,0,0,0,0,0,0,0,0,0
ANDHRA PRADESH,KURNOOL,INSTITUTIONAL,20.0 & ABOVE,30,PANYAM,1,23,12,12,24,0,0,0,0,0
ANDHRA PRADESH,KURNOOL,INSTITUTIONAL,20.0 & ABOVE,31,GADIVEMULA,0,0,0,0,0,0,0,0,0,0
ANDHRA PRADESH,KURNOOL,INSTITUTIONAL,20.0 & ABOVE,32,VELGODE,0,0,0,0,0,0,0,0,0,0
ANDHRA PRADESH,KURNOOL,INSTITUTIONAL,20.0 & ABOVE,33,BANDI ATMAKUR,0,0,0,0,0,0,0,0,0,0
ANDHRA PRADESH,KURNOOL,INSTITUTIONAL,20.0 & ABOVE,34,NANDYAL,2,73,37,37,74,0,0,0,0,0
ANDHRA PRADESH,KURNOOL,INSTITUTIONAL,20.0 & ABOVE,35,MAHANANDI,0,0,0,0,0,0,0,0,0,0
ANDHRA PRADESH,KURNOOL,INSTITUTIONAL,20.0 & ABOVE,36,SIRVEL,0,0,0,0,0,0,0,0,0,0
ANDHRA PRADESH,KURNOOL,INSTITUTIONAL,20.0 & ABOVE,37,GOSPADU,0,0,0,0,0,0,0,0,0,0
ANDHRA PRADESH,KURNOOL,INSTITUTIONAL,20.0 & ABOVE,38,BANAGANAPALLE,0,0,0,0,0,0,0,0,0,0
ANDHRA PRADESH,KURNOOL,INSTITUTIONAL,20.0 & ABOVE,39,DHONE,0,0,0,0,0,0,0,0,0,0
ANDHRA PRADESH,KURNOOL,INSTITUTIONAL,20.0 & ABOVE,40,PATTIKONDA,0,0,0,0,0,0,0,0,0,0
ANDHRA PRADESH,KURNOOL,INSTITUTIONAL,20.0 & ABOVE,41,CHIPPAGIRI,0,0,0,0,0,0,0,0,0,0
ANDHRA PRADESH,KURNOOL,INSTITUTIONAL,20.0 & ABOVE,42,MADDIKERA (EAST),0,0,0,0,0,0,0,0,0,0
ANDHRA PRADESH,KURNOOL,INSTITUTIONAL,20.0 & ABOVE,43,TUGGALI,0,0,0,0,0,0,0,0,0,0
ANDHRA PRADESH,KURNOOL,INSTITUTIONAL,20.0 & ABOVE,44,PEAPALLY,0,0,0,0,0,0,0,0,0,0
ANDHRA PRADESH,KURNOOL,INSTITUTIONAL,20.0 & ABOVE,45,OWK,0,0,0,0,0,0,0,0,0,0
ANDHRA PRADESH,KURNOOL,INSTITUTIONAL,20.0 & ABOVE,46,KOILKUNTLA,0,0,0,0,0,0,0,0,0,0
ANDHRA PRADESH,KURNOOL,INSTITUTIONAL,20.0 & ABOVE,47,RUDRAVARAM,0,0,0,0,0,0,0,0,0,0
ANDHRA PRADESH,KURNOOL,INSTITUTIONAL,20.0 & ABOVE,48,ALLAGADDA,0,0,0,0,0,0,0,0,0,0
ANDHRA PRADESH,KURNOOL,INSTITUTIONAL,20.0 & ABOVE,49,DORNIPADU,0,0,0,0,0,0,0,0,0,0
ANDHRA PRADESH,KURNOOL,INSTITUTIONAL,20.0 & ABOVE,50,SANJAMALA,0,0,0,0,0,0,0,0,0,0
ANDHRA PRADESH,KURNOOL,INSTITUTIONAL,20.0 & ABOVE,51,KOLIMIGUNDLA,0,0,0,0,0,0,0,0,0,0
ANDHRA PRADESH,KURNOOL,INSTITUTIONAL,20.0 & ABOVE,52,UYYALAWADA,0,0,0,0,0,0,0,0,0,0
ANDHRA PRADESH,KURNOOL,INSTITUTIONAL,20.0 & ABOVE,53,CHAGALAMARRI,0,0,0,0,0,0,0,0,0,0
ANDHRA PRADESH,KURNOOL,INSTITUTIONAL,20.0 & ABOVE,54,CHAGALAMARRI,0,0,0,0,0,0,0,0,0,0
ANDHRA PRADESH,KURNOOL,SCHEDULED CASTE,20.0 & ABOVE,1,MANTRALAYAM,0,0,0,0,0,0,0,0,0,0
ANDHRA PRADESH,KURNOOL,SCHEDULED CASTE,20.0 & ABOVE,2,KOSIGI,0,0,0,0,0,0,0,0,0,0
ANDHRA PRADESH,KURNOOL,SCHEDULED CASTE,20.0 & ABOVE,3,KOWTHALAM,1,27,14,14,28,0,0,0,0,0
ANDHRA PRADESH,KURNOOL,SCHEDULED CASTE,20.0 & ABOVE,4,PEDDA KADUBUR,0,0,0,0,0,0,0,0,0,0
ANDHRA PRADESH,KURNOOL,SCHEDULED CASTE,20.0 & ABOVE,5,YEMMIGANUR,0,0,0,0,0,0,0,0,0,0
ANDHRA PRADESH,KURNOOL,SCHEDULED CASTE,20.0 & ABOVE,6,NANDAVARAM,0,0,0,0,0,0,0,0,0,0
ANDHRA PRADESH,KURNOOL,SCHEDULED CASTE,20.0 & ABOVE,7,C.BELAGAL,0,0,0,0,0,0,0,0,0,0
ANDHRA PRADESH,KURNOOL,SCHEDULED CASTE,20.0 & ABOVE,8,GUDUR,0,0,0,0,0,0,0,0,0,0
ANDHRA PRADESH,KURNOOL,SCHEDULED CASTE,20.0 & ABOVE,9,KALLUR,0,0,0,0,0,0,0,0,0,0
ANDHRA PRADESH,KURNOOL,SCHEDULED CASTE,20.0 & ABOVE,10,KURNOOL,1,30,15,15,30,0,0,0,0,0
ANDHRA PRADESH,KURNOOL,SCHEDULED CASTE,20.0 & ABOVE,11,NANDIKOTKUR,0,0,0,0,0,0,0,0,0,0
ANDHRA PRADESH,KURNOOL,SCHEDULED CASTE,20.0 & ABOVE,12,PAGIDYALA,0,0,0,0,0,0,0,0,0,0
ANDHRA PRADESH,KURNOOL,SCHEDULED CASTE,20.0 & ABOVE,13,JUPADU BUNGALOW,0,0,0,0,0,0,0,0,0,0
ANDHRA PRADESH,KURNOOL,SCHEDULED CASTE,20.0 & ABOVE,14,KOTHAPALLE,1,86,43,43,86,0,0,0,0,0
ANDHRA PRADESH,KURNOOL,SCHEDULED CASTE,20.0 & ABOVE,15,ATMAKUR,0,0,0,0,0,0,0,0,0,0
ANDHRA PRADESH,KURNOOL,SCHEDULED CASTE,20.0 & ABOVE,16,PAMULAPADU,0,0,0,0,0,0,0,0,0,0
ANDHRA PRADESH,KURNOOL,SCHEDULED CASTE,20.0 & ABOVE,17,MIDTHUR,0,0,0,0,0,0,0,0,0,0
ANDHRA PRADESH,KURNOOL,SCHEDULED CASTE,20.0 & ABOVE,18,ORVAKAL,1,26,13,13,26,0,0,0,0,0
ANDHRA PRADESH,KURNOOL,SCHEDULED CASTE,20.0 & ABOVE,19,KODUMUR,0,0,0,0,0,0,0,0,0,0
ANDHRA PRADESH,KURNOOL,SCHEDULED CASTE,20.0 & ABOVE,20,GONEGANDLA,0,0,0,0,0,0,0,0,0,0
ANDHRA PRADESH,KURNOOL,SCHEDULED CASTE,20.0 & ABOVE,21,ADONI,0,0,0,0,0,0,0,0,0,0
ANDHRA PRADESH,KURNOOL,SCHEDULED CASTE,20.0 & ABOVE,22,HOLAGUNDA,0,0,0,0,0,0,0,0,0,0
ANDHRA PRADESH,KURNOOL,SCHEDULED CASTE,20.0 & ABOVE,23,HALAHARVI,0,0,0,0,0,0,0,0,0,0
ANDHRA PRADESH,KURNOOL,SCHEDULED CASTE,20.0 & ABOVE,24,ALUR,0,0,0,0,0,0,0,0,0,0
ANDHRA PRADESH,KURNOOL,SCHEDULED CASTE,20.0 & ABOVE,25,ASPARI,2,81,80,1,81,0,0,0,0,0
ANDHRA PRADESH,KURNOOL,SCHEDULED CASTE,20.0 & ABOVE,26,DEVANAKONDA,0,0,0,0,0,0,0,0,0,0
ANDHRA PRADESH,KURNOOL,SCHEDULED CASTE,20.0 & ABOVE,27,KRISHNAGIRI,0,0,0,0,0,0,0,0,0,0
ANDHRA PRADESH,KURNOOL,SCHEDULED CASTE,20.0 & ABOVE,28,VELDURTHI,0,0,0,0,0,0,0,0,0,0
ANDHRA PRADESH,KURNOOL,SCHEDULED CASTE,20.0 & ABOVE,29,BETHAMCHERLA,0,0,0,0,0,0,0,0,0,0
ANDHRA PRADESH,KURNOOL,SCHEDULED CASTE,20.0 & ABOVE,30,PANYAM,1,21,10,10,20,0,0,0,0,0
ANDHRA PRADESH,KURNOOL,SCHEDULED CASTE,20.0 & ABOVE,31,GADIVEMULA,1,55,27,27,54,0,0,0,0,0
ANDHRA PRADESH,KURNOOL,SCHEDULED CASTE,20.0 & ABOVE,32,VELGODE,0,0,0,0,0,0,0,0,0,0
ANDHRA PRADESH,KURNOOL,SCHEDULED CASTE,20.0 & ABOVE,33,BANDI ATMAKUR,0,0,0,0,0,0,0,0,0,0
ANDHRA PRADESH,KURNOOL,SCHEDULED CASTE,20.0 & ABOVE,34,NANDYAL,0,0,0,0,0,0,0,0,0,0
ANDHRA PRADESH,KURNOOL,SCHEDULED CASTE,20.0 & ABOVE,35,MAHANANDI,1,26,13,13,26,0,0,0,0,0
ANDHRA PRADESH,KURNOOL,SCHEDULED CASTE,20.0 & ABOVE,36,SIRVEL,0,0,0,0,0,0,0,0,0,0
ANDHRA PRADESH,KURNOOL,SCHEDULED CASTE,20.0 & ABOVE,37,GOSPADU,0,0,0,0,0,0,0,0,0,0
ANDHRA PRADESH,KURNOOL,SCHEDULED CASTE,20.0 & ABOVE,38,BANAGANAPALLE,0,0,0,0,0,0,0,0,0,0
ANDHRA PRADESH,KURNOOL,SCHEDULED CASTE,20.0 & ABOVE,39,DHONE,0,0,0,0,0,0,0,0,0,0
ANDHRA PRADESH,KURNOOL,SCHEDULED CASTE,20.0 & ABOVE,40,PATTIKONDA,0,0,0,0,0,0,0,0,0,0
ANDHRA PRADESH,KURNOOL,SCHEDULED CASTE,20.0 & ABOVE,41,CHIPPAGIRI,0,0,0,0,0,0,0,0,0,0
ANDHRA PRADESH,KURNOOL,SCHEDULED CASTE,20.0 & ABOVE,42,MADDIKERA (EAST),0,0,0,0,0,0,0,0,0,0
ANDHRA PRADESH,KURNOOL,SCHEDULED CASTE,20.0 & ABOVE,43,TUGGALI,0,0,0,0,0,0,0,0,0,0
ANDHRA PRADESH,KURNOOL,SCHEDULED CASTE,20.0 & ABOVE,44,PEAPALLY,0,0,0,0,0,0,0,0,0,0
ANDHRA PRADESH,KURNOOL,SCHEDULED CASTE,20.0 & ABOVE,45,OWK,0,0,0,0,0,0,0,0,0,0
ANDHRA PRADESH,KURNOOL,SCHEDULED CASTE,20.0 & ABOVE,46,KOILKUNTLA,0,0,0,0,0,0,0,0,0,0
ANDHRA PRADESH,KURNOOL,SCHEDULED CASTE,20.0 & ABOVE,47,RUDRAVARAM,0,0,0,0,0,0,0,0,0,0
ANDHRA PRADESH,KURNOOL,SCHEDULED CASTE,20.0 & ABOVE,48,ALLAGADDA,0,0,0,0,0,0,0,0,0,0
ANDHRA PRADESH,KURNOOL,SCHEDULED CASTE,20.0 & ABOVE,49,DORNIPADU,0,0,0,0,0,0,0,0,0,0
ANDHRA PRADESH,KURNOOL,SCHEDULED CASTE,20.0 & ABOVE,50,SANJAMALA,0,0,0,0,0,0,0,0,0,0
ANDHRA PRADESH,KURNOOL,SCHEDULED CASTE,20.0 & ABOVE,51,KOLIMIGUNDLA,0,0,0,0,0,0,0,0,0,0
ANDHRA PRADESH,KURNOOL,SCHEDULED CASTE,20.0 & ABOVE,52,UYYALAWADA,0,0,0,0,0,0,0,0,0,0
ANDHRA PRADESH,KURNOOL,SCHEDULED CASTE,20.0 & ABOVE,53,CHAGALAMARRI,0,0,0,0,0,0,0,0,0,0
ANDHRA PRADESH,KURNOOL,SCHEDULED CASTE,20.0 & ABOVE,54,CHAGALAMARRI,0,0,0,0,0,0,0,0,0,0
ANDHRA PRADESH,KURNOOL,OTHERS,20.0 & ABOVE,1,MANTRALAYAM,3,75,38,38,76,0,0,0,0,0
ANDHRA PRADESH,KURNOOL,OTHERS,20.0 & ABOVE,2,KOSIGI,4,113,56,56,112,0,0,0,0,0
ANDHRA PRADESH,KURNOOL,OTHERS,20.0 & ABOVE,3,KOWTHALAM,10,407,407,0,407,0,0,0,0,0
ANDHRA PRADESH,KURNOOL,OTHERS,20.0 & ABOVE,4,PEDDA KADUBUR,2,44,22,22,44,0,0,0,0,0
ANDHRA PRADESH,KURNOOL,OTHERS,20.0 & ABOVE,5,YEMMIGANUR,3,80,12,0,12,15,27,12,54,14
ANDHRA PRADESH,KURNOOL,OTHERS,20.0 & ABOVE,6,NANDAVARAM,4,103,52,52,104,0,0,0,0,0
ANDHRA PRADESH,KURNOOL,OTHERS,20.0 & ABOVE,7,C.BELAGAL,0,0,0,0,0,0,0,0,0,0
ANDHRA PRADESH,KURNOOL,OTHERS,20.0 & ABOVE,8,GUDUR,0,0,0,0,0,0,0,0,0,0
ANDHRA PRADESH,KURNOOL,OTHERS,20.0 & ABOVE,9,KALLUR,3,71,36,36,72,0,0,0,0,0
ANDHRA PRADESH,KURNOOL,OTHERS,20.0 & ABOVE,10,KURNOOL,3,156,156,0,156,0,0,0,0,0
ANDHRA PRADESH,KURNOOL,OTHERS,20.0 & ABOVE,11,NANDIKOTKUR,3,106,35,50,85,0,13,0,13,8
ANDHRA PRADESH,KURNOOL,OTHERS,20.0 & ABOVE,12,PAGIDYALA,2,45,23,23,46,0,0,0,0,0
ANDHRA PRADESH,KURNOOL,OTHERS,20.0 & ABOVE,13,JUPADU BUNGALOW,5,126,22,103,125,0,0,0,0,0
ANDHRA PRADESH,KURNOOL,OTHERS,20.0 & ABOVE,14,KOTHAPALLE,2,44,22,22,44,0,0,0,0,0
ANDHRA PRADESH,KURNOOL,OTHERS,20.0 & ABOVE,15,ATMAKUR,4,127,63,63,126,0,0,0,0,0
ANDHRA PRADESH,KURNOOL,OTHERS,20.0 & ABOVE,16,PAMULAPADU,1,21,11,11,22,0,0,0,0,0
ANDHRA PRADESH,KURNOOL,OTHERS,20.0 & ABOVE,17,MIDTHUR,4,90,45,45,90,0,0,0,0,0
ANDHRA PRADESH,KURNOOL,OTHERS,20.0 & ABOVE,18,ORVAKAL,9,264,132,132,264,0,0,0,0,0
ANDHRA PRADESH,KURNOOL,OTHERS,20.0 & ABOVE,19,KODUMUR,7,209,209,0,209,0,0,0,0,0
ANDHRA PRADESH,KURNOOL,OTHERS,20.0 & ABOVE,20,GONEGANDLA,0,0,0,0,0,0,0,0,0,0
ANDHRA PRADESH,KURNOOL,OTHERS,20.0 & ABOVE,21,ADONI,3,61,31,31,62,0,0,0,0,0
ANDHRA PRADESH,KURNOOL,OTHERS,20.0 & ABOVE,22,HOLAGUNDA,9,241,78,151,229,0,7,0,7,4
ANDHRA PRADESH,KURNOOL,OTHERS,20.0 & ABOVE,23,HALAHARVI,4,101,101,0,101,0,0,0,0,0
ANDHRA PRADESH,KURNOOL,OTHERS,20.0 & ABOVE,24,ALUR,14,912,456,456,912,0,0,0,0,0
ANDHRA PRADESH,KURNOOL,OTHERS,20.0 & ABOVE,25,ASPARI,17,2186,2186,0,2186,0,0,0,0,0
ANDHRA PRADESH,KURNOOL,OTHERS,20.0 & ABOVE,26,DEVANAKONDA,5,112,92,21,113,0,0,0,0,0
ANDHRA PRADESH,KURNOOL,OTHERS,20.0 & ABOVE,27,KRISHNAGIRI,17,427,287,140,427,0,0,0,0,0
ANDHRA PRADESH,KURNOOL,OTHERS,20.0 & ABOVE,28,VELDURTHI,4,88,57,23,80,5,0,0,5,3
ANDHRA PRADESH,KURNOOL,OTHERS,20.0 & ABOVE,29,BETHAMCHERLA,1,21,11,11,22,0,0,0,0,0
ANDHRA PRADESH,KURNOOL,OTHERS,20.0 & ABOVE,30,PANYAM,7,205,102,102,204,0,0,0,0,0
ANDHRA PRADESH,KURNOOL,OTHERS,20.0 & ABOVE,31,GADIVEMULA,5,118,59,59,118,0,0,0,0,0
ANDHRA PRADESH,KURNOOL,OTHERS,20.0 & ABOVE,32,VELGODE,0,0,0,0,0,0,0,0,0,0
ANDHRA PRADESH,KURNOOL,OTHERS,20.0 & ABOVE,33,BANDI ATMAKUR,1,21,21,0,21,0,0,0,0,0
ANDHRA PRADESH,KURNOOL,OTHERS,20.0 & ABOVE,34,NANDYAL,4,128,64,64,128,0,0,0,0,0
ANDHRA PRADESH,KURNOOL,OTHERS,20.0 & ABOVE,35,MAHANANDI,0,0,0,0,0,0,0,0,0,0
ANDHRA PRADESH,KURNOOL,OTHERS,20.0 & ABOVE,36,SIRVEL,8,209,105,105,210,0,0,0,0,0
ANDHRA PRADESH,KURNOOL,OTHERS,20.0 & ABOVE,37,GOSPADU,4,91,45,45,90,0,0,0,0,0
ANDHRA PRADESH,KURNOOL,OTHERS,20.0 & ABOVE,38,BANAGANAPALLE,1,21,15,5,20,0,0,0,0,0
ANDHRA PRADESH,KURNOOL,OTHERS,20.0 & ABOVE,39,DHONE,3,75,37,37,74,0,0,0,0,0
ANDHRA PRADESH,KURNOOL,OTHERS,20.0 & ABOVE,40,PATTIKONDA,7,171,153,17,170,0,0,0,0,0
ANDHRA PRADESH,KURNOOL,OTHERS,20.0 & ABOVE,41,CHIPPAGIRI,10,282,141,141,282,0,0,0,0,0
ANDHRA PRADESH,KURNOOL,OTHERS,20.0 & ABOVE,42,MADDIKERA (EAST),2,46,46,0,46,0,0,0,0,0
ANDHRA PRADESH,KURNOOL,OTHERS,20.0 & ABOVE,43,TUGGALI,1,21,11,11,22,0,0,0,0,0
ANDHRA PRADESH,KURNOOL,OTHERS,20.0 & ABOVE,44,PEAPALLY,4,103,52,52,104,0,0,0,0,0
ANDHRA PRADESH,KURNOOL,OTHERS,20.0 & ABOVE,45,OWK,6,153,153,0,153,0,0,0,0,0
ANDHRA PRADESH,KURNOOL,OTHERS,20.0 & ABOVE,46,KOILKUNTLA,1,30,15,15,30,0,0,0,0,0
ANDHRA PRADESH,KURNOOL,OTHERS,20.0 & ABOVE,47,RUDRAVARAM,4,96,96,0,96,0,0,0,0,0
ANDHRA PRADESH,KURNOOL,OTHERS,20.0 & ABOVE,48,ALLAGADDA,4,115,58,58,116,0,0,0,0,0
ANDHRA PRADESH,KURNOOL,OTHERS,20.0 & ABOVE,49,DORNIPADU,2,116,58,58,116,0,0,0,0,0
ANDHRA PRADESH,KURNOOL,OTHERS,20.0 & ABOVE,50,SANJAMALA,1,27,14,14,28,0,0,0,0,0
ANDHRA PRADESH,KURNOOL,OTHERS,20.0 & ABOVE,51,KOLIMIGUNDLA,12,319,160,160,320,0,0,0,0,0
ANDHRA PRADESH,KURNOOL,OTHERS,20.0 & ABOVE,52,UYYALAWADA,4,101,101,0,101,0,0,0,0,0
ANDHRA PRADESH,KURNOOL,OTHERS,20.0 & ABOVE,53,CHAGALAMARRI,1,30,15,15,30,0,0,0,0,0
ANDHRA PRADESH,KURNOOL,OTHERS,20.0 & ABOVE,54,CHAGALAMARRI,1,30,15,15,30,0,0,0,0,0
ANDHRA PRADESH,KURNOOL,SCHEDULED TRIBES,20.0 & ABOVE,1,MANTRALAYAM,0,0,0,0,0,0,0,0,0,0
ANDHRA PRADESH,KURNOOL,SCHEDULED TRIBES,20.0 & ABOVE,2,KOSIGI,0,0,0,0,0,0,0,0,0,0
ANDHRA PRADESH,KURNOOL,SCHEDULED TRIBES,20.0 & ABOVE,3,KOWTHALAM,0,0,0,0,0,0,0,0,0,0
ANDHRA PRADESH,KURNOOL,SCHEDULED TRIBES,20.0 & ABOVE,4,PEDDA KADUBUR,0,0,0,0,0,0,0,0,0,0
ANDHRA PRADESH,KURNOOL,SCHEDULED TRIBES,20.0 & ABOVE,5,YEMMIGANUR,0,0,0,0,0,0,0,0,0,0
ANDHRA PRADESH,KURNOOL,SCHEDULED TRIBES,20.0 & ABOVE,6,NANDAVARAM,0,0,0,0,0,0,0,0,0,0
ANDHRA PRADESH,KURNOOL,SCHEDULED TRIBES,20.0 & ABOVE,7,C.BELAGAL,0,0,0,0,0,0,0,0,0,0
ANDHRA PRADESH,KURNOOL,SCHEDULED TRIBES,20.0 & ABOVE,8,GUDUR,0,0,0,0,0,0,0,0,0,0
ANDHRA PRADESH,KURNOOL,SCHEDULED TRIBES,20.0 & ABOVE,9,KALLUR,0,0,0,0,0,0,0,0,0,0
ANDHRA PRADESH,KURNOOL,SCHEDULED TRIBES,20.0 & ABOVE,10,KURNOOL,0,0,0,0,0,0,0,0,0,0
ANDHRA PRADESH,KURNOOL,SCHEDULED TRIBES,20.0 & ABOVE,11,NANDIKOTKUR,0,0,0,0,0,0,0,0,0,0
ANDHRA PRADESH,KURNOOL,SCHEDULED TRIBES,20.0 & ABOVE,12,PAGIDYALA,0,0,0,0,0,0,0,0,0,0
ANDHRA PRADESH,KURNOOL,SCHEDULED TRIBES,20.0 & ABOVE,13,JUPADU BUNGALOW,0,0,0,0,0,0,0,0,0,0
ANDHRA PRADESH,KURNOOL,SCHEDULED TRIBES,20.0 & ABOVE,14,KOTHAPALLE,0,0,0,0,0,0,0,0,0,0
ANDHRA PRADESH,KURNOOL,SCHEDULED TRIBES,20.0 & ABOVE,15,ATMAKUR,0,0,0,0,0,0,0,0,0,0
ANDHRA PRADESH,KURNOOL,SCHEDULED TRIBES,20.0 & ABOVE,16,PAMULAPADU,0,0,0,0,0,0,0,0,0,0
ANDHRA PRADESH,KURNOOL,SCHEDULED TRIBES,20.0 & ABOVE,17,MIDTHUR,0,0,0,0,0,0,0,0,0,0
ANDHRA PRADESH,KURNOOL,SCHEDULED TRIBES,20.0 & ABOVE,18,ORVAKAL,0,0,0,0,0,0,0,0,0,0
ANDHRA PRADESH,KURNOOL,SCHEDULED TRIBES,20.0 & ABOVE,19,KODUMUR,0,0,0,0,0,0,0,0,0,0
ANDHRA PRADESH,KURNOOL,SCHEDULED TRIBES,20.0 & ABOVE,20,GONEGANDLA,0,0,0,0,0,0,0,0,0,0
ANDHRA PRADESH,KURNOOL,SCHEDULED TRIBES,20.0 & ABOVE,21,ADONI,0,0,0,0,0,0,0,0,0,0
ANDHRA PRADESH,KURNOOL,SCHEDULED TRIBES,20.0 & ABOVE,22,HOLAGUNDA,0,0,0,0,0,0,0,0,0,0
ANDHRA PRADESH,KURNOOL,SCHEDULED TRIBES,20.0 & ABOVE,23,HALAHARVI,0,0,0,0,0,0,0,0,0,0
ANDHRA PRADESH,KURNOOL,SCHEDULED TRIBES,20.0 & ABOVE,24,ALUR,0,0,0,0,0,0,0,0,0,0
ANDHRA PRADESH,KURNOOL,SCHEDULED TRIBES,20.0 & ABOVE,25,ASPARI,0,0,0,0,0,0,0,0,0,0
ANDHRA PRADESH,KURNOOL,SCHEDULED TRIBES,20.0 & ABOVE,26,DEVANAKONDA,0,0,0,0,0,0,0,0,0,0
ANDHRA PRADESH,KURNOOL,SCHEDULED TRIBES,20.0 & ABOVE,27,KRISHNAGIRI,1,27,13,13,26,0,0,0,0,0
ANDHRA PRADESH,KURNOOL,SCHEDULED TRIBES,20.0 & ABOVE,28,VELDURTHI,0,0,0,0,0,0,0,0,0,0
ANDHRA PRADESH,KURNOOL,SCHEDULED TRIBES,20.0 & ABOVE,29,BETHAMCHERLA,0,0,0,0,0,0,0,0,0,0
ANDHRA PRADESH,KURNOOL,SCHEDULED TRIBES,20.0 & ABOVE,30,PANYAM,0,0,0,0,0,0,0,0,0,0
ANDHRA PRADESH,KURNOOL,SCHEDULED TRIBES,20.0 & ABOVE,31,GADIVEMULA,0,0,0,0,0,0,0,0,0,0
ANDHRA PRADESH,KURNOOL,SCHEDULED TRIBES,20.0 & ABOVE,32,VELGODE,0,0,0,0,0,0,0,0,0,0
ANDHRA PRADESH,KURNOOL,SCHEDULED TRIBES,20.0 & ABOVE,33,BANDI ATMAKUR,0,0,0,0,0,0,0,0,0,0
ANDHRA PRADESH,KURNOOL,SCHEDULED TRIBES,20.0 & ABOVE,34,NANDYAL,0,0,0,0,0,0,0,0,0,0
ANDHRA PRADESH,KURNOOL,SCHEDULED TRIBES,20.0 & ABOVE,35,MAHANANDI,0,0,0,0,0,0,0,0,0,0
ANDHRA PRADESH,KURNOOL,SCHEDULED TRIBES,20.0 & ABOVE,36,SIRVEL,0,0,0,0,0,0,0,0,0,0
ANDHRA PRADESH,KURNOOL,SCHEDULED TRIBES,20.0 & ABOVE,37,GOSPADU,0,0,0,0,0,0,0,0,0,0
ANDHRA PRADESH,KURNOOL,SCHEDULED TRIBES,20.0 & ABOVE,38,BANAGANAPALLE,0,0,0,0,0,0,0,0,0,0
ANDHRA PRADESH,KURNOOL,SCHEDULED TRIBES,20.0 & ABOVE,39,DHONE,1,32,16,16,32,0,0,0,0,0
ANDHRA PRADESH,KURNOOL,SCHEDULED TRIBES,20.0 & ABOVE,40,PATTIKONDA,0,0,0,0,0,0,0,0,0,0
ANDHRA PRADESH,KURNOOL,SCHEDULED TRIBES,20.0 & ABOVE,41,CHIPPAGIRI,0,0,0,0,0,0,0,0,0,0
ANDHRA PRADESH,KURNOOL,SCHEDULED TRIBES,20.0 & ABOVE,42,MADDIKERA (EAST),0,0,0,0,0,0,0,0,0,0
ANDHRA PRADESH,KURNOOL,SCHEDULED TRIBES,20.0 & ABOVE,43,TUGGALI,0,0,0,0,0,0,0,0,0,0
ANDHRA PRADESH,KURNOOL,SCHEDULED TRIBES,20.0 & ABOVE,44,PEAPALLY,0,0,0,0,0,0,0,0,0,0
ANDHRA PRADESH,KURNOOL,SCHEDULED TRIBES,20.0 & ABOVE,45,OWK,0,0,0,0,0,0,0,0,0,0
ANDHRA PRADESH,KURNOOL,SCHEDULED TRIBES,20.0 & ABOVE,46,KOILKUNTLA,0,0,0,0,0,0,0,0,0,0
ANDHRA PRADESH,KURNOOL,SCHEDULED TRIBES,20.0 & ABOVE,47,RUDRAVARAM,0,0,0,0,0,0,0,0,0,0
ANDHRA PRADESH,KURNOOL,SCHEDULED TRIBES,20.0 & ABOVE,48,ALLAGADDA,0,0,0,0,0,0,0,0,0,0
ANDHRA PRADESH,KURNOOL,SCHEDULED TRIBES,20.0 & ABOVE,49,DORNIPADU,0,0,0,0,0,0,0,0,0,0
ANDHRA PRADESH,KURNOOL,SCHEDULED TRIBES,20.0 & ABOVE,50,SANJAMALA,0,0,0,0,0,0,0,0,0,0
ANDHRA PRADESH,KURNOOL,SCHEDULED TRIBES,20.0 & ABOVE,51,KOLIMIGUNDLA,0,0,0,0,0,0,0,0,0,0
ANDHRA PRADESH,KURNOOL,SCHEDULED TRIBES,20.0 & ABOVE,52,UYYALAWADA,0,0,0,0,0,0,0,0,0,0
ANDHRA PRADESH,KURNOOL,SCHEDULED TRIBES,20.0 & ABOVE,53,CHAGALAMARRI,0,0,0,0,0,0,0,0,0,0
ANDHRA PRADESH,KURNOOL,SCHEDULED TRIBES,20.0 & ABOVE,54,CHAGALAMARRI,0,0,0,0,0,0,0,0,0,0
ANDHRA PRADESH,KURNOOL,ALL SOCIAL GROUPS,20.0 & ABOVE,1,MANTRALAYAM,3,75,38,38,76,0,0,0,0,0
ANDHRA PRADESH,KURNOOL,ALL SOCIAL GROUPS,20.0 & ABOVE,2,KOSIGI,4,113,56,56,112,0,0,0,0,0
ANDHRA PRADESH,KURNOOL,ALL SOCIAL GROUPS,20.0 & ABOVE,3,KOWTHALAM,11,435,421,14,435,0,0,0,0,0
ANDHRA PRADESH,KURNOOL,ALL SOCIAL GROUPS,20.0 & ABOVE,4,PEDDA KADUBUR,2,44,22,22,44,0,0,0,0,0
ANDHRA PRADESH,KURNOOL,ALL SOCIAL GROUPS,20.0 & ABOVE,5,YEMMIGANUR,7,645,295,283,578,15,27,12,54,14
ANDHRA PRADESH,KURNOOL,ALL SOCIAL GROUPS,20.0 & ABOVE,6,NANDAVARAM,4,103,52,52,104,0,0,0,0,0
ANDHRA PRADESH,KURNOOL,ALL SOCIAL GROUPS,20.0 & ABOVE,7,C.BELAGAL,0,0,0,0,0,0,0,0,0,0
ANDHRA PRADESH,KURNOOL,ALL SOCIAL GROUPS,20.0 & ABOVE,8,GUDUR,0,0,0,0,0,0,0,0,0,0
ANDHRA PRADESH,KURNOOL,ALL SOCIAL GROUPS,20.0 & ABOVE,9,KALLUR,3,71,36,36,72,0,0,0,0,0
ANDHRA PRADESH,KURNOOL,ALL SOCIAL GROUPS,20.0 & ABOVE,10,KURNOOL,7,298,283,15,298,0,0,0,0,0
ANDHRA PRADESH,KURNOOL,ALL SOCIAL GROUPS,20.0 & ABOVE,11,NANDIKOTKUR,5,170,67,82,149,0,13,0,13,8
ANDHRA PRADESH,KURNOOL,ALL SOCIAL GROUPS,20.0 & ABOVE,12,PAGIDYALA,2,45,23,23,46,0,0,0,0,0
ANDHRA PRADESH,KURNOOL,ALL SOCIAL GROUPS,20.0 & ABOVE,13,JUPADU BUNGALOW,8,641,280,361,641,0,0,0,0,0
ANDHRA PRADESH,KURNOOL,ALL SOCIAL GROUPS,20.0 & ABOVE,14,KOTHAPALLE,3,129,65,65,130,0,0,0,0,0
ANDHRA PRADESH,KURNOOL,ALL SOCIAL GROUPS,20.0 & ABOVE,15,ATMAKUR,4,127,63,63,126,0,0,0,0,0
ANDHRA PRADESH,KURNOOL,ALL SOCIAL GROUPS,20.0 & ABOVE,16,PAMULAPADU,1,21,11,11,22,0,0,0,0,0
ANDHRA PRADESH,KURNOOL,ALL SOCIAL GROUPS,20.0 & ABOVE,17,MIDTHUR,4,90,45,45,90,0,0,0,0,0
ANDHRA PRADESH,KURNOOL,ALL SOCIAL GROUPS,20.0 & ABOVE,18,ORVAKAL,10,291,145,145,290,0,0,0,0,0
ANDHRA PRADESH,KURNOOL,ALL SOCIAL GROUPS,20.0 & ABOVE,19,KODUMUR,7,209,209,0,209,0,0,0,0,0
ANDHRA PRADESH,KURNOOL,ALL SOCIAL GROUPS,20.0 & ABOVE,20,GONEGANDLA,0,0,0,0,0,0,0,0,0,0
ANDHRA PRADESH,KURNOOL,ALL SOCIAL GROUPS,20.0 & ABOVE,21,ADONI,3,61,31,31,62,0,0,0,0,0
ANDHRA PRADESH,KURNOOL,ALL SOCIAL GROUPS,20.0 & ABOVE,22,HOLAGUNDA,9,241,78,151,229,0,7,0,7,4
ANDHRA PRADESH,KURNOOL,ALL SOCIAL GROUPS,20.0 & ABOVE,23,HALAHARVI,4,101,101,0,101,0,0,0,0,0
ANDHRA PRADESH,KURNOOL,ALL SOCIAL GROUPS,20.0 & ABOVE,24,ALUR,14,912,456,456,912,0,0,0,0,0
ANDHRA PRADESH,KURNOOL,ALL SOCIAL GROUPS,20.0 & ABOVE,25,ASPARI,19,2267,2267,1,2268,0,0,0,0,0
ANDHRA PRADESH,KURNOOL,ALL SOCIAL GROUPS,20.0 & ABOVE,26,DEVANAKONDA,5,112,92,21,113,0,0,0,0,0
ANDHRA PRADESH,KURNOOL,ALL SOCIAL GROUPS,20.0 & ABOVE,27,KRISHNAGIRI,18,454,300,154,454,0,0,0,0,0
ANDHRA PRADESH,KURNOOL,ALL SOCIAL GROUPS,20.0 & ABOVE,28,VELDURTHI,4,88,57,23,80,5,0,0,5,3
ANDHRA PRADESH,KURNOOL,ALL SOCIAL GROUPS,20.0 & ABOVE,29,BETHAMCHERLA,1,21,11,11,22,0,0,0,0,0
ANDHRA PRADESH,KURNOOL,ALL SOCIAL GROUPS,20.0 & ABOVE,30,PANYAM,9,249,124,124,248,0,0,0,0,0
ANDHRA PRADESH,KURNOOL,ALL SOCIAL GROUPS,20.0 & ABOVE,31,GADIVEMULA,6,173,86,87,173,0,0,0,0,0
ANDHRA PRADESH,KURNOOL,ALL SOCIAL GROUPS,20.0 & ABOVE,32,VELGODE,0,0,0,0,0,0,0,0,0,0
ANDHRA PRADESH,KURNOOL,ALL SOCIAL GROUPS,20.0 & ABOVE,33,BANDI ATMAKUR,1,21,21,0,21,0,0,0,0,0
ANDHRA PRADESH,KURNOOL,ALL SOCIAL GROUPS,20.0 & ABOVE,34,NANDYAL,6,201,100,100,200,0,0,0,0,0
ANDHRA PRADESH,KURNOOL,ALL SOCIAL GROUPS,20.0 & ABOVE,35,MAHANANDI,1,26,13,13,26,0,0,0,0,0
ANDHRA PRADESH,KURNOOL,ALL SOCIAL GROUPS,20.0 & ABOVE,36,SIRVEL,8,209,105,105,210,0,0,0,0,0
ANDHRA PRADESH,KURNOOL,ALL SOCIAL GROUPS,20.0 & ABOVE,37,GOSPADU,4,91,45,45,90,0,0,0,0,0
ANDHRA PRADESH,KURNOOL,ALL SOCIAL GROUPS,20.0 & ABOVE,38,BANAGANAPALLE,1,21,15,5,20,0,0,0,0,0
ANDHRA PRADESH,KURNOOL,ALL SOCIAL GROUPS,20.0 & ABOVE,39,DHONE,4,106,53,53,106,0,0,0,0,0
ANDHRA PRADESH,KURNOOL,ALL SOCIAL GROUPS,20.0 & ABOVE,40,PATTIKONDA,7,171,153,17,170,0,0,0,0,0
ANDHRA PRADESH,KURNOOL,ALL SOCIAL GROUPS,20.0 & ABOVE,41,CHIPPAGIRI,10,282,141,141,282,0,0,0,0,0
ANDHRA PRADESH,KURNOOL,ALL SOCIAL GROUPS,20.0 & ABOVE,42,MADDIKERA (EAST),2,46,46,0,46,0,0,0,0,0
ANDHRA PRADESH,KURNOOL,ALL SOCIAL GROUPS,20.0 & ABOVE,43,TUGGALI,1,21,11,11,22,0,0,0,0,0
ANDHRA PRADESH,KURNOOL,ALL SOCIAL GROUPS,20.0 & ABOVE,44,PEAPALLY,4,103,52,52,104,0,0,0,0,0
ANDHRA PRADESH,KURNOOL,ALL SOCIAL GROUPS,20.0 & ABOVE,45,OWK,6,153,153,0,153,0,0,0,0,0
ANDHRA PRADESH,KURNOOL,ALL SOCIAL GROUPS,20.0 & ABOVE,46,KOILKUNTLA,1,30,15,15,30,0,0,0,0,0
ANDHRA PRADESH,KURNOOL,ALL SOCIAL GROUPS,20.0 & ABOVE,47,RUDRAVARAM,4,96,96,0,96,0,0,0,0,0
ANDHRA PRADESH,KURNOOL,ALL SOCIAL GROUPS,20.0 & ABOVE,48,ALLAGADDA,4,115,58,58,116,0,0,0,0,0
ANDHRA PRADESH,KURNOOL,ALL SOCIAL GROUPS,20.0 & ABOVE,49,DORNIPADU,2,116,58,58,116,0,0,0,0,0
ANDHRA PRADESH,KURNOOL,ALL SOCIAL GROUPS,20.0 & ABOVE,50,SANJAMALA,1,27,14,14,28,0,0,0,0,0
ANDHRA PRADESH,KURNOOL,ALL SOCIAL GROUPS,20.0 & ABOVE,51,KOLIMIGUNDLA,12,319,160,160,320,0,0,0,0,0
ANDHRA PRADESH,KURNOOL,ALL SOCIAL GROUPS,20.0 & ABOVE,52,UYYALAWADA,4,101,101,0,101,0,0,0,0,0
ANDHRA PRADESH,KURNOOL,ALL SOCIAL GROUPS,20.0 & ABOVE,53,CHAGALAMARRI,1,30,15,15,30,0,0,0,0,0
ANDHRA PRADESH,KURNOOL,ALL SOCIAL GROUPS,20.0 & ABOVE,54,CHAGALAMARRI,1,30,15,15,30,0,0,0,0,0
ANDHRA PRADESH,KURNOOL,INSTITUTIONAL,Below 0.5,1,MANTRALAYAM,0,0,0,0,0,0,0,0,0,0
ANDHRA PRADESH,KURNOOL,INSTITUTIONAL,Below 0.5,2,KOSIGI,0,0,0,0,0,0,0,0,0,0
ANDHRA PRADESH,KURNOOL,INSTITUTIONAL,Below 0.5,3,KOWTHALAM,0,0,0,0,0,0,0,0,0,0
ANDHRA PRADESH,KURNOOL,INSTITUTIONAL,Below 0.5,4,PEDDA KADUBUR,0,0,0,0,0,0,0,0,0,0
ANDHRA PRADESH,KURNOOL,INSTITUTIONAL,Below 0.5,5,YEMMIGANUR,0,0,0,0,0,0,0,0,0,0
ANDHRA PRADESH,KURNOOL,INSTITUTIONAL,Below 0.5,6,NANDAVARAM,0,0,0,0,0,0,0,0,0,0
ANDHRA PRADESH,KURNOOL,INSTITUTIONAL,Below 0.5,7,C.BELAGAL,0,0,0,0,0,0,0,0,0,0
ANDHRA PRADESH,KURNOOL,INSTITUTIONAL,Below 0.5,8,GUDUR,0,0,0,0,0,0,0,0,0,0
ANDHRA PRADESH,KURNOOL,INSTITUTIONAL,Below 0.5,9,KALLUR,0,0,0,0,0,0,0,0,0,0
ANDHRA PRADESH,KURNOOL,INSTITUTIONAL,Below 0.5,10,KURNOOL,0,0,0,0,0,0,0,0,0,0
ANDHRA PRADESH,KURNOOL,INSTITUTIONAL,Below 0.5,11,NANDIKOTKUR,0,0,0,0,0,0,0,0,0,0
ANDHRA PRADESH,KURNOOL,INSTITUTIONAL,Below 0.5,12,PAGIDYALA,0,0,0,0,0,0,0,0,0,0
ANDHRA PRADESH,KURNOOL,INSTITUTIONAL,Below 0.5,13,JUPADU BUNGALOW,0,0,0,0,0,0,0,0,0,0
ANDHRA PRADESH,KURNOOL,INSTITUTIONAL,Below 0.5,14,KOTHAPALLE,0,0,0,0,0,0,0,0,0,0
ANDHRA PRADESH,KURNOOL,INSTITUTIONAL,Below 0.5,15,ATMAKUR,0,0,0,0,0,0,0,0,0,0
ANDHRA PRADESH,KURNOOL,INSTITUTIONAL,Below 0.5,16,PAMULAPADU,0,0,0,0,0,0,0,0,0,0
ANDHRA PRADESH,KURNOOL,INSTITUTIONAL,Below 0.5,17,MIDTHUR,0,0,0,0,0,0,0,0,0,0
ANDHRA PRADESH,KURNOOL,INSTITUTIONAL,Below 0.5,18,ORVAKAL,0,0,0,0,0,0,0,0,0,0
ANDHRA PRADESH,KURNOOL,INSTITUTIONAL,Below 0.5,19,KODUMUR,0,0,0,0,0,0,0,0,0,0
ANDHRA PRADESH,KURNOOL,INSTITUTIONAL,Below 0.5,20,GONEGANDLA,0,0,0,0,0,0,0,0,0,0
ANDHRA PRADESH,KURNOOL,INSTITUTIONAL,Below 0.5,21,ADONI,0,0,0,0,0,0,0,0,0,0
ANDHRA PRADESH,KURNOOL,INSTITUTIONAL,Below 0.5,22,HOLAGUNDA,0,0,0,0,0,0,0,0,0,0
ANDHRA PRADESH,KURNOOL,INSTITUTIONAL,Below 0.5,23,HALAHARVI,0,0,0,0,0,0,0,0,0,0
ANDHRA PRADESH,KURNOOL,INSTITUTIONAL,Below 0.5,24,ALUR,0,0,0,0,0,0,0,0,0,0
ANDHRA PRADESH,KURNOOL,INSTITUTIONAL,Below 0.5,25,ASPARI,0,0,0,0,0,0,0,0,0,0
ANDHRA PRADESH,KURNOOL,INSTITUTIONAL,Below 0.5,26,DEVANAKONDA,0,0,0,0,0,0,0,0,0,0
ANDHRA PRADESH,KURNOOL,INSTITUTIONAL,Below 0.5,27,KRISHNAGIRI,0,0,0,0,0,0,0,0,0,0
ANDHRA PRADESH,KURNOOL,INSTITUTIONAL,Below 0.5,28,VELDURTHI,0,0,0,0,0,0,0,0,0,0
ANDHRA PRADESH,KURNOOL,INSTITUTIONAL,Below 0.5,29,BETHAMCHERLA,0,0,0,0,0,0,0,0,0,0
ANDHRA PRADESH,KURNOOL,INSTITUTIONAL,Below 0.5,30,PANYAM,0,0,0,0,0,0,0,0,0,0
ANDHRA PRADESH,KURNOOL,INSTITUTIONAL,Below 0.5,31,GADIVEMULA,0,0,0,0,0,0,0,0,0,0
ANDHRA PRADESH,KURNOOL,INSTITUTIONAL,Below 0.5,32,VELGODE,0,0,0,0,0,0,0,0,0,0
ANDHRA PRADESH,KURNOOL,INSTITUTIONAL,Below 0.5,33,BANDI ATMAKUR,0,0,0,0,0,0,0,0,0,0
ANDHRA PRADESH,KURNOOL,INSTITUTIONAL,Below 0.5,34,NANDYAL,0,0,0,0,0,0,0,0,0,0
ANDHRA PRADESH,KURNOOL,INSTITUTIONAL,Below 0.5,35,MAHANANDI,0,0,0,0,0,0,0,0,0,0
ANDHRA PRADESH,KURNOOL,INSTITUTIONAL,Below 0.5,36,SIRVEL,0,0,0,0,0,0,0,0,0,0
ANDHRA PRADESH,KURNOOL,INSTITUTIONAL,Below 0.5,37,GOSPADU,0,0,0,0,0,0,0,0,0,0
ANDHRA PRADESH,KURNOOL,INSTITUTIONAL,Below 0.5,38,BANAGANAPALLE,0,0,0,0,0,0,0,0,0,0
ANDHRA PRADESH,KURNOOL,INSTITUTIONAL,Below 0.5,39,DHONE,0,0,0,0,0,0,0,0,0,0
ANDHRA PRADESH,KURNOOL,INSTITUTIONAL,Below 0.5,40,PATTIKONDA,0,0,0,0,0,0,0,0,0,0
ANDHRA PRADESH,KURNOOL,INSTITUTIONAL,Below 0.5,41,CHIPPAGIRI,0,0,0,0,0,0,0,0,0,0
ANDHRA PRADESH,KURNOOL,INSTITUTIONAL,Below 0.5,42,MADDIKERA (EAST),0,0,0,0,0,0,0,0,0,0
ANDHRA PRADESH,KURNOOL,INSTITUTIONAL,Below 0.5,43,TUGGALI,0,0,0,0,0,0,0,0,0,0
ANDHRA PRADESH,KURNOOL,INSTITUTIONAL,Below 0.5,44,PEAPALLY,0,0,0,0,0,0,0,0,0,0
ANDHRA PRADESH,KURNOOL,INSTITUTIONAL,Below 0.5,45,OWK,0,0,0,0,0,0,0,0,0,0
ANDHRA PRADESH,KURNOOL,INSTITUTIONAL,Below 0.5,46,KOILKUNTLA,0,0,0,0,0,0,0,0,0,0
ANDHRA PRADESH,KURNOOL,INSTITUTIONAL,Below 0.5,47,RUDRAVARAM,0,0,0,0,0,0,0,0,0,0
ANDHRA PRADESH,KURNOOL,INSTITUTIONAL,Below 0.5,48,ALLAGADDA,0,0,0,0,0,0,0,0,0,0
ANDHRA PRADESH,KURNOOL,INSTITUTIONAL,Below 0.5,49,DORNIPADU,0,0,0,0,0,0,0,0,0,0
ANDHRA PRADESH,KURNOOL,INSTITUTIONAL,Below 0.5,50,SANJAMALA,0,0,0,0,0,0,0,0,0,0
ANDHRA PRADESH,KURNOOL,INSTITUTIONAL,Below 0.5,51,KOLIMIGUNDLA,0,0,0,0,0,0,0,0,0,0
ANDHRA PRADESH,KURNOOL,INSTITUTIONAL,Below 0.5,52,UYYALAWADA,0,0,0,0,0,0,0,0,0,0
ANDHRA PRADESH,KURNOOL,INSTITUTIONAL,Below 0.5,53,CHAGALAMARRI,0,0,0,0,0,0,0,0,0,0
ANDHRA PRADESH,KURNOOL,INSTITUTIONAL,Below 0.5,54,CHAGALAMARRI,0,0,0,0,0,0,0,0,0,0
ANDHRA PRADESH,KURNOOL,SCHEDULED CASTE,Below 0.5,1,MANTRALAYAM,305,99,99,0,99,0,0,0,0,0
ANDHRA PRADESH,KURNOOL,SCHEDULED CASTE,Below 0.5,2,KOSIGI,237,85,85,0,85,0,0,0,0,0
ANDHRA PRADESH,KURNOOL,SCHEDULED CASTE,Below 0.5,3,KOWTHALAM,507,177,177,0,177,0,0,0,0,0
ANDHRA PRADESH,KURNOOL,SCHEDULED CASTE,Below 0.5,4,PEDDA KADUBUR,419,147,147,0,147,0,0,0,0,0
ANDHRA PRADESH,KURNOOL,SCHEDULED CASTE,Below 0.5,5,YEMMIGANUR,573,190,168,21,189,0,1,0,1,0
ANDHRA PRADESH,KURNOOL,SCHEDULED CASTE,Below 0.5,6,NANDAVARAM,450,168,165,3,168,0,0,0,0,0
ANDHRA PRADESH,KURNOOL,SCHEDULED CASTE,Below 0.5,7,C.BELAGAL,627,201,201,0,201,0,0,0,0,0
ANDHRA PRADESH,KURNOOL,SCHEDULED CASTE,Below 0.5,8,GUDUR,393,130,130,0,130,0,0,0,0,0
ANDHRA PRADESH,KURNOOL,SCHEDULED CASTE,Below 0.5,9,KALLUR,516,167,167,0,167,0,0,0,0,0
ANDHRA PRADESH,KURNOOL,SCHEDULED CASTE,Below 0.5,10,KURNOOL,809,252,247,5,252,0,0,0,0,0
ANDHRA PRADESH,KURNOOL,SCHEDULED CASTE,Below 0.5,11,NANDIKOTKUR,597,175,163,12,175,0,0,0,0,0
ANDHRA PRADESH,KURNOOL,SCHEDULED CASTE,Below 0.5,12,PAGIDYALA,409,126,71,50,121,0,5,0,5,0
ANDHRA PRADESH,KURNOOL,SCHEDULED CASTE,Below 0.5,13,JUPADU BUNGALOW,336,116,106,11,117,0,0,0,0,0
ANDHRA PRADESH,KURNOOL,SCHEDULED CASTE,Below 0.5,14,KOTHAPALLE,330,110,94,16,110,0,0,0,0,0
ANDHRA PRADESH,KURNOOL,SCHEDULED CASTE,Below 0.5,15,ATMAKUR,792,287,287,0,287,0,0,0,0,0
ANDHRA PRADESH,KURNOOL,SCHEDULED CASTE,Below 0.5,16,PAMULAPADU,786,234,222,12,234,0,0,0,0,0
ANDHRA PRADESH,KURNOOL,SCHEDULED CASTE,Below 0.5,17,MIDTHUR,306,106,97,9,106,0,0,0,0,0
ANDHRA PRADESH,KURNOOL,SCHEDULED CASTE,Below 0.5,18,ORVAKAL,498,147,98,49,147,0,0,0,0,0
ANDHRA PRADESH,KURNOOL,SCHEDULED CASTE,Below 0.5,19,KODUMUR,297,102,102,0,102,0,0,0,0,0
ANDHRA PRADESH,KURNOOL,SCHEDULED CASTE,Below 0.5,20,GONEGANDLA,690,153,153,0,153,0,0,0,0,0
ANDHRA PRADESH,KURNOOL,SCHEDULED CASTE,Below 0.5,21,ADONI,572,195,195,0,195,0,0,0,0,0
ANDHRA PRADESH,KURNOOL,SCHEDULED CASTE,Below 0.5,22,HOLAGUNDA,177,63,49,14,63,0,0,0,0,0
ANDHRA PRADESH,KURNOOL,SCHEDULED CASTE,Below 0.5,23,HALAHARVI,201,74,56,18,74,0,0,0,0,0
ANDHRA PRADESH,KURNOOL,SCHEDULED CASTE,Below 0.5,24,ALUR,127,47,47,0,47,0,0,0,0,0
ANDHRA PRADESH,KURNOOL,SCHEDULED CASTE,Below 0.5,25,ASPARI,51,17,17,0,17,0,0,0,0,0
ANDHRA PRADESH,KURNOOL,SCHEDULED CASTE,Below 0.5,26,DEVANAKONDA,239,90,84,6,90,0,0,0,0,0
ANDHRA PRADESH,KURNOOL,SCHEDULED CASTE,Below 0.5,27,KRISHNAGIRI,113,41,41,0,41,0,0,0,0,0
ANDHRA PRADESH,KURNOOL,SCHEDULED CASTE,Below 0.5,28,VELDURTHI,390,135,128,7,135,0,0,0,0,0
ANDHRA PRADESH,KURNOOL,SCHEDULED CASTE,Below 0.5,29,BETHAMCHERLA,252,94,94,0,94,0,0,0,0,0
ANDHRA PRADESH,KURNOOL,SCHEDULED CASTE,Below 0.5,30,PANYAM,561,180,154,27,181,0,0,0,0,0
ANDHRA PRADESH,KURNOOL,SCHEDULED CASTE,Below 0.5,31,GADIVEMULA,481,156,156,0,156,0,0,0,0,0
ANDHRA PRADESH,KURNOOL,SCHEDULED CASTE,Below 0.5,32,VELGODE,527,156,156,0,156,0,0,0,0,0
ANDHRA PRADESH,KURNOOL,SCHEDULED CASTE,Below 0.5,33,BANDI ATMAKUR,820,241,240,1,241,0,0,0,0,0
ANDHRA PRADESH,KURNOOL,SCHEDULED CASTE,Below 0.5,34,NANDYAL,657,186,185,1,186,0,0,0,0,0
ANDHRA PRADESH,KURNOOL,SCHEDULED CASTE,Below 0.5,35,MAHANANDI,241,68,68,0,68,0,0,0,0,0
ANDHRA PRADESH,KURNOOL,SCHEDULED CASTE,Below 0.5,36,SIRVEL,589,198,198,0,198,0,0,0,0,0
ANDHRA PRADESH,KURNOOL,SCHEDULED CASTE,Below 0.5,37,GOSPADU,968,271,271,0,271,0,0,0,0,0
ANDHRA PRADESH,KURNOOL,SCHEDULED CASTE,Below 0.5,38,BANAGANAPALLE,478,165,153,13,166,0,0,0,0,0
ANDHRA PRADESH,KURNOOL,SCHEDULED CASTE,Below 0.5,39,DHONE,205,67,65,2,67,0,0,0,0,0
ANDHRA PRADESH,KURNOOL,SCHEDULED CASTE,Below 0.5,40,PATTIKONDA,94,35,31,3,34,0,0,0,0,0
ANDHRA PRADESH,KURNOOL,SCHEDULED CASTE,Below 0.5,41,CHIPPAGIRI,125,48,48,0,48,0,0,0,0,0
ANDHRA PRADESH,KURNOOL,SCHEDULED CASTE,Below 0.5,42,MADDIKERA (EAST),31,13,13,0,13,0,0,0,0,0
ANDHRA PRADESH,KURNOOL,SCHEDULED CASTE,Below 0.5,43,TUGGALI,92,29,29,0,29,0,0,0,0,0
ANDHRA PRADESH,KURNOOL,SCHEDULED CASTE,Below 0.5,44,PEAPALLY,118,41,41,0,41,0,0,0,0,0
ANDHRA PRADESH,KURNOOL,SCHEDULED CASTE,Below 0.5,45,OWK,456,137,121,17,138,0,0,0,0,0
ANDHRA PRADESH,KURNOOL,SCHEDULED CASTE,Below 0.5,46,KOILKUNTLA,444,166,166,0,166,0,0,0,0,0
ANDHRA PRADESH,KURNOOL,SCHEDULED CASTE,Below 0.5,47,RUDRAVARAM,365,124,121,3,124,0,0,0,0,0
ANDHRA PRADESH,KURNOOL,SCHEDULED CASTE,Below 0.5,48,ALLAGADDA,471,146,92,55,147,0,0,0,0,0
ANDHRA PRADESH,KURNOOL,SCHEDULED CASTE,Below 0.5,49,DORNIPADU,369,129,129,0,129,0,0,0,0,0
ANDHRA PRADESH,KURNOOL,SCHEDULED CASTE,Below 0.5,50,SANJAMALA,181,67,67,0,67,0,0,0,0,0
ANDHRA PRADESH,KURNOOL,SCHEDULED CASTE,Below 0.5,51,KOLIMIGUNDLA,140,44,44,0,44,0,0,0,0,0
ANDHRA PRADESH,KURNOOL,SCHEDULED CASTE,Below 0.5,52,UYYALAWADA,246,88,88,0,88,0,0,0,0,0
ANDHRA PRADESH,KURNOOL,SCHEDULED CASTE,Below 0.5,53,CHAGALAMARRI,496,158,111,47,158,0,0,0,0,0
ANDHRA PRADESH,KURNOOL,SCHEDULED CASTE,Below 0.5,54,CHAGALAMARRI,496,158,111,47,158,0,0,0,0,0
ANDHRA PRADESH,KURNOOL,OTHERS,Below 0.5,1,MANTRALAYAM,1994,634,634,0,634,0,0,0,0,0
ANDHRA PRADESH,KURNOOL,OTHERS,Below 0.5,2,KOSIGI,2160,734,734,0,734,0,0,0,0,0
ANDHRA PRADESH,KURNOOL,OTHERS,Below 0.5,3,KOWTHALAM,2971,1000,1000,0,1000,0,0,0,0,0
ANDHRA PRADESH,KURNOOL,OTHERS,Below 0.5,4,PEDDA KADUBUR,1941,637,637,0,637,0,0,0,0,0
ANDHRA PRADESH,KURNOOL,OTHERS,Below 0.5,5,YEMMIGANUR,2445,811,788,15,803,1,4,0,5,3
ANDHRA PRADESH,KURNOOL,OTHERS,Below 0.5,6,NANDAVARAM,2114,742,711,12,723,3,9,0,12,7
ANDHRA PRADESH,KURNOOL,OTHERS,Below 0.5,7,C.BELAGAL,2536,841,841,0,841,0,0,0,0,0
ANDHRA PRADESH,KURNOOL,OTHERS,Below 0.5,8,GUDUR,1785,563,563,0,563,0,0,0,0,0
ANDHRA PRADESH,KURNOOL,OTHERS,Below 0.5,9,KALLUR,2379,773,768,5,773,0,0,0,0,0
ANDHRA PRADESH,KURNOOL,OTHERS,Below 0.5,10,KURNOOL,3207,976,946,30,976,0,0,0,0,0
ANDHRA PRADESH,KURNOOL,OTHERS,Below 0.5,11,NANDIKOTKUR,1709,550,500,49,549,0,1,0,1,0
ANDHRA PRADESH,KURNOOL,OTHERS,Below 0.5,12,PAGIDYALA,1630,500,340,138,478,0,11,0,11,10
ANDHRA PRADESH,KURNOOL,OTHERS,Below 0.5,13,JUPADU BUNGALOW,960,334,312,22,334,0,0,0,0,0
ANDHRA PRADESH,KURNOOL,OTHERS,Below 0.5,14,KOTHAPALLE,1064,351,304,47,351,0,0,0,0,0
ANDHRA PRADESH,KURNOOL,OTHERS,Below 0.5,15,ATMAKUR,2457,824,824,0,824,0,0,0,0,0
ANDHRA PRADESH,KURNOOL,OTHERS,Below 0.5,16,PAMULAPADU,3079,947,886,61,947,0,0,0,0,0
ANDHRA PRADESH,KURNOOL,OTHERS,Below 0.5,17,MIDTHUR,1183,419,419,0,419,0,0,0,0,0
ANDHRA PRADESH,KURNOOL,OTHERS,Below 0.5,18,ORVAKAL,2314,684,578,106,684,0,0,0,0,0
ANDHRA PRADESH,KURNOOL,OTHERS,Below 0.5,19,KODUMUR,1824,594,594,0,594,0,0,0,0,0
ANDHRA PRADESH,KURNOOL,OTHERS,Below 0.5,20,GONEGANDLA,2903,834,834,0,834,0,0,0,0,0
ANDHRA PRADESH,KURNOOL,OTHERS,Below 0.5,21,ADONI,3096,1052,985,67,1052,0,0,0,0,0
ANDHRA PRADESH,KURNOOL,OTHERS,Below 0.5,22,HOLAGUNDA,1111,392,323,69,392,0,0,0,0,0
ANDHRA PRADESH,KURNOOL,OTHERS,Below 0.5,23,HALAHARVI,1863,625,607,18,625,0,0,0,0,0
ANDHRA PRADESH,KURNOOL,OTHERS,Below 0.5,24,ALUR,470,172,172,0,172,0,0,0,0,0
ANDHRA PRADESH,KURNOOL,OTHERS,Below 0.5,25,ASPARI,1167,431,385,47,432,0,0,0,0,0
ANDHRA PRADESH,KURNOOL,OTHERS,Below 0.5,26,DEVANAKONDA,904,348,317,31,348,0,0,0,0,0
ANDHRA PRADESH,KURNOOL,OTHERS,Below 0.5,27,KRISHNAGIRI,678,241,241,0,241,0,0,0,0,0
ANDHRA PRADESH,KURNOOL,OTHERS,Below 0.5,28,VELDURTHI,1209,414,354,59,413,0,0,0,0,0
ANDHRA PRADESH,KURNOOL,OTHERS,Below 0.5,29,BETHAMCHERLA,782,276,276,1,277,0,0,0,0,0
ANDHRA PRADESH,KURNOOL,OTHERS,Below 0.5,30,PANYAM,2126,639,475,164,639,0,0,0,0,0
ANDHRA PRADESH,KURNOOL,OTHERS,Below 0.5,31,GADIVEMULA,1844,587,542,33,575,0,8,0,8,4
ANDHRA PRADESH,KURNOOL,OTHERS,Below 0.5,32,VELGODE,1835,581,581,0,581,0,0,0,0,0
ANDHRA PRADESH,KURNOOL,OTHERS,Below 0.5,33,BANDI ATMAKUR,4113,1204,1198,5,1203,0,0,0,0,0
ANDHRA PRADESH,KURNOOL,OTHERS,Below 0.5,34,NANDYAL,5545,1565,1560,5,1565,0,0,0,0,0
ANDHRA PRADESH,KURNOOL,OTHERS,Below 0.5,35,MAHANANDI,1447,438,438,0,438,0,0,0,0,0
ANDHRA PRADESH,KURNOOL,OTHERS,Below 0.5,36,SIRVEL,3058,977,977,0,977,0,0,0,0,0
ANDHRA PRADESH,KURNOOL,OTHERS,Below 0.5,37,GOSPADU,2536,793,793,0,793,0,0,0,0,0
ANDHRA PRADESH,KURNOOL,OTHERS,Below 0.5,38,BANAGANAPALLE,2552,832,616,216,832,0,0,0,0,0
ANDHRA PRADESH,KURNOOL,OTHERS,Below 0.5,39,DHONE,1464,452,424,28,452,0,0,0,0,0
ANDHRA PRADESH,KURNOOL,OTHERS,Below 0.5,40,PATTIKONDA,539,195,188,7,195,0,0,0,0,0
ANDHRA PRADESH,KURNOOL,OTHERS,Below 0.5,41,CHIPPAGIRI,674,254,254,0,254,0,0,0,0,0
ANDHRA PRADESH,KURNOOL,OTHERS,Below 0.5,42,MADDIKERA (EAST),485,173,171,2,173,0,0,0,0,0
ANDHRA PRADESH,KURNOOL,OTHERS,Below 0.5,43,TUGGALI,645,204,204,0,204,0,0,0,0,0
ANDHRA PRADESH,KURNOOL,OTHERS,Below 0.5,44,PEAPALLY,805,289,283,5,288,0,0,0,0,0
ANDHRA PRADESH,KURNOOL,OTHERS,Below 0.5,45,OWK,1621,455,403,51,454,0,0,0,0,0
ANDHRA PRADESH,KURNOOL,OTHERS,Below 0.5,46,KOILKUNTLA,1274,454,454,0,454,0,0,0,0,0
ANDHRA PRADESH,KURNOOL,OTHERS,Below 0.5,47,RUDRAVARAM,2070,658,658,0,658,0,0,0,0,0
ANDHRA PRADESH,KURNOOL,OTHERS,Below 0.5,48,ALLAGADDA,3430,1062,432,630,1062,0,0,0,0,0
ANDHRA PRADESH,KURNOOL,OTHERS,Below 0.5,49,DORNIPADU,1337,446,446,0,446,0,0,0,0,0
ANDHRA PRADESH,KURNOOL,OTHERS,Below 0.5,50,SANJAMALA,1069,356,356,0,356,0,0,0,0,0
ANDHRA PRADESH,KURNOOL,OTHERS,Below 0.5,51,KOLIMIGUNDLA,1036,299,299,0,299,0,0,0,0,0
ANDHRA PRADESH,KURNOOL,OTHERS,Below 0.5,52,UYYALAWADA,971,330,330,0,330,0,0,0,0,0
ANDHRA PRADESH,KURNOOL,OTHERS,Below 0.5,53,CHAGALAMARRI,2823,776,501,275,776,0,0,0,0,0
ANDHRA PRADESH,KURNOOL,OTHERS,Below 0.5,54,CHAGALAMARRI,2823,776,501,275,776,0,0,0,0,0
ANDHRA PRADESH,KURNOOL,SCHEDULED TRIBES,Below 0.5,1,MANTRALAYAM,27,10,10,0,10,0,0,0,0,0
ANDHRA PRADESH,KURNOOL,SCHEDULED TRIBES,Below 0.5,2,KOSIGI,22,7,4,4,8,0,0,0,0,0
ANDHRA PRADESH,KURNOOL,SCHEDULED TRIBES,Below 0.5,3,KOWTHALAM,81,29,29,0,29,0,0,0,0,0
ANDHRA PRADESH,KURNOOL,SCHEDULED TRIBES,Below 0.5,4,PEDDA KADUBUR,2,1,1,0,1,0,0,0,0,0
ANDHRA PRADESH,KURNOOL,SCHEDULED TRIBES,Below 0.5,5,YEMMIGANUR,6,2,1,1,2,0,0,0,0,0
ANDHRA PRADESH,KURNOOL,SCHEDULED TRIBES,Below 0.5,6,NANDAVARAM,5,2,1,1,2,0,0,0,0,0
ANDHRA PRADESH,KURNOOL,SCHEDULED TRIBES,Below 0.5,7,C.BELAGAL,3,1,0,0,0,0,0,0,0,0
ANDHRA PRADESH,KURNOOL,SCHEDULED TRIBES,Below 0.5,8,GUDUR,0,0,0,0,0,0,0,0,0,0
ANDHRA PRADESH,KURNOOL,SCHEDULED TRIBES,Below 0.5,9,KALLUR,63,18,18,0,18,0,0,0,0,0
ANDHRA PRADESH,KURNOOL,SCHEDULED TRIBES,Below 0.5,10,KURNOOL,61,19,19,0,19,0,0,0,0,0
ANDHRA PRADESH,KURNOOL,SCHEDULED TRIBES,Below 0.5,11,NANDIKOTKUR,43,14,12,1,13,0,0,0,0,0
ANDHRA PRADESH,KURNOOL,SCHEDULED TRIBES,Below 0.5,12,PAGIDYALA,8,3,2,2,4,0,0,0,0,0
ANDHRA PRADESH,KURNOOL,SCHEDULED TRIBES,Below 0.5,13,JUPADU BUNGALOW,19,8,4,4,8,0,0,0,0,0
ANDHRA PRADESH,KURNOOL,SCHEDULED TRIBES,Below 0.5,14,KOTHAPALLE,56,18,18,0,18,0,0,0,0,0
ANDHRA PRADESH,KURNOOL,SCHEDULED TRIBES,Below 0.5,15,ATMAKUR,151,55,55,0,55,0,0,0,0,0
ANDHRA PRADESH,KURNOOL,SCHEDULED TRIBES,Below 0.5,16,PAMULAPADU,127,35,30,5,35,0,0,0,0,0
ANDHRA PRADESH,KURNOOL,SCHEDULED TRIBES,Below 0.5,17,MIDTHUR,7,3,1,1,2,0,0,0,0,0
ANDHRA PRADESH,KURNOOL,SCHEDULED TRIBES,Below 0.5,18,ORVAKAL,67,21,21,0,21,0,0,0,0,0
ANDHRA PRADESH,KURNOOL,SCHEDULED TRIBES,Below 0.5,19,KODUMUR,7,2,1,1,2,0,0,0,0,0
ANDHRA PRADESH,KURNOOL,SCHEDULED TRIBES,Below 0.5,20,GONEGANDLA,88,14,14,0,14,0,0,0,0,0
ANDHRA PRADESH,KURNOOL,SCHEDULED TRIBES,Below 0.5,21,ADONI,5,2,2,0,2,0,0,0,0,0
ANDHRA PRADESH,KURNOOL,SCHEDULED TRIBES,Below 0.5,22,HOLAGUNDA,59,22,21,1,22,0,0,0,0,0
ANDHRA PRADESH,KURNOOL,SCHEDULED TRIBES,Below 0.5,23,HALAHARVI,2,1,0,0,0,0,0,0,0,0
ANDHRA PRADESH,KURNOOL,SCHEDULED TRIBES,Below 0.5,24,ALUR,15,6,6,0,6,0,0,0,0,0
ANDHRA PRADESH,KURNOOL,SCHEDULED TRIBES,Below 0.5,25,ASPARI,11,4,2,2,4,0,0,0,0,0
ANDHRA PRADESH,KURNOOL,SCHEDULED TRIBES,Below 0.5,26,DEVANAKONDA,9,4,2,2,4,0,0,0,0,0
ANDHRA PRADESH,KURNOOL,SCHEDULED TRIBES,Below 0.5,27,KRISHNAGIRI,19,7,7,0,7,0,0,0,0,0
ANDHRA PRADESH,KURNOOL,SCHEDULED TRIBES,Below 0.5,28,VELDURTHI,2,1,0,0,0,0,0,0,0,0
ANDHRA PRADESH,KURNOOL,SCHEDULED TRIBES,Below 0.5,29,BETHAMCHERLA,48,18,18,1,19,0,0,0,0,0
ANDHRA PRADESH,KURNOOL,SCHEDULED TRIBES,Below 0.5,30,PANYAM,116,42,42,0,42,0,0,0,0,0
ANDHRA PRADESH,KURNOOL,SCHEDULED TRIBES,Below 0.5,31,GADIVEMULA,86,31,31,0,31,0,0,0,0,0
ANDHRA PRADESH,KURNOOL,SCHEDULED TRIBES,Below 0.5,32,VELGODE,88,31,31,0,31,0,0,0,0,0
ANDHRA PRADESH,KURNOOL,SCHEDULED TRIBES,Below 0.5,33,BANDI ATMAKUR,203,64,64,0,64,0,0,0,0,0
ANDHRA PRADESH,KURNOOL,SCHEDULED TRIBES,Below 0.5,34,NANDYAL,27,8,8,0,8,0,0,0,0,0
ANDHRA PRADESH,KURNOOL,SCHEDULED TRIBES,Below 0.5,35,MAHANANDI,34,10,5,5,10,0,0,0,0,0
ANDHRA PRADESH,KURNOOL,SCHEDULED TRIBES,Below 0.5,36,SIRVEL,80,29,29,0,29,0,0,0,0,0
ANDHRA PRADESH,KURNOOL,SCHEDULED TRIBES,Below 0.5,37,GOSPADU,34,9,9,0,9,0,0,0,0,0
ANDHRA PRADESH,KURNOOL,SCHEDULED TRIBES,Below 0.5,38,BANAGANAPALLE,196,66,39,27,66,0,0,0,0,0
ANDHRA PRADESH,KURNOOL,SCHEDULED TRIBES,Below 0.5,39,DHONE,54,16,12,4,16,0,0,0,0,0
ANDHRA PRADESH,KURNOOL,SCHEDULED TRIBES,Below 0.5,40,PATTIKONDA,281,66,66,0,66,0,0,0,0,0
ANDHRA PRADESH,KURNOOL,SCHEDULED TRIBES,Below 0.5,41,CHIPPAGIRI,1,0,0,0,0,0,0,0,0,0
ANDHRA PRADESH,KURNOOL,SCHEDULED TRIBES,Below 0.5,42,MADDIKERA (EAST),5,2,2,0,2,0,0,0,0,0
ANDHRA PRADESH,KURNOOL,SCHEDULED TRIBES,Below 0.5,43,TUGGALI,140,52,52,0,52,0,0,0,0,0
ANDHRA PRADESH,KURNOOL,SCHEDULED TRIBES,Below 0.5,44,PEAPALLY,47,16,16,0,16,0,0,0,0,0
ANDHRA PRADESH,KURNOOL,SCHEDULED TRIBES,Below 0.5,45,OWK,147,50,45,5,50,0,0,0,0,0
ANDHRA PRADESH,KURNOOL,SCHEDULED TRIBES,Below 0.5,46,KOILKUNTLA,26,10,5,5,10,0,0,0,0,0
ANDHRA PRADESH,KURNOOL,SCHEDULED TRIBES,Below 0.5,47,RUDRAVARAM,54,19,19,0,19,0,0,0,0,0
ANDHRA PRADESH,KURNOOL,SCHEDULED TRIBES,Below 0.5,48,ALLAGADDA,92,30,15,15,30,0,0,0,0,0
ANDHRA PRADESH,KURNOOL,SCHEDULED TRIBES,Below 0.5,49,DORNIPADU,19,5,3,2,5,0,0,0,0,0
ANDHRA PRADESH,KURNOOL,SCHEDULED TRIBES,Below 0.5,50,SANJAMALA,16,6,6,0,6,0,0,0,0,0
ANDHRA PRADESH,KURNOOL,SCHEDULED TRIBES,Below 0.5,51,KOLIMIGUNDLA,32,11,11,0,11,0,0,0,0,0
ANDHRA PRADESH,KURNOOL,SCHEDULED TRIBES,Below 0.5,52,UYYALAWADA,5,2,2,0,2,0,0,0,0,0
ANDHRA PRADESH,KURNOOL,SCHEDULED TRIBES,Below 0.5,53,CHAGALAMARRI,69,22,18,3,21,0,0,0,0,0
ANDHRA PRADESH,KURNOOL,SCHEDULED TRIBES,Below 0.5,54,CHAGALAMARRI,69,22,18,3,21,0,0,0,0,0
ANDHRA PRADESH,KURNOOL,ALL SOCIAL GROUPS,Below 0.5,1,MANTRALAYAM,2326,743,743,0,743,0,0,0,0,0
ANDHRA PRADESH,KURNOOL,ALL SOCIAL GROUPS,Below 0.5,2,KOSIGI,2419,827,823,4,827,0,0,0,0,0
ANDHRA PRADESH,KURNOOL,ALL SOCIAL GROUPS,Below 0.5,3,KOWTHALAM,3559,1206,1206,0,1206,0,0,0,0,0
ANDHRA PRADESH,KURNOOL,ALL SOCIAL GROUPS,Below 0.5,4,PEDDA KADUBUR,2362,784,784,0,784,0,0,0,0,0
ANDHRA PRADESH,KURNOOL,ALL SOCIAL GROUPS,Below 0.5,5,YEMMIGANUR,3024,1003,957,37,994,1,5,0,6,3
ANDHRA PRADESH,KURNOOL,ALL SOCIAL GROUPS,Below 0.5,6,NANDAVARAM,2569,911,876,17,893,3,9,0,12,7
ANDHRA PRADESH,KURNOOL,ALL SOCIAL GROUPS,Below 0.5,7,C.BELAGAL,3166,1043,1043,0,1043,0,0,0,0,0
ANDHRA PRADESH,KURNOOL,ALL SOCIAL GROUPS,Below 0.5,8,GUDUR,2178,694,694,0,694,0,0,0,0,0
ANDHRA PRADESH,KURNOOL,ALL SOCIAL GROUPS,Below 0.5,9,KALLUR,2958,958,953,5,958,0,0,0,0,0
ANDHRA PRADESH,KURNOOL,ALL SOCIAL GROUPS,Below 0.5,10,KURNOOL,4077,1247,1212,36,1248,0,0,0,0,0
ANDHRA PRADESH,KURNOOL,ALL SOCIAL GROUPS,Below 0.5,11,NANDIKOTKUR,2349,739,676,62,738,0,1,0,1,1
ANDHRA PRADESH,KURNOOL,ALL SOCIAL GROUPS,Below 0.5,12,PAGIDYALA,2047,629,413,190,603,0,16,0,16,10
ANDHRA PRADESH,KURNOOL,ALL SOCIAL GROUPS,Below 0.5,13,JUPADU BUNGALOW,1315,457,421,36,457,0,0,0,0,0
ANDHRA PRADESH,KURNOOL,ALL SOCIAL GROUPS,Below 0.5,14,KOTHAPALLE,1450,479,416,63,479,0,0,0,0,0
ANDHRA PRADESH,KURNOOL,ALL SOCIAL GROUPS,Below 0.5,15,ATMAKUR,3400,1166,1166,0,1166,0,0,0,0,0
ANDHRA PRADESH,KURNOOL,ALL SOCIAL GROUPS,Below 0.5,16,PAMULAPADU,3992,1216,1138,78,1216,0,0,0,0,0
ANDHRA PRADESH,KURNOOL,ALL SOCIAL GROUPS,Below 0.5,17,MIDTHUR,1496,527,517,10,527,0,0,0,0,0
ANDHRA PRADESH,KURNOOL,ALL SOCIAL GROUPS,Below 0.5,18,ORVAKAL,2879,852,697,155,852,0,0,0,0,0
ANDHRA PRADESH,KURNOOL,ALL SOCIAL GROUPS,Below 0.5,19,KODUMUR,2128,698,697,1,698,0,0,0,0,0
ANDHRA PRADESH,KURNOOL,ALL SOCIAL GROUPS,Below 0.5,20,GONEGANDLA,3681,1001,1001,0,1001,0,0,0,0,0
ANDHRA PRADESH,KURNOOL,ALL SOCIAL GROUPS,Below 0.5,21,ADONI,3673,1248,1182,67,1249,0,0,0,0,0
ANDHRA PRADESH,KURNOOL,ALL SOCIAL GROUPS,Below 0.5,22,HOLAGUNDA,1347,477,393,84,477,0,0,0,0,0
ANDHRA PRADESH,KURNOOL,ALL SOCIAL GROUPS,Below 0.5,23,HALAHARVI,2066,700,663,37,700,0,0,0,0,0
ANDHRA PRADESH,KURNOOL,ALL SOCIAL GROUPS,Below 0.5,24,ALUR,612,224,224,0,224,0,0,0,0,0
ANDHRA PRADESH,KURNOOL,ALL SOCIAL GROUPS,Below 0.5,25,ASPARI,1229,452,404,49,453,0,0,0,0,0
ANDHRA PRADESH,KURNOOL,ALL SOCIAL GROUPS,Below 0.5,26,DEVANAKONDA,1152,441,402,39,441,0,0,0,0,0
ANDHRA PRADESH,KURNOOL,ALL SOCIAL GROUPS,Below 0.5,27,KRISHNAGIRI,810,289,289,0,289,0,0,0,0,0
ANDHRA PRADESH,KURNOOL,ALL SOCIAL GROUPS,Below 0.5,28,VELDURTHI,1601,549,482,66,548,0,0,0,0,0
ANDHRA PRADESH,KURNOOL,ALL SOCIAL GROUPS,Below 0.5,29,BETHAMCHERLA,1082,388,387,1,388,0,0,0,0,0
ANDHRA PRADESH,KURNOOL,ALL SOCIAL GROUPS,Below 0.5,30,PANYAM,2803,861,670,191,861,0,0,0,0,0
ANDHRA PRADESH,KURNOOL,ALL SOCIAL GROUPS,Below 0.5,31,GADIVEMULA,2411,775,730,33,763,0,8,0,8,4
ANDHRA PRADESH,KURNOOL,ALL SOCIAL GROUPS,Below 0.5,32,VELGODE,2450,769,769,0,769,0,0,0,0,0
ANDHRA PRADESH,KURNOOL,ALL SOCIAL GROUPS,Below 0.5,33,BANDI ATMAKUR,5136,1509,1502,7,1509,0,0,0,0,0
ANDHRA PRADESH,KURNOOL,ALL SOCIAL GROUPS,Below 0.5,34,NANDYAL,6229,1758,1753,6,1759,0,0,0,0,0
ANDHRA PRADESH,KURNOOL,ALL SOCIAL GROUPS,Below 0.5,35,MAHANANDI,1722,516,511,5,516,0,0,0,0,0
ANDHRA PRADESH,KURNOOL,ALL SOCIAL GROUPS,Below 0.5,36,SIRVEL,3727,1203,1203,0,1203,0,0,0,0,0
ANDHRA PRADESH,KURNOOL,ALL SOCIAL GROUPS,Below 0.5,37,GOSPADU,3538,1072,1072,0,1072,0,0,0,0,0
ANDHRA PRADESH,KURNOOL,ALL SOCIAL GROUPS,Below 0.5,38,BANAGANAPALLE,3226,1063,808,255,1063,0,0,0,0,0
ANDHRA PRADESH,KURNOOL,ALL SOCIAL GROUPS,Below 0.5,39,DHONE,1723,536,501,35,536,0,0,0,0,0
ANDHRA PRADESH,KURNOOL,ALL SOCIAL GROUPS,Below 0.5,40,PATTIKONDA,914,296,286,10,296,0,0,0,0,0
ANDHRA PRADESH,KURNOOL,ALL SOCIAL GROUPS,Below 0.5,41,CHIPPAGIRI,800,302,302,0,302,0,0,0,0,0
ANDHRA PRADESH,KURNOOL,ALL SOCIAL GROUPS,Below 0.5,42,MADDIKERA (EAST),521,188,185,2,187,0,0,0,0,0
ANDHRA PRADESH,KURNOOL,ALL SOCIAL GROUPS,Below 0.5,43,TUGGALI,877,286,286,0,286,0,0,0,0,0
ANDHRA PRADESH,KURNOOL,ALL SOCIAL GROUPS,Below 0.5,44,PEAPALLY,970,346,341,5,346,0,0,0,0,0
ANDHRA PRADESH,KURNOOL,ALL SOCIAL GROUPS,Below 0.5,45,OWK,2224,642,569,73,642,0,0,0,0,0
ANDHRA PRADESH,KURNOOL,ALL SOCIAL GROUPS,Below 0.5,46,KOILKUNTLA,1744,630,625,5,630,0,0,0,0,0
ANDHRA PRADESH,KURNOOL,ALL SOCIAL GROUPS,Below 0.5,47,RUDRAVARAM,2489,801,798,3,801,0,0,0,0,0
ANDHRA PRADESH,KURNOOL,ALL SOCIAL GROUPS,Below 0.5,48,ALLAGADDA,3993,1239,539,700,1239,0,0,0,0,0
ANDHRA PRADESH,KURNOOL,ALL SOCIAL GROUPS,Below 0.5,49,DORNIPADU,1725,580,578,2,580,0,0,0,0,0
ANDHRA PRADESH,KURNOOL,ALL SOCIAL GROUPS,Below 0.5,50,SANJAMALA,1266,428,428,0,428,0,0,0,0,0
ANDHRA PRADESH,KURNOOL,ALL SOCIAL GROUPS,Below 0.5,51,KOLIMIGUNDLA,1208,353,353,0,353,0,0,0,0,0
ANDHRA PRADESH,KURNOOL,ALL SOCIAL GROUPS,Below 0.5,52,UYYALAWADA,1222,420,420,0,420,0,0,0,0,0
ANDHRA PRADESH,KURNOOL,ALL SOCIAL GROUPS,Below 0.5,53,CHAGALAMARRI,3388,955,630,325,955,0,0,0,0,0
ANDHRA PRADESH,KURNOOL,ALL SOCIAL GROUPS,Below 0.5,54,CHAGALAMARRI,3388,955,630,325,955,0,0,0,0,0
ANDHRA PRADESH,KURNOOL,INSTITUTIONAL,1.0-2.0,1,MANTRALAYAM,0,0,0,0,0,0,0,0,0,0
ANDHRA PRADESH,KURNOOL,INSTITUTIONAL,1.0-2.0,2,KOSIGI,0,0,0,0,0,0,0,0,0,0
ANDHRA PRADESH,KURNOOL,INSTITUTIONAL,1.0-2.0,3,KOWTHALAM,0,0,0,0,0,0,0,0,0,0
ANDHRA PRADESH,KURNOOL,INSTITUTIONAL,1.0-2.0,4,PEDDA KADUBUR,0,0,0,0,0,0,0,0,0,0
ANDHRA PRADESH,KURNOOL,INSTITUTIONAL,1.0-2.0,5,YEMMIGANUR,0,0,0,0,0,0,0,0,0,0
ANDHRA PRADESH,KURNOOL,INSTITUTIONAL,1.0-2.0,6,NANDAVARAM,0,0,0,0,0,0,0,0,0,0
ANDHRA PRADESH,KURNOOL,INSTITUTIONAL,1.0-2.0,7,C.BELAGAL,0,0,0,0,0,0,0,0,0,0
ANDHRA PRADESH,KURNOOL,INSTITUTIONAL,1.0-2.0,8,GUDUR,0,0,0,0,0,0,0,0,0,0
ANDHRA PRADESH,KURNOOL,INSTITUTIONAL,1.0-2.0,9,KALLUR,0,0,0,0,0,0,0,0,0,0
ANDHRA PRADESH,KURNOOL,INSTITUTIONAL,1.0-2.0,10,KURNOOL,0,0,0,0,0,0,0,0,0,0
ANDHRA PRADESH,KURNOOL,INSTITUTIONAL,1.0-2.0,11,NANDIKOTKUR,0,0,0,0,0,0,0,0,0,0
ANDHRA PRADESH,KURNOOL,INSTITUTIONAL,1.0-2.0,12,PAGIDYALA,0,0,0,0,0,0,0,0,0,0
ANDHRA PRADESH,KURNOOL,INSTITUTIONAL,1.0-2.0,13,JUPADU BUNGALOW,0,0,0,0,0,0,0,0,0,0
ANDHRA PRADESH,KURNOOL,INSTITUTIONAL,1.0-2.0,14,KOTHAPALLE,0,0,0,0,0,0,0,0,0,0
ANDHRA PRADESH,KURNOOL,INSTITUTIONAL,1.0-2.0,15,ATMAKUR,0,0,0,0,0,0,0,0,0,0
ANDHRA PRADESH,KURNOOL,INSTITUTIONAL,1.0-2.0,16,PAMULAPADU,0,0,0,0,0,0,0,0,0,0
ANDHRA PRADESH,KURNOOL,INSTITUTIONAL,1.0-2.0,17,MIDTHUR,0,0,0,0,0,0,0,0,0,0
ANDHRA PRADESH,KURNOOL,INSTITUTIONAL,1.0-2.0,18,ORVAKAL,1,2,2,0,2,0,0,0,0,0
ANDHRA PRADESH,KURNOOL,INSTITUTIONAL,1.0-2.0,19,KODUMUR,0,0,0,0,0,0,0,0,0,0
ANDHRA PRADESH,KURNOOL,INSTITUTIONAL,1.0-2.0,20,GONEGANDLA,0,0,0,0,0,0,0,0,0,0
ANDHRA PRADESH,KURNOOL,INSTITUTIONAL,1.0-2.0,21,ADONI,0,0,0,0,0,0,0,0,0,0
ANDHRA PRADESH,KURNOOL,INSTITUTIONAL,1.0-2.0,22,HOLAGUNDA,0,0,0,0,0,0,0,0,0,0
ANDHRA PRADESH,KURNOOL,INSTITUTIONAL,1.0-2.0,23,HALAHARVI,0,0,0,0,0,0,0,0,0,0
ANDHRA PRADESH,KURNOOL,INSTITUTIONAL,1.0-2.0,24,ALUR,0,0,0,0,0,0,0,0,0,0
ANDHRA PRADESH,KURNOOL,INSTITUTIONAL,1.0-2.0,25,ASPARI,0,0,0,0,0,0,0,0,0,0
ANDHRA PRADESH,KURNOOL,INSTITUTIONAL,1.0-2.0,26,DEVANAKONDA,0,0,0,0,0,0,0,0,0,0
ANDHRA PRADESH,KURNOOL,INSTITUTIONAL,1.0-2.0,27,KRISHNAGIRI,0,0,0,0,0,0,0,0,0,0
ANDHRA PRADESH,KURNOOL,INSTITUTIONAL,1.0-2.0,28,VELDURTHI,0,0,0,0,0,0,0,0,0,0
ANDHRA PRADESH,KURNOOL,INSTITUTIONAL,1.0-2.0,29,BETHAMCHERLA,0,0,0,0,0,0,0,0,0,0
ANDHRA PRADESH,KURNOOL,INSTITUTIONAL,1.0-2.0,30,PANYAM,1,2,1,1,2,0,0,0,0,0
ANDHRA PRADESH,KURNOOL,INSTITUTIONAL,1.0-2.0,31,GADIVEMULA,0,0,0,0,0,0,0,0,0,0
ANDHRA PRADESH,KURNOOL,INSTITUTIONAL,1.0-2.0,32,VELGODE,0,0,0,0,0,0,0,0,0,0
ANDHRA PRADESH,KURNOOL,INSTITUTIONAL,1.0-2.0,33,BANDI ATMAKUR,0,0,0,0,0,0,0,0,0,0
ANDHRA PRADESH,KURNOOL,INSTITUTIONAL,1.0-2.0,34,NANDYAL,0,0,0,0,0,0,0,0,0,0
ANDHRA PRADESH,KURNOOL,INSTITUTIONAL,1.0-2.0,35,MAHANANDI,0,0,0,0,0,0,0,0,0,0
ANDHRA PRADESH,KURNOOL,INSTITUTIONAL,1.0-2.0,36,SIRVEL,0,0,0,0,0,0,0,0,0,0
ANDHRA PRADESH,KURNOOL,INSTITUTIONAL,1.0-2.0,37,GOSPADU,0,0,0,0,0,0,0,0,0,0
ANDHRA PRADESH,KURNOOL,INSTITUTIONAL,1.0-2.0,38,BANAGANAPALLE,0,0,0,0,0,0,0,0,0,0
ANDHRA PRADESH,KURNOOL,INSTITUTIONAL,1.0-2.0,39,DHONE,0,0,0,0,0,0,0,0,0,0
ANDHRA PRADESH,KURNOOL,INSTITUTIONAL,1.0-2.0,40,PATTIKONDA,0,0,0,0,0,0,0,0,0,0
ANDHRA PRADESH,KURNOOL,INSTITUTIONAL,1.0-2.0,41,CHIPPAGIRI,0,0,0,0,0,0,0,0,0,0
ANDHRA PRADESH,KURNOOL,INSTITUTIONAL,1.0-2.0,42,MADDIKERA (EAST),0,0,0,0,0,0,0,0,0,0
ANDHRA PRADESH,KURNOOL,INSTITUTIONAL,1.0-2.0,43,TUGGALI,0,0,0,0,0,0,0,0,0,0
ANDHRA PRADESH,KURNOOL,INSTITUTIONAL,1.0-2.0,44,PEAPALLY,0,0,0,0,0,0,0,0,0,0
ANDHRA PRADESH,KURNOOL,INSTITUTIONAL,1.0-2.0,45,OWK,0,0,0,0,0,0,0,0,0,0
ANDHRA PRADESH,KURNOOL,INSTITUTIONAL,1.0-2.0,46,KOILKUNTLA,0,0,0,0,0,0,0,0,0,0
ANDHRA PRADESH,KURNOOL,INSTITUTIONAL,1.0-2.0,47,RUDRAVARAM,0,0,0,0,0,0,0,0,0,0
ANDHRA PRADESH,KURNOOL,INSTITUTIONAL,1.0-2.0,48,ALLAGADDA,0,0,0,0,0,0,0,0,0,0
ANDHRA PRADESH,KURNOOL,INSTITUTIONAL,1.0-2.0,49,DORNIPADU,0,0,0,0,0,0,0,0,0,0
ANDHRA PRADESH,KURNOOL,INSTITUTIONAL,1.0-2.0,50,SANJAMALA,0,0,0,0,0,0,0,0,0,0
ANDHRA PRADESH,KURNOOL,INSTITUTIONAL,1.0-2.0,51,KOLIMIGUNDLA,0,0,0,0,0,0,0,0,0,0
ANDHRA PRADESH,KURNOOL,INSTITUTIONAL,1.0-2.0,52,UYYALAWADA,0,0,0,0,0,0,0,0,0,0
ANDHRA PRADESH,KURNOOL,INSTITUTIONAL,1.0-2.0,53,CHAGALAMARRI,0,0,0,0,0,0,0,0,0,0
ANDHRA PRADESH,KURNOOL,INSTITUTIONAL,1.0-2.0,54,CHAGALAMARRI,0,0,0,0,0,0,0,0,0,0
ANDHRA PRADESH,KURNOOL,SCHEDULED CASTE,1.0-2.0,1,MANTRALAYAM,271,380,367,14,381,0,0,0,0,0
ANDHRA PRADESH,KURNOOL,SCHEDULED CASTE,1.0-2.0,2,KOSIGI,301,411,411,0,411,0,0,0,0,0
ANDHRA PRADESH,KURNOOL,SCHEDULED CASTE,1.0-2.0,3,KOWTHALAM,636,912,912,0,912,0,0,0,0,0
ANDHRA PRADESH,KURNOOL,SCHEDULED CASTE,1.0-2.0,4,PEDDA KADUBUR,478,657,638,19,657,0,0,0,0,0
ANDHRA PRADESH,KURNOOL,SCHEDULED CASTE,1.0-2.0,5,YEMMIGANUR,569,773,752,15,767,0,6,0,6,0
ANDHRA PRADESH,KURNOOL,SCHEDULED CASTE,1.0-2.0,6,NANDAVARAM,613,862,857,0,857,2,0,0,2,2
ANDHRA PRADESH,KURNOOL,SCHEDULED CASTE,1.0-2.0,7,C.BELAGAL,383,528,522,6,528,0,0,0,0,0
ANDHRA PRADESH,KURNOOL,SCHEDULED CASTE,1.0-2.0,8,GUDUR,238,318,318,0,318,0,0,0,0,0
ANDHRA PRADESH,KURNOOL,SCHEDULED CASTE,1.0-2.0,9,KALLUR,378,525,503,22,525,0,0,0,0,0
ANDHRA PRADESH,KURNOOL,SCHEDULED CASTE,1.0-2.0,10,KURNOOL,495,675,672,3,675,0,0,0,0,0
ANDHRA PRADESH,KURNOOL,SCHEDULED CASTE,1.0-2.0,11,NANDIKOTKUR,258,357,327,30,357,0,0,0,0,0
ANDHRA PRADESH,KURNOOL,SCHEDULED CASTE,1.0-2.0,12,PAGIDYALA,106,145,42,101,143,0,2,0,2,0
ANDHRA PRADESH,KURNOOL,SCHEDULED CASTE,1.0-2.0,13,JUPADU BUNGALOW,586,829,760,59,819,0,10,0,10,0
ANDHRA PRADESH,KURNOOL,SCHEDULED CASTE,1.0-2.0,14,KOTHAPALLE,442,610,562,48,610,0,0,0,0,0
ANDHRA PRADESH,KURNOOL,SCHEDULED CASTE,1.0-2.0,15,ATMAKUR,346,471,471,0,471,0,0,0,0,0
ANDHRA PRADESH,KURNOOL,SCHEDULED CASTE,1.0-2.0,16,PAMULAPADU,406,544,540,4,544,0,0,0,0,0
ANDHRA PRADESH,KURNOOL,SCHEDULED CASTE,1.0-2.0,17,MIDTHUR,556,806,783,23,806,0,0,0,0,0
ANDHRA PRADESH,KURNOOL,SCHEDULED CASTE,1.0-2.0,18,ORVAKAL,365,498,352,146,498,0,0,0,0,0
ANDHRA PRADESH,KURNOOL,SCHEDULED CASTE,1.0-2.0,19,KODUMUR,274,380,380,0,380,0,0,0,0,0
ANDHRA PRADESH,KURNOOL,SCHEDULED CASTE,1.0-2.0,20,GONEGANDLA,878,1301,1178,124,1302,0,0,0,0,0
ANDHRA PRADESH,KURNOOL,SCHEDULED CASTE,1.0-2.0,21,ADONI,641,869,847,22,869,0,0,0,0,0
ANDHRA PRADESH,KURNOOL,SCHEDULED CASTE,1.0-2.0,22,HOLAGUNDA,408,577,462,115,577,0,0,0,0,0
ANDHRA PRADESH,KURNOOL,SCHEDULED CASTE,1.0-2.0,23,HALAHARVI,238,337,337,0,337,0,0,0,0,0
ANDHRA PRADESH,KURNOOL,SCHEDULED CASTE,1.0-2.0,24,ALUR,707,1009,1009,0,1009,0,0,0,0,0
ANDHRA PRADESH,KURNOOL,SCHEDULED CASTE,1.0-2.0,25,ASPARI,194,275,234,41,275,0,0,0,0,0
ANDHRA PRADESH,KURNOOL,SCHEDULED CASTE,1.0-2.0,26,DEVANAKONDA,873,1247,1202,45,1247,0,0,0,0,0
ANDHRA PRADESH,KURNOOL,SCHEDULED CASTE,1.0-2.0,27,KRISHNAGIRI,458,636,623,14,637,0,0,0,0,0
ANDHRA PRADESH,KURNOOL,SCHEDULED CASTE,1.0-2.0,28,VELDURTHI,537,795,667,128,795,0,0,0,0,0
ANDHRA PRADESH,KURNOOL,SCHEDULED CASTE,1.0-2.0,29,BETHAMCHERLA,464,633,633,0,633,0,0,0,0,0
ANDHRA PRADESH,KURNOOL,SCHEDULED CASTE,1.0-2.0,30,PANYAM,274,374,277,97,374,0,0,0,0,0
ANDHRA PRADESH,KURNOOL,SCHEDULED CASTE,1.0-2.0,31,GADIVEMULA,283,389,296,84,380,0,9,0,9,0
ANDHRA PRADESH,KURNOOL,SCHEDULED CASTE,1.0-2.0,32,VELGODE,189,258,258,0,258,0,0,0,0,0
ANDHRA PRADESH,KURNOOL,SCHEDULED CASTE,1.0-2.0,33,BANDI ATMAKUR,216,295,292,3,295,0,0,0,0,0
ANDHRA PRADESH,KURNOOL,SCHEDULED CASTE,1.0-2.0,34,NANDYAL,160,224,213,11,224,0,0,0,0,0
ANDHRA PRADESH,KURNOOL,SCHEDULED CASTE,1.0-2.0,35,MAHANANDI,104,144,143,0,143,0,0,0,0,1
ANDHRA PRADESH,KURNOOL,SCHEDULED CASTE,1.0-2.0,36,SIRVEL,230,298,298,0,298,0,0,0,0,0
ANDHRA PRADESH,KURNOOL,SCHEDULED CASTE,1.0-2.0,37,GOSPADU,131,176,176,0,176,0,0,0,0,0
ANDHRA PRADESH,KURNOOL,SCHEDULED CASTE,1.0-2.0,38,BANAGANAPALLE,407,553,484,69,553,0,0,0,0,0
ANDHRA PRADESH,KURNOOL,SCHEDULED CASTE,1.0-2.0,39,DHONE,450,640,626,14,640,0,0,0,0,0
ANDHRA PRADESH,KURNOOL,SCHEDULED CASTE,1.0-2.0,40,PATTIKONDA,520,725,725,0,725,0,0,0,0,0
ANDHRA PRADESH,KURNOOL,SCHEDULED CASTE,1.0-2.0,41,CHIPPAGIRI,340,483,483,0,483,0,0,0,0,0
ANDHRA PRADESH,KURNOOL,SCHEDULED CASTE,1.0-2.0,42,MADDIKERA (EAST),204,292,292,0,292,0,0,0,0,0
ANDHRA PRADESH,KURNOOL,SCHEDULED CASTE,1.0-2.0,43,TUGGALI,485,687,687,0,687,0,0,0,0,0
ANDHRA PRADESH,KURNOOL,SCHEDULED CASTE,1.0-2.0,44,PEAPALLY,692,933,899,35,934,0,0,0,0,0
ANDHRA PRADESH,KURNOOL,SCHEDULED CASTE,1.0-2.0,45,OWK,342,481,440,41,481,0,0,0,0,0
ANDHRA PRADESH,KURNOOL,SCHEDULED CASTE,1.0-2.0,46,KOILKUNTLA,219,302,302,0,302,0,0,0,0,0
ANDHRA PRADESH,KURNOOL,SCHEDULED CASTE,1.0-2.0,47,RUDRAVARAM,503,700,700,0,700,0,0,0,0,0
ANDHRA PRADESH,KURNOOL,SCHEDULED CASTE,1.0-2.0,48,ALLAGADDA,291,394,267,127,394,0,0,0,0,0
ANDHRA PRADESH,KURNOOL,SCHEDULED CASTE,1.0-2.0,49,DORNIPADU,130,172,172,0,172,0,0,0,0,0
ANDHRA PRADESH,KURNOOL,SCHEDULED CASTE,1.0-2.0,50,SANJAMALA,374,508,508,0,508,0,0,0,0,0
ANDHRA PRADESH,KURNOOL,SCHEDULED CASTE,1.0-2.0,51,KOLIMIGUNDLA,254,352,352,0,352,0,0,0,0,0
ANDHRA PRADESH,KURNOOL,SCHEDULED CASTE,1.0-2.0,52,UYYALAWADA,212,293,293,0,293,0,0,0,0,0
ANDHRA PRADESH,KURNOOL,SCHEDULED CASTE,1.0-2.0,53,CHAGALAMARRI,499,700,322,379,701,0,0,0,0,0
ANDHRA PRADESH,KURNOOL,SCHEDULED CASTE,1.0-2.0,54,CHAGALAMARRI,499,700,322,379,701,0,0,0,0,0
ANDHRA PRADESH,KURNOOL,OTHERS,1.0-2.0,1,MANTRALAYAM,2536,3615,3526,89,3615,0,0,0,0,0
ANDHRA PRADESH,KURNOOL,OTHERS,1.0-2.0,2,KOSIGI,3422,4783,4672,112,4784,0,0,0,0,0
ANDHRA PRADESH,KURNOOL,OTHERS,1.0-2.0,3,KOWTHALAM,4377,6262,6262,0,6262,0,0,0,0,0
ANDHRA PRADESH,KURNOOL,OTHERS,1.0-2.0,4,PEDDA KADUBUR,2353,3355,3267,88,3355,0,0,0,0,0
ANDHRA PRADESH,KURNOOL,OTHERS,1.0-2.0,5,YEMMIGANUR,3986,5665,5479,112,5591,3,43,0,46,27
ANDHRA PRADESH,KURNOOL,OTHERS,1.0-2.0,6,NANDAVARAM,3923,5654,5410,134,5544,22,49,0,71,40
ANDHRA PRADESH,KURNOOL,OTHERS,1.0-2.0,7,C.BELAGAL,3206,4490,4462,28,4490,0,0,0,0,0
ANDHRA PRADESH,KURNOOL,OTHERS,1.0-2.0,8,GUDUR,2534,3577,3561,16,3577,0,0,0,0,0
ANDHRA PRADESH,KURNOOL,OTHERS,1.0-2.0,9,KALLUR,3629,5145,4977,167,5144,0,0,0,0,0
ANDHRA PRADESH,KURNOOL,OTHERS,1.0-2.0,10,KURNOOL,3169,4443,4415,28,4443,0,0,0,0,0
ANDHRA PRADESH,KURNOOL,OTHERS,1.0-2.0,11,NANDIKOTKUR,2042,2913,2631,231,2862,22,7,4,33,18
ANDHRA PRADESH,KURNOOL,OTHERS,1.0-2.0,12,PAGIDYALA,926,1309,802,488,1290,0,10,0,10,9
ANDHRA PRADESH,KURNOOL,OTHERS,1.0-2.0,13,JUPADU BUNGALOW,2733,3975,3649,215,3864,0,70,0,70,40
ANDHRA PRADESH,KURNOOL,OTHERS,1.0-2.0,14,KOTHAPALLE,1719,2470,2240,230,2470,0,0,0,0,0
ANDHRA PRADESH,KURNOOL,OTHERS,1.0-2.0,15,ATMAKUR,2128,2963,2963,0,2963,0,0,0,0,0
ANDHRA PRADESH,KURNOOL,OTHERS,1.0-2.0,16,PAMULAPADU,1831,2535,2391,145,2536,0,0,0,0,0
ANDHRA PRADESH,KURNOOL,OTHERS,1.0-2.0,17,MIDTHUR,3129,4511,4458,53,4511,0,0,0,0,0
ANDHRA PRADESH,KURNOOL,OTHERS,1.0-2.0,18,ORVAKAL,3433,4868,4133,734,4867,0,0,0,0,0
ANDHRA PRADESH,KURNOOL,OTHERS,1.0-2.0,19,KODUMUR,3437,4900,4870,30,4900,0,0,0,0,0
ANDHRA PRADESH,KURNOOL,OTHERS,1.0-2.0,20,GONEGANDLA,3137,4446,4006,439,4445,0,0,0,0,0
ANDHRA PRADESH,KURNOOL,OTHERS,1.0-2.0,21,ADONI,5959,8508,8287,221,8508,0,0,0,0,0
ANDHRA PRADESH,KURNOOL,OTHERS,1.0-2.0,22,HOLAGUNDA,2921,4190,3367,824,4191,0,0,0,0,0
ANDHRA PRADESH,KURNOOL,OTHERS,1.0-2.0,23,HALAHARVI,2831,4077,4077,0,4077,0,0,0,0,0
ANDHRA PRADESH,KURNOOL,OTHERS,1.0-2.0,24,ALUR,3406,4963,4918,36,4954,0,6,0,6,3
ANDHRA PRADESH,KURNOOL,OTHERS,1.0-2.0,25,ASPARI,4985,7163,5711,1452,7163,0,0,0,0,0
ANDHRA PRADESH,KURNOOL,OTHERS,1.0-2.0,26,DEVANAKONDA,5168,7528,7357,171,7528,0,0,0,0,0
ANDHRA PRADESH,KURNOOL,OTHERS,1.0-2.0,27,KRISHNAGIRI,3668,5300,5138,162,5300,0,0,0,0,0
ANDHRA PRADESH,KURNOOL,OTHERS,1.0-2.0,28,VELDURTHI,3429,5046,4198,846,5044,2,0,0,2,1
ANDHRA PRADESH,KURNOOL,OTHERS,1.0-2.0,29,BETHAMCHERLA,3035,4310,4292,18,4310,0,0,0,0,0
ANDHRA PRADESH,KURNOOL,OTHERS,1.0-2.0,30,PANYAM,2563,3671,2706,961,3667,0,2,0,2,1
ANDHRA PRADESH,KURNOOL,OTHERS,1.0-2.0,31,GADIVEMULA,2406,3461,3340,67,3407,0,34,0,34,20
ANDHRA PRADESH,KURNOOL,OTHERS,1.0-2.0,32,VELGODE,1755,2464,2453,11,2464,0,0,0,0,0
ANDHRA PRADESH,KURNOOL,OTHERS,1.0-2.0,33,BANDI ATMAKUR,2454,3458,3406,49,3455,0,1,1,2,1
ANDHRA PRADESH,KURNOOL,OTHERS,1.0-2.0,34,NANDYAL,2605,3703,3688,13,3701,0,0,0,0,2
ANDHRA PRADESH,KURNOOL,OTHERS,1.0-2.0,35,MAHANANDI,1501,2107,2084,4,2088,2,0,10,12,7
ANDHRA PRADESH,KURNOOL,OTHERS,1.0-2.0,36,SIRVEL,2617,3689,3689,0,3689,0,0,0,0,0
ANDHRA PRADESH,KURNOOL,OTHERS,1.0-2.0,37,GOSPADU,1816,2565,2565,0,2565,0,0,0,0,0
ANDHRA PRADESH,KURNOOL,OTHERS,1.0-2.0,38,BANAGANAPALLE,5510,7826,5649,2177,7826,0,0,0,0,0
ANDHRA PRADESH,KURNOOL,OTHERS,1.0-2.0,39,DHONE,4073,5926,5860,66,5926,0,0,0,0,0
ANDHRA PRADESH,KURNOOL,OTHERS,1.0-2.0,40,PATTIKONDA,3354,4864,4855,8,4863,0,0,0,0,0
ANDHRA PRADESH,KURNOOL,OTHERS,1.0-2.0,41,CHIPPAGIRI,3233,4718,4711,7,4718,0,0,0,0,0
ANDHRA PRADESH,KURNOOL,OTHERS,1.0-2.0,42,MADDIKERA (EAST),3678,5334,5256,78,5334,0,0,0,0,0
ANDHRA PRADESH,KURNOOL,OTHERS,1.0-2.0,43,TUGGALI,3510,5112,5112,0,5112,0,0,0,0,0
ANDHRA PRADESH,KURNOOL,OTHERS,1.0-2.0,44,PEAPALLY,5680,8153,7767,387,8154,0,0,0,0,0
ANDHRA PRADESH,KURNOOL,OTHERS,1.0-2.0,45,OWK,2174,3109,2941,168,3109,0,0,0,0,0
ANDHRA PRADESH,KURNOOL,OTHERS,1.0-2.0,46,KOILKUNTLA,2572,3694,3694,0,3694,0,0,0,0,0
ANDHRA PRADESH,KURNOOL,OTHERS,1.0-2.0,47,RUDRAVARAM,3365,4828,4784,44,4828,0,0,0,0,0
ANDHRA PRADESH,KURNOOL,OTHERS,1.0-2.0,48,ALLAGADDA,3727,5260,2612,2648,5260,0,0,0,0,0
ANDHRA PRADESH,KURNOOL,OTHERS,1.0-2.0,49,DORNIPADU,1607,2284,2284,0,2284,0,0,0,0,0
ANDHRA PRADESH,KURNOOL,OTHERS,1.0-2.0,50,SANJAMALA,2961,4258,4246,13,4259,0,0,0,0,0
ANDHRA PRADESH,KURNOOL,OTHERS,1.0-2.0,51,KOLIMIGUNDLA,1868,2714,2714,0,2714,0,0,0,0,0
ANDHRA PRADESH,KURNOOL,OTHERS,1.0-2.0,52,UYYALAWADA,2387,3440,3440,0,3440,0,0,0,0,0
ANDHRA PRADESH,KURNOOL,OTHERS,1.0-2.0,53,CHAGALAMARRI,2949,4262,1834,2428,4262,0,0,0,0,0
ANDHRA PRADESH,KURNOOL,OTHERS,1.0-2.0,54,CHAGALAMARRI,2949,4262,1834,2428,4262,0,0,0,0,0
ANDHRA PRADESH,KURNOOL,SCHEDULED TRIBES,1.0-2.0,1,MANTRALAYAM,18,23,23,0,23,0,0,0,0,0
ANDHRA PRADESH,KURNOOL,SCHEDULED TRIBES,1.0-2.0,2,KOSIGI,37,52,26,26,52,0,0,0,0,0
ANDHRA PRADESH,KURNOOL,SCHEDULED TRIBES,1.0-2.0,3,KOWTHALAM,92,136,136,0,136,0,0,0,0,0
ANDHRA PRADESH,KURNOOL,SCHEDULED TRIBES,1.0-2.0,4,PEDDA KADUBUR,3,4,2,2,4,0,0,0,0,0
ANDHRA PRADESH,KURNOOL,SCHEDULED TRIBES,1.0-2.0,5,YEMMIGANUR,2,3,2,2,4,0,0,0,0,0
ANDHRA PRADESH,KURNOOL,SCHEDULED TRIBES,1.0-2.0,6,NANDAVARAM,1,1,1,0,1,0,0,0,0,0
ANDHRA PRADESH,KURNOOL,SCHEDULED TRIBES,1.0-2.0,7,C.BELAGAL,4,5,2,2,4,0,0,0,0,0
ANDHRA PRADESH,KURNOOL,SCHEDULED TRIBES,1.0-2.0,8,GUDUR,0,0,0,0,0,0,0,0,0,0
ANDHRA PRADESH,KURNOOL,SCHEDULED TRIBES,1.0-2.0,9,KALLUR,63,88,80,8,88,0,0,0,0,0
ANDHRA PRADESH,KURNOOL,SCHEDULED TRIBES,1.0-2.0,10,KURNOOL,47,66,62,3,65,0,0,0,0,0
ANDHRA PRADESH,KURNOOL,SCHEDULED TRIBES,1.0-2.0,11,NANDIKOTKUR,20,27,24,3,27,0,0,0,0,0
ANDHRA PRADESH,KURNOOL,SCHEDULED TRIBES,1.0-2.0,12,PAGIDYALA,2,2,1,1,2,0,0,0,0,0
ANDHRA PRADESH,KURNOOL,SCHEDULED TRIBES,1.0-2.0,13,JUPADU BUNGALOW,28,39,29,0,29,0,8,0,8,2
ANDHRA PRADESH,KURNOOL,SCHEDULED TRIBES,1.0-2.0,14,KOTHAPALLE,42,59,29,30,59,0,0,0,0,0
ANDHRA PRADESH,KURNOOL,SCHEDULED TRIBES,1.0-2.0,15,ATMAKUR,164,202,202,0,202,0,0,0,0,0
ANDHRA PRADESH,KURNOOL,SCHEDULED TRIBES,1.0-2.0,16,PAMULAPADU,57,79,79,0,79,0,0,0,0,0
ANDHRA PRADESH,KURNOOL,SCHEDULED TRIBES,1.0-2.0,17,MIDTHUR,2,3,2,2,4,0,0,0,0,0
ANDHRA PRADESH,KURNOOL,SCHEDULED TRIBES,1.0-2.0,18,ORVAKAL,121,173,115,58,173,0,0,0,0,0
ANDHRA PRADESH,KURNOOL,SCHEDULED TRIBES,1.0-2.0,19,KODUMUR,1,1,1,1,2,0,0,0,0,0
ANDHRA PRADESH,KURNOOL,SCHEDULED TRIBES,1.0-2.0,20,GONEGANDLA,34,48,48,0,48,0,0,0,0,0
ANDHRA PRADESH,KURNOOL,SCHEDULED TRIBES,1.0-2.0,21,ADONI,15,20,20,0,20,0,0,0,0,0
ANDHRA PRADESH,KURNOOL,SCHEDULED TRIBES,1.0-2.0,22,HOLAGUNDA,61,85,80,5,85,0,0,0,0,0
ANDHRA PRADESH,KURNOOL,SCHEDULED TRIBES,1.0-2.0,23,HALAHARVI,7,9,5,5,10,0,0,0,0,0
ANDHRA PRADESH,KURNOOL,SCHEDULED TRIBES,1.0-2.0,24,ALUR,91,132,132,0,132,0,0,0,0,0
ANDHRA PRADESH,KURNOOL,SCHEDULED TRIBES,1.0-2.0,25,ASPARI,24,33,23,10,33,0,0,0,0,0
ANDHRA PRADESH,KURNOOL,SCHEDULED TRIBES,1.0-2.0,26,DEVANAKONDA,42,59,59,0,59,0,0,0,0,0
ANDHRA PRADESH,KURNOOL,SCHEDULED TRIBES,1.0-2.0,27,KRISHNAGIRI,93,127,127,0,127,0,0,0,0,0
ANDHRA PRADESH,KURNOOL,SCHEDULED TRIBES,1.0-2.0,28,VELDURTHI,23,33,17,16,33,0,0,0,0,0
ANDHRA PRADESH,KURNOOL,SCHEDULED TRIBES,1.0-2.0,29,BETHAMCHERLA,178,221,209,12,221,0,0,0,0,0
ANDHRA PRADESH,KURNOOL,SCHEDULED TRIBES,1.0-2.0,30,PANYAM,31,42,0,42,42,0,0,0,0,0
ANDHRA PRADESH,KURNOOL,SCHEDULED TRIBES,1.0-2.0,31,GADIVEMULA,125,179,179,0,179,0,0,0,0,0
ANDHRA PRADESH,KURNOOL,SCHEDULED TRIBES,1.0-2.0,32,VELGODE,35,47,47,0,47,0,0,0,0,0
ANDHRA PRADESH,KURNOOL,SCHEDULED TRIBES,1.0-2.0,33,BANDI ATMAKUR,44,63,63,0,63,0,0,0,0,0
ANDHRA PRADESH,KURNOOL,SCHEDULED TRIBES,1.0-2.0,34,NANDYAL,2,3,1,1,2,0,0,0,0,0
ANDHRA PRADESH,KURNOOL,SCHEDULED TRIBES,1.0-2.0,35,MAHANANDI,14,20,10,10,20,0,0,0,0,0
ANDHRA PRADESH,KURNOOL,SCHEDULED TRIBES,1.0-2.0,36,SIRVEL,34,47,47,0,47,0,0,0,0,0
ANDHRA PRADESH,KURNOOL,SCHEDULED TRIBES,1.0-2.0,37,GOSPADU,2,4,2,2,4,0,0,0,0,0
ANDHRA PRADESH,KURNOOL,SCHEDULED TRIBES,1.0-2.0,38,BANAGANAPALLE,299,423,271,152,423,0,0,0,0,0
ANDHRA PRADESH,KURNOOL,SCHEDULED TRIBES,1.0-2.0,39,DHONE,213,314,273,41,314,0,0,0,0,0
ANDHRA PRADESH,KURNOOL,SCHEDULED TRIBES,1.0-2.0,40,PATTIKONDA,194,277,277,0,277,0,0,0,0,0
ANDHRA PRADESH,KURNOOL,SCHEDULED TRIBES,1.0-2.0,41,CHIPPAGIRI,2,3,3,0,3,0,0,0,0,0
ANDHRA PRADESH,KURNOOL,SCHEDULED TRIBES,1.0-2.0,42,MADDIKERA (EAST),38,51,51,0,51,0,0,0,0,0
ANDHRA PRADESH,KURNOOL,SCHEDULED TRIBES,1.0-2.0,43,TUGGALI,342,494,494,0,494,0,0,0,0,0
ANDHRA PRADESH,KURNOOL,SCHEDULED TRIBES,1.0-2.0,44,PEAPALLY,235,321,290,31,321,0,0,0,0,0
ANDHRA PRADESH,KURNOOL,SCHEDULED TRIBES,1.0-2.0,45,OWK,286,393,257,136,393,0,0,0,0,0
ANDHRA PRADESH,KURNOOL,SCHEDULED TRIBES,1.0-2.0,46,KOILKUNTLA,18,25,25,0,25,0,0,0,0,0
ANDHRA PRADESH,KURNOOL,SCHEDULED TRIBES,1.0-2.0,47,RUDRAVARAM,58,81,81,0,81,0,0,0,0,0
ANDHRA PRADESH,KURNOOL,SCHEDULED TRIBES,1.0-2.0,48,ALLAGADDA,83,116,116,0,116,0,0,0,0,0
ANDHRA PRADESH,KURNOOL,SCHEDULED TRIBES,1.0-2.0,49,DORNIPADU,9,12,6,6,12,0,0,0,0,0
ANDHRA PRADESH,KURNOOL,SCHEDULED TRIBES,1.0-2.0,50,SANJAMALA,27,36,18,18,36,0,0,0,0,0
ANDHRA PRADESH,KURNOOL,SCHEDULED TRIBES,1.0-2.0,51,KOLIMIGUNDLA,64,86,86,0,86,0,0,0,0,0
ANDHRA PRADESH,KURNOOL,SCHEDULED TRIBES,1.0-2.0,52,UYYALAWADA,3,3,3,0,3,0,0,0,0,0
ANDHRA PRADESH,KURNOOL,SCHEDULED TRIBES,1.0-2.0,53,CHAGALAMARRI,241,345,210,135,345,0,0,0,0,0
ANDHRA PRADESH,KURNOOL,SCHEDULED TRIBES,1.0-2.0,54,CHAGALAMARRI,241,345,210,135,345,0,0,0,0,0
ANDHRA PRADESH,KURNOOL,ALL SOCIAL GROUPS,1.0-2.0,1,MANTRALAYAM,2825,4018,3916,103,4019,0,0,0,0,0
ANDHRA PRADESH,KURNOOL,ALL SOCIAL GROUPS,1.0-2.0,2,KOSIGI,3760,5247,5109,138,5247,0,0,0,0,0
ANDHRA PRADESH,KURNOOL,ALL SOCIAL GROUPS,1.0-2.0,3,KOWTHALAM,5105,7310,7310,0,7310,0,0,0,0,0
ANDHRA PRADESH,KURNOOL,ALL SOCIAL GROUPS,1.0-2.0,4,PEDDA KADUBUR,2834,4015,3907,109,4016,0,0,0,0,0
ANDHRA PRADESH,KURNOOL,ALL SOCIAL GROUPS,1.0-2.0,5,YEMMIGANUR,4557,6442,6233,129,6362,3,49,0,52,27
ANDHRA PRADESH,KURNOOL,ALL SOCIAL GROUPS,1.0-2.0,6,NANDAVARAM,4537,6518,6269,134,6403,24,49,0,73,42
ANDHRA PRADESH,KURNOOL,ALL SOCIAL GROUPS,1.0-2.0,7,C.BELAGAL,3593,5022,4987,36,5023,0,0,0,0,0
ANDHRA PRADESH,KURNOOL,ALL SOCIAL GROUPS,1.0-2.0,8,GUDUR,2772,3894,3879,16,3895,0,0,0,0,0
ANDHRA PRADESH,KURNOOL,ALL SOCIAL GROUPS,1.0-2.0,9,KALLUR,4070,5758,5560,198,5758,0,0,0,0,0
ANDHRA PRADESH,KURNOOL,ALL SOCIAL GROUPS,1.0-2.0,10,KURNOOL,3711,5184,5150,34,5184,0,0,0,0,0
ANDHRA PRADESH,KURNOOL,ALL SOCIAL GROUPS,1.0-2.0,11,NANDIKOTKUR,2320,3297,2983,263,3246,22,7,4,33,18
ANDHRA PRADESH,KURNOOL,ALL SOCIAL GROUPS,1.0-2.0,12,PAGIDYALA,1034,1456,846,590,1436,0,12,0,12,9
ANDHRA PRADESH,KURNOOL,ALL SOCIAL GROUPS,1.0-2.0,13,JUPADU BUNGALOW,3347,4842,4437,275,4712,0,89,0,89,42
ANDHRA PRADESH,KURNOOL,ALL SOCIAL GROUPS,1.0-2.0,14,KOTHAPALLE,2203,3138,2830,308,3138,0,0,0,0,0
ANDHRA PRADESH,KURNOOL,ALL SOCIAL GROUPS,1.0-2.0,15,ATMAKUR,2638,3636,3636,0,3636,0,0,0,0,0
ANDHRA PRADESH,KURNOOL,ALL SOCIAL GROUPS,1.0-2.0,16,PAMULAPADU,2294,3159,3010,149,3159,0,0,0,0,0
ANDHRA PRADESH,KURNOOL,ALL SOCIAL GROUPS,1.0-2.0,17,MIDTHUR,3687,5320,5243,77,5320,0,0,0,0,0
ANDHRA PRADESH,KURNOOL,ALL SOCIAL GROUPS,1.0-2.0,18,ORVAKAL,3920,5540,4603,938,5541,0,0,0,0,0
ANDHRA PRADESH,KURNOOL,ALL SOCIAL GROUPS,1.0-2.0,19,KODUMUR,3712,5281,5251,31,5282,0,0,0,0,0
ANDHRA PRADESH,KURNOOL,ALL SOCIAL GROUPS,1.0-2.0,20,GONEGANDLA,4049,5795,5232,563,5795,0,0,0,0,0
ANDHRA PRADESH,KURNOOL,ALL SOCIAL GROUPS,1.0-2.0,21,ADONI,6615,9397,9153,244,9397,0,0,0,0,0
ANDHRA PRADESH,KURNOOL,ALL SOCIAL GROUPS,1.0-2.0,22,HOLAGUNDA,3390,4853,3908,944,4852,0,0,0,0,0
ANDHRA PRADESH,KURNOOL,ALL SOCIAL GROUPS,1.0-2.0,23,HALAHARVI,3076,4423,4418,5,4423,0,0,0,0,0
ANDHRA PRADESH,KURNOOL,ALL SOCIAL GROUPS,1.0-2.0,24,ALUR,4204,6105,6060,36,6096,0,6,0,6,3
ANDHRA PRADESH,KURNOOL,ALL SOCIAL GROUPS,1.0-2.0,25,ASPARI,5203,7471,5968,1503,7471,0,0,0,0,0
ANDHRA PRADESH,KURNOOL,ALL SOCIAL GROUPS,1.0-2.0,26,DEVANAKONDA,6083,8834,8618,216,8834,0,0,0,0,0
ANDHRA PRADESH,KURNOOL,ALL SOCIAL GROUPS,1.0-2.0,27,KRISHNAGIRI,4219,6064,5888,176,6064,0,0,0,0,0
ANDHRA PRADESH,KURNOOL,ALL SOCIAL GROUPS,1.0-2.0,28,VELDURTHI,3989,5875,4882,990,5872,2,0,0,2,1
ANDHRA PRADESH,KURNOOL,ALL SOCIAL GROUPS,1.0-2.0,29,BETHAMCHERLA,3677,5164,5134,30,5164,0,0,0,0,0
ANDHRA PRADESH,KURNOOL,ALL SOCIAL GROUPS,1.0-2.0,30,PANYAM,2869,4089,2984,1101,4085,0,2,0,2,1
ANDHRA PRADESH,KURNOOL,ALL SOCIAL GROUPS,1.0-2.0,31,GADIVEMULA,2814,4029,3814,152,3966,0,43,0,43,20
ANDHRA PRADESH,KURNOOL,ALL SOCIAL GROUPS,1.0-2.0,32,VELGODE,1979,2769,2759,11,2770,0,0,0,0,0
ANDHRA PRADESH,KURNOOL,ALL SOCIAL GROUPS,1.0-2.0,33,BANDI ATMAKUR,2714,3816,3761,51,3812,0,1,1,2,1
ANDHRA PRADESH,KURNOOL,ALL SOCIAL GROUPS,1.0-2.0,34,NANDYAL,2767,3930,3902,26,3928,0,0,0,0,2
ANDHRA PRADESH,KURNOOL,ALL SOCIAL GROUPS,1.0-2.0,35,MAHANANDI,1619,2270,2237,13,2250,2,0,10,12,8
ANDHRA PRADESH,KURNOOL,ALL SOCIAL GROUPS,1.0-2.0,36,SIRVEL,2881,4034,4034,0,4034,0,0,0,0,0
ANDHRA PRADESH,KURNOOL,ALL SOCIAL GROUPS,1.0-2.0,37,GOSPADU,1949,2745,2743,2,2745,0,0,0,0,0
ANDHRA PRADESH,KURNOOL,ALL SOCIAL GROUPS,1.0-2.0,38,BANAGANAPALLE,6216,8803,6404,2398,8802,0,0,0,0,0
ANDHRA PRADESH,KURNOOL,ALL SOCIAL GROUPS,1.0-2.0,39,DHONE,4736,6880,6759,121,6880,0,0,0,0,0
ANDHRA PRADESH,KURNOOL,ALL SOCIAL GROUPS,1.0-2.0,40,PATTIKONDA,4068,5866,5858,8,5866,0,0,0,0,0
ANDHRA PRADESH,KURNOOL,ALL SOCIAL GROUPS,1.0-2.0,41,CHIPPAGIRI,3575,5204,5196,7,5203,0,0,0,0,0
ANDHRA PRADESH,KURNOOL,ALL SOCIAL GROUPS,1.0-2.0,42,MADDIKERA (EAST),3920,5677,5599,78,5677,0,0,0,0,0
ANDHRA PRADESH,KURNOOL,ALL SOCIAL GROUPS,1.0-2.0,43,TUGGALI,4337,6294,6294,0,6294,0,0,0,0,0
ANDHRA PRADESH,KURNOOL,ALL SOCIAL GROUPS,1.0-2.0,44,PEAPALLY,6607,9408,8955,453,9408,0,0,0,0,0
ANDHRA PRADESH,KURNOOL,ALL SOCIAL GROUPS,1.0-2.0,45,OWK,2802,3983,3638,345,3983,0,0,0,0,0
ANDHRA PRADESH,KURNOOL,ALL SOCIAL GROUPS,1.0-2.0,46,KOILKUNTLA,2809,4021,4021,0,4021,0,0,0,0,0
ANDHRA PRADESH,KURNOOL,ALL SOCIAL GROUPS,1.0-2.0,47,RUDRAVARAM,3926,5609,5565,44,5609,0,0,0,0,0
ANDHRA PRADESH,KURNOOL,ALL SOCIAL GROUPS,1.0-2.0,48,ALLAGADDA,4101,5770,2995,2775,5770,0,0,0,0,0
ANDHRA PRADESH,KURNOOL,ALL SOCIAL GROUPS,1.0-2.0,49,DORNIPADU,1746,2467,2461,6,2467,0,0,0,0,0
ANDHRA PRADESH,KURNOOL,ALL SOCIAL GROUPS,1.0-2.0,50,SANJAMALA,3362,4802,4772,31,4803,0,0,0,0,0
ANDHRA PRADESH,KURNOOL,ALL SOCIAL GROUPS,1.0-2.0,51,KOLIMIGUNDLA,2186,3153,3153,0,3153,0,0,0,0,0
ANDHRA PRADESH,KURNOOL,ALL SOCIAL GROUPS,1.0-2.0,52,UYYALAWADA,2602,3737,3737,0,3737,0,0,0,0,0
ANDHRA PRADESH,KURNOOL,ALL SOCIAL GROUPS,1.0-2.0,53,CHAGALAMARRI,3689,5307,2366,2941,5307,0,0,0,0,0
ANDHRA PRADESH,KURNOOL,ALL SOCIAL GROUPS,1.0-2.0,54,CHAGALAMARRI,3689,5307,2366,2941,5307,0,0,0,0,0
ANDHRA PRADESH,KURNOOL,INSTITUTIONAL,0.5-1.0,1,MANTRALAYAM,0,0,0,0,0,0,0,0,0,0
ANDHRA PRADESH,KURNOOL,INSTITUTIONAL,0.5-1.0,2,KOSIGI,0,0,0,0,0,0,0,0,0,0
ANDHRA PRADESH,KURNOOL,INSTITUTIONAL,0.5-1.0,3,KOWTHALAM,0,0,0,0,0,0,0,0,0,0
ANDHRA PRADESH,KURNOOL,INSTITUTIONAL,0.5-1.0,4,PEDDA KADUBUR,0,0,0,0,0,0,0,0,0,0
ANDHRA PRADESH,KURNOOL,INSTITUTIONAL,0.5-1.0,5,YEMMIGANUR,0,0,0,0,0,0,0,0,0,0
ANDHRA PRADESH,KURNOOL,INSTITUTIONAL,0.5-1.0,6,NANDAVARAM,0,0,0,0,0,0,0,0,0,0
ANDHRA PRADESH,KURNOOL,INSTITUTIONAL,0.5-1.0,7,C.BELAGAL,0,0,0,0,0,0,0,0,0,0
ANDHRA PRADESH,KURNOOL,INSTITUTIONAL,0.5-1.0,8,GUDUR,0,0,0,0,0,0,0,0,0,0
ANDHRA PRADESH,KURNOOL,INSTITUTIONAL,0.5-1.0,9,KALLUR,0,0,0,0,0,0,0,0,0,0
ANDHRA PRADESH,KURNOOL,INSTITUTIONAL,0.5-1.0,10,KURNOOL,0,0,0,0,0,0,0,0,0,0
ANDHRA PRADESH,KURNOOL,INSTITUTIONAL,0.5-1.0,11,NANDIKOTKUR,2,2,2,0,2,0,0,0,0,0
ANDHRA PRADESH,KURNOOL,INSTITUTIONAL,0.5-1.0,12,PAGIDYALA,0,0,0,0,0,0,0,0,0,0
ANDHRA PRADESH,KURNOOL,INSTITUTIONAL,0.5-1.0,13,JUPADU BUNGALOW,0,0,0,0,0,0,0,0,0,0
ANDHRA PRADESH,KURNOOL,INSTITUTIONAL,0.5-1.0,14,KOTHAPALLE,0,0,0,0,0,0,0,0,0,0
ANDHRA PRADESH,KURNOOL,INSTITUTIONAL,0.5-1.0,15,ATMAKUR,0,0,0,0,0,0,0,0,0,0
ANDHRA PRADESH,KURNOOL,INSTITUTIONAL,0.5-1.0,16,PAMULAPADU,0,0,0,0,0,0,0,0,0,0
ANDHRA PRADESH,KURNOOL,INSTITUTIONAL,0.5-1.0,17,MIDTHUR,0,0,0,0,0,0,0,0,0,0
ANDHRA PRADESH,KURNOOL,INSTITUTIONAL,0.5-1.0,18,ORVAKAL,0,0,0,0,0,0,0,0,0,0
ANDHRA PRADESH,KURNOOL,INSTITUTIONAL,0.5-1.0,19,KODUMUR,0,0,0,0,0,0,0,0,0,0
ANDHRA PRADESH,KURNOOL,INSTITUTIONAL,0.5-1.0,20,GONEGANDLA,0,0,0,0,0,0,0,0,0,0
ANDHRA PRADESH,KURNOOL,INSTITUTIONAL,0.5-1.0,21,ADONI,0,0,0,0,0,0,0,0,0,0
ANDHRA PRADESH,KURNOOL,INSTITUTIONAL,0.5-1.0,22,HOLAGUNDA,0,0,0,0,0,0,0,0,0,0
ANDHRA PRADESH,KURNOOL,INSTITUTIONAL,0.5-1.0,23,HALAHARVI,0,0,0,0,0,0,0,0,0,0
ANDHRA PRADESH,KURNOOL,INSTITUTIONAL,0.5-1.0,24,ALUR,0,0,0,0,0,0,0,0,0,0
ANDHRA PRADESH,KURNOOL,INSTITUTIONAL,0.5-1.0,25,ASPARI,0,0,0,0,0,0,0,0,0,0
ANDHRA PRADESH,KURNOOL,INSTITUTIONAL,0.5-1.0,26,DEVANAKONDA,0,0,0,0,0,0,0,0,0,0
ANDHRA PRADESH,KURNOOL,INSTITUTIONAL,0.5-1.0,27,KRISHNAGIRI,0,0,0,0,0,0,0,0,0,0
ANDHRA PRADESH,KURNOOL,INSTITUTIONAL,0.5-1.0,28,VELDURTHI,0,0,0,0,0,0,0,0,0,0
ANDHRA PRADESH,KURNOOL,INSTITUTIONAL,0.5-1.0,29,BETHAMCHERLA,0,0,0,0,0,0,0,0,0,0
ANDHRA PRADESH,KURNOOL,INSTITUTIONAL,0.5-1.0,30,PANYAM,1,1,1,0,1,0,0,0,0,0
ANDHRA PRADESH,KURNOOL,INSTITUTIONAL,0.5-1.0,31,GADIVEMULA,0,0,0,0,0,0,0,0,0,0
ANDHRA PRADESH,KURNOOL,INSTITUTIONAL,0.5-1.0,32,VELGODE,0,0,0,0,0,0,0,0,0,0
ANDHRA PRADESH,KURNOOL,INSTITUTIONAL,0.5-1.0,33,BANDI ATMAKUR,0,0,0,0,0,0,0,0,0,0
ANDHRA PRADESH,KURNOOL,INSTITUTIONAL,0.5-1.0,34,NANDYAL,0,0,0,0,0,0,0,0,0,0
ANDHRA PRADESH,KURNOOL,INSTITUTIONAL,0.5-1.0,35,MAHANANDI,0,0,0,0,0,0,0,0,0,0
ANDHRA PRADESH,KURNOOL,INSTITUTIONAL,0.5-1.0,36,SIRVEL,0,0,0,0,0,0,0,0,0,0
ANDHRA PRADESH,KURNOOL,INSTITUTIONAL,0.5-1.0,37,GOSPADU,0,0,0,0,0,0,0,0,0,0
ANDHRA PRADESH,KURNOOL,INSTITUTIONAL,0.5-1.0,38,BANAGANAPALLE,0,0,0,0,0,0,0,0,0,0
ANDHRA PRADESH,KURNOOL,INSTITUTIONAL,0.5-1.0,39,DHONE,0,0,0,0,0,0,0,0,0,0
ANDHRA PRADESH,KURNOOL,INSTITUTIONAL,0.5-1.0,40,PATTIKONDA,0,0,0,0,0,0,0,0,0,0
ANDHRA PRADESH,KURNOOL,INSTITUTIONAL,0.5-1.0,41,CHIPPAGIRI,0,0,0,0,0,0,0,0,0,0
ANDHRA PRADESH,KURNOOL,INSTITUTIONAL,0.5-1.0,42,MADDIKERA (EAST),0,0,0,0,0,0,0,0,0,0
ANDHRA PRADESH,KURNOOL,INSTITUTIONAL,0.5-1.0,43,TUGGALI,0,0,0,0,0,0,0,0,0,0
ANDHRA PRADESH,KURNOOL,INSTITUTIONAL,0.5-1.0,44,PEAPALLY,0,0,0,0,0,0,0,0,0,0
ANDHRA PRADESH,KURNOOL,INSTITUTIONAL,0.5-1.0,45,OWK,0,0,0,0,0,0,0,0,0,0
ANDHRA PRADESH,KURNOOL,INSTITUTIONAL,0.5-1.0,46,KOILKUNTLA,0,0,0,0,0,0,0,0,0,0
ANDHRA PRADESH,KURNOOL,INSTITUTIONAL,0.5-1.0,47,RUDRAVARAM,0,0,0,0,0,0,0,0,0,0
ANDHRA PRADESH,KURNOOL,INSTITUTIONAL,0.5-1.0,48,ALLAGADDA,0,0,0,0,0,0,0,0,0,0
ANDHRA PRADESH,KURNOOL,INSTITUTIONAL,0.5-1.0,49,DORNIPADU,0,0,0,0,0,0,0,0,0,0
ANDHRA PRADESH,KURNOOL,INSTITUTIONAL,0.5-1.0,50,SANJAMALA,0,0,0,0,0,0,0,0,0,0
ANDHRA PRADESH,KURNOOL,INSTITUTIONAL,0.5-1.0,51,KOLIMIGUNDLA,0,0,0,0,0,0,0,0,0,0
ANDHRA PRADESH,KURNOOL,INSTITUTIONAL,0.5-1.0,52,UYYALAWADA,0,0,0,0,0,0,0,0,0,0
ANDHRA PRADESH,KURNOOL,INSTITUTIONAL,0.5-1.0,53,CHAGALAMARRI,0,0,0,0,0,0,0,0,0,0
ANDHRA PRADESH,KURNOOL,INSTITUTIONAL,0.5-1.0,54,CHAGALAMARRI,0,0,0,0,0,0,0,0,0,0
ANDHRA PRADESH,KURNOOL,SCHEDULED CASTE,0.5-1.0,1,MANTRALAYAM,536,387,387,0,387,0,0,0,0,0
ANDHRA PRADESH,KURNOOL,SCHEDULED CASTE,0.5-1.0,2,KOSIGI,391,295,295,0,295,0,0,0,0,0
ANDHRA PRADESH,KURNOOL,SCHEDULED CASTE,0.5-1.0,3,KOWTHALAM,676,514,514,0,514,0,0,0,0,0
ANDHRA PRADESH,KURNOOL,SCHEDULED CASTE,0.5-1.0,4,PEDDA KADUBUR,593,439,431,8,439,0,0,0,0,0
ANDHRA PRADESH,KURNOOL,SCHEDULED CASTE,0.5-1.0,5,YEMMIGANUR,875,635,611,21,632,0,3,0,3,0
ANDHRA PRADESH,KURNOOL,SCHEDULED CASTE,0.5-1.0,6,NANDAVARAM,668,495,479,14,493,0,3,0,3,0
ANDHRA PRADESH,KURNOOL,SCHEDULED CASTE,0.5-1.0,7,C.BELAGAL,644,465,462,3,465,0,0,0,0,0
ANDHRA PRADESH,KURNOOL,SCHEDULED CASTE,0.5-1.0,8,GUDUR,424,315,315,0,315,0,0,0,0,0
ANDHRA PRADESH,KURNOOL,SCHEDULED CASTE,0.5-1.0,9,KALLUR,534,393,376,17,393,0,0,0,0,0
ANDHRA PRADESH,KURNOOL,SCHEDULED CASTE,0.5-1.0,10,KURNOOL,758,545,531,14,545,0,0,0,0,0
ANDHRA PRADESH,KURNOOL,SCHEDULED CASTE,0.5-1.0,11,NANDIKOTKUR,371,265,255,9,264,0,1,0,1,0
ANDHRA PRADESH,KURNOOL,SCHEDULED CASTE,0.5-1.0,12,PAGIDYALA,175,124,55,65,120,0,3,0,3,0
ANDHRA PRADESH,KURNOOL,SCHEDULED CASTE,0.5-1.0,13,JUPADU BUNGALOW,478,362,316,34,350,0,12,0,12,0
ANDHRA PRADESH,KURNOOL,SCHEDULED CASTE,0.5-1.0,14,KOTHAPALLE,592,417,390,27,417,0,0,0,0,0
ANDHRA PRADESH,KURNOOL,SCHEDULED CASTE,0.5-1.0,15,ATMAKUR,837,563,563,0,563,0,0,0,0,0
ANDHRA PRADESH,KURNOOL,SCHEDULED CASTE,0.5-1.0,16,PAMULAPADU,636,459,454,5,459,0,0,0,0,0
ANDHRA PRADESH,KURNOOL,SCHEDULED CASTE,0.5-1.0,17,MIDTHUR,538,393,383,11,394,0,0,0,0,0
ANDHRA PRADESH,KURNOOL,SCHEDULED CASTE,0.5-1.0,18,ORVAKAL,652,477,196,281,477,0,0,0,0,0
ANDHRA PRADESH,KURNOOL,SCHEDULED CASTE,0.5-1.0,19,KODUMUR,473,342,342,0,342,0,0,0,0,0
ANDHRA PRADESH,KURNOOL,SCHEDULED CASTE,0.5-1.0,20,GONEGANDLA,228,166,157,9,166,0,0,0,0,0
ANDHRA PRADESH,KURNOOL,SCHEDULED CASTE,0.5-1.0,21,ADONI,724,535,512,23,535,0,0,0,0,0
ANDHRA PRADESH,KURNOOL,SCHEDULED CASTE,0.5-1.0,22,HOLAGUNDA,598,453,413,40,453,0,0,0,0,0
ANDHRA PRADESH,KURNOOL,SCHEDULED CASTE,0.5-1.0,23,HALAHARVI,331,249,249,0,249,0,0,0,0,0
ANDHRA PRADESH,KURNOOL,SCHEDULED CASTE,0.5-1.0,24,ALUR,499,395,395,0,395,0,0,0,0,0
ANDHRA PRADESH,KURNOOL,SCHEDULED CASTE,0.5-1.0,25,ASPARI,164,123,106,17,123,0,0,0,0,0
ANDHRA PRADESH,KURNOOL,SCHEDULED CASTE,0.5-1.0,26,DEVANAKONDA,570,426,393,33,426,0,0,0,0,0
ANDHRA PRADESH,KURNOOL,SCHEDULED CASTE,0.5-1.0,27,KRISHNAGIRI,388,298,298,0,298,0,0,0,0,0
ANDHRA PRADESH,KURNOOL,SCHEDULED CASTE,0.5-1.0,28,VELDURTHI,630,468,421,45,466,1,0,0,1,1
ANDHRA PRADESH,KURNOOL,SCHEDULED CASTE,0.5-1.0,29,BETHAMCHERLA,560,426,426,0,426,0,0,0,0,0
ANDHRA PRADESH,KURNOOL,SCHEDULED CASTE,0.5-1.0,30,PANYAM,425,311,248,58,306,0,5,0,5,0
ANDHRA PRADESH,KURNOOL,SCHEDULED CASTE,0.5-1.0,31,GADIVEMULA,411,297,297,0,297,0,0,0,0,0
ANDHRA PRADESH,KURNOOL,SCHEDULED CASTE,0.5-1.0,32,VELGODE,325,236,236,0,236,0,0,0,0,0
ANDHRA PRADESH,KURNOOL,SCHEDULED CASTE,0.5-1.0,33,BANDI ATMAKUR,363,262,254,8,262,0,0,0,0,0
ANDHRA PRADESH,KURNOOL,SCHEDULED CASTE,0.5-1.0,34,NANDYAL,305,217,212,5,217,0,0,0,0,0
ANDHRA PRADESH,KURNOOL,SCHEDULED CASTE,0.5-1.0,35,MAHANANDI,200,142,141,1,142,0,0,0,0,0
ANDHRA PRADESH,KURNOOL,SCHEDULED CASTE,0.5-1.0,36,SIRVEL,413,289,289,0,289,0,0,0,0,0
ANDHRA PRADESH,KURNOOL,SCHEDULED CASTE,0.5-1.0,37,GOSPADU,291,204,204,0,204,0,0,0,0,0
ANDHRA PRADESH,KURNOOL,SCHEDULED CASTE,0.5-1.0,38,BANAGANAPALLE,489,357,283,75,358,0,0,0,0,0
ANDHRA PRADESH,KURNOOL,SCHEDULED CASTE,0.5-1.0,39,DHONE,411,311,308,3,311,0,0,0,0,0
ANDHRA PRADESH,KURNOOL,SCHEDULED CASTE,0.5-1.0,40,PATTIKONDA,443,343,343,0,343,0,0,0,0,0
ANDHRA PRADESH,KURNOOL,SCHEDULED CASTE,0.5-1.0,41,CHIPPAGIRI,318,252,252,0,252,0,0,0,0,0
ANDHRA PRADESH,KURNOOL,SCHEDULED CASTE,0.5-1.0,42,MADDIKERA (EAST),235,182,171,11,182,0,0,0,0,0
ANDHRA PRADESH,KURNOOL,SCHEDULED CASTE,0.5-1.0,43,TUGGALI,359,269,269,0,269,0,0,0,0,0
ANDHRA PRADESH,KURNOOL,SCHEDULED CASTE,0.5-1.0,44,PEAPALLY,417,311,306,5,311,0,0,0,0,0
ANDHRA PRADESH,KURNOOL,SCHEDULED CASTE,0.5-1.0,45,OWK,390,284,240,45,285,0,0,0,0,0
ANDHRA PRADESH,KURNOOL,SCHEDULED CASTE,0.5-1.0,46,KOILKUNTLA,489,341,341,0,341,0,0,0,0,0
ANDHRA PRADESH,KURNOOL,SCHEDULED CASTE,0.5-1.0,47,RUDRAVARAM,538,399,399,0,399,0,0,0,0,0
ANDHRA PRADESH,KURNOOL,SCHEDULED CASTE,0.5-1.0,48,ALLAGADDA,429,313,221,92,313,0,0,0,0,0
ANDHRA PRADESH,KURNOOL,SCHEDULED CASTE,0.5-1.0,49,DORNIPADU,198,141,141,0,141,0,0,0,0,0
ANDHRA PRADESH,KURNOOL,SCHEDULED CASTE,0.5-1.0,50,SANJAMALA,309,227,227,0,227,0,0,0,0,0
ANDHRA PRADESH,KURNOOL,SCHEDULED CASTE,0.5-1.0,51,KOLIMIGUNDLA,205,153,153,0,153,0,0,0,0,0
ANDHRA PRADESH,KURNOOL,SCHEDULED CASTE,0.5-1.0,52,UYYALAWADA,343,244,244,0,244,0,0,0,0,0
ANDHRA PRADESH,KURNOOL,SCHEDULED CASTE,0.5-1.0,53,CHAGALAMARRI,640,462,136,326,462,0,0,0,0,0
ANDHRA PRADESH,KURNOOL,SCHEDULED CASTE,0.5-1.0,54,CHAGALAMARRI,640,462,136,326,462,0,0,0,0,0
ANDHRA PRADESH,KURNOOL,OTHERS,0.5-1.0,1,MANTRALAYAM,2449,1812,1779,33,1812,0,0,0,0,0
ANDHRA PRADESH,KURNOOL,OTHERS,0.5-1.0,2,KOSIGI,3361,2489,2469,21,2490,0,0,0,0,0
ANDHRA PRADESH,KURNOOL,OTHERS,0.5-1.0,3,KOWTHALAM,3937,2958,2958,0,2958,0,0,0,0,0
ANDHRA PRADESH,KURNOOL,OTHERS,0.5-1.0,4,PEDDA KADUBUR,2375,1762,1747,15,1762,0,0,0,0,0
ANDHRA PRADESH,KURNOOL,OTHERS,0.5-1.0,5,YEMMIGANUR,3413,2531,2432,57,2489,1,25,0,26,15
ANDHRA PRADESH,KURNOOL,OTHERS,0.5-1.0,6,NANDAVARAM,2944,2229,2188,16,2204,2,13,0,15,9
ANDHRA PRADESH,KURNOOL,OTHERS,0.5-1.0,7,C.BELAGAL,3090,2279,2279,0,2279,0,0,0,0,0
ANDHRA PRADESH,KURNOOL,OTHERS,0.5-1.0,8,GUDUR,2326,1736,1736,0,1736,0,0,0,0,0
ANDHRA PRADESH,KURNOOL,OTHERS,0.5-1.0,9,KALLUR,3372,2519,2504,14,2518,0,0,0,0,0
ANDHRA PRADESH,KURNOOL,OTHERS,0.5-1.0,10,KURNOOL,3219,2379,2327,52,2379,0,0,0,0,0
ANDHRA PRADESH,KURNOOL,OTHERS,0.5-1.0,11,NANDIKOTKUR,1987,1466,1392,60,1452,5,4,0,9,5
ANDHRA PRADESH,KURNOOL,OTHERS,0.5-1.0,12,PAGIDYALA,1088,800,464,318,782,0,9,0,9,9
ANDHRA PRADESH,KURNOOL,OTHERS,0.5-1.0,13,JUPADU BUNGALOW,1929,1483,1371,101,1472,0,7,0,7,4
ANDHRA PRADESH,KURNOOL,OTHERS,0.5-1.0,14,KOTHAPALLE,1497,1117,1023,94,1117,0,0,0,0,0
ANDHRA PRADESH,KURNOOL,OTHERS,0.5-1.0,15,ATMAKUR,2274,1661,1661,0,1661,0,0,0,0,0
ANDHRA PRADESH,KURNOOL,OTHERS,0.5-1.0,16,PAMULAPADU,2567,1849,1796,53,1849,0,0,0,0,0
ANDHRA PRADESH,KURNOOL,OTHERS,0.5-1.0,17,MIDTHUR,2256,1684,1665,19,1684,0,0,0,0,0
ANDHRA PRADESH,KURNOOL,OTHERS,0.5-1.0,18,ORVAKAL,3483,2593,2164,429,2593,0,0,0,0,0
ANDHRA PRADESH,KURNOOL,OTHERS,0.5-1.0,19,KODUMUR,2840,2110,2107,3,2110,0,0,0,0,0
ANDHRA PRADESH,KURNOOL,OTHERS,0.5-1.0,20,GONEGANDLA,3075,2282,2190,93,2283,0,0,0,0,0
ANDHRA PRADESH,KURNOOL,OTHERS,0.5-1.0,21,ADONI,4975,3737,3615,123,3738,0,0,0,0,0
ANDHRA PRADESH,KURNOOL,OTHERS,0.5-1.0,22,HOLAGUNDA,2167,1647,1493,153,1646,0,0,0,0,0
ANDHRA PRADESH,KURNOOL,OTHERS,0.5-1.0,23,HALAHARVI,2295,1746,1741,5,1746,0,0,0,0,0
ANDHRA PRADESH,KURNOOL,OTHERS,0.5-1.0,24,ALUR,1713,1346,1346,0,1346,0,0,0,0,0
ANDHRA PRADESH,KURNOOL,OTHERS,0.5-1.0,25,ASPARI,3555,2727,2045,681,2726,0,0,0,0,0
ANDHRA PRADESH,KURNOOL,OTHERS,0.5-1.0,26,DEVANAKONDA,2490,1902,1849,53,1902,0,0,0,0,0
ANDHRA PRADESH,KURNOOL,OTHERS,0.5-1.0,27,KRISHNAGIRI,1815,1383,1383,0,1383,0,0,0,0,0
ANDHRA PRADESH,KURNOOL,OTHERS,0.5-1.0,28,VELDURTHI,2549,1918,1702,215,1917,0,0,0,0,0
ANDHRA PRADESH,KURNOOL,OTHERS,0.5-1.0,29,BETHAMCHERLA,2020,1532,1532,0,1532,0,0,0,0,0
ANDHRA PRADESH,KURNOOL,OTHERS,0.5-1.0,30,PANYAM,2343,1761,1335,424,1759,0,1,0,1,1
ANDHRA PRADESH,KURNOOL,OTHERS,0.5-1.0,31,GADIVEMULA,2062,1510,1470,28,1498,0,8,0,8,4
ANDHRA PRADESH,KURNOOL,OTHERS,0.5-1.0,32,VELGODE,1854,1362,1362,0,1362,0,0,0,0,0
ANDHRA PRADESH,KURNOOL,OTHERS,0.5-1.0,33,BANDI ATMAKUR,2522,1823,1810,12,1822,0,0,0,0,0
ANDHRA PRADESH,KURNOOL,OTHERS,0.5-1.0,34,NANDYAL,3269,2372,2361,12,2373,0,0,0,0,0
ANDHRA PRADESH,KURNOOL,OTHERS,0.5-1.0,35,MAHANANDI,1458,1074,1061,7,1068,0,0,4,4,2
ANDHRA PRADESH,KURNOOL,OTHERS,0.5-1.0,36,SIRVEL,2889,2121,2121,0,2121,0,0,0,0,0
ANDHRA PRADESH,KURNOOL,OTHERS,0.5-1.0,37,GOSPADU,2078,1520,1520,0,1520,0,0,0,0,0
ANDHRA PRADESH,KURNOOL,OTHERS,0.5-1.0,38,BANAGANAPALLE,4035,3042,2221,821,3042,0,0,0,0,0
ANDHRA PRADESH,KURNOOL,OTHERS,0.5-1.0,39,DHONE,2315,1753,1733,20,1753,0,0,0,0,0
ANDHRA PRADESH,KURNOOL,OTHERS,0.5-1.0,40,PATTIKONDA,1674,1287,1284,3,1287,0,0,0,0,0
ANDHRA PRADESH,KURNOOL,OTHERS,0.5-1.0,41,CHIPPAGIRI,1748,1348,1347,1,1348,0,0,0,0,0
ANDHRA PRADESH,KURNOOL,OTHERS,0.5-1.0,42,MADDIKERA (EAST),1810,1420,1407,13,1420,0,0,0,0,0
ANDHRA PRADESH,KURNOOL,OTHERS,0.5-1.0,43,TUGGALI,1575,1224,1224,0,1224,0,0,0,0,0
ANDHRA PRADESH,KURNOOL,OTHERS,0.5-1.0,44,PEAPALLY,2734,2110,2048,62,2110,0,0,0,0,0
ANDHRA PRADESH,KURNOOL,OTHERS,0.5-1.0,45,OWK,1523,1118,1039,79,1118,0,0,0,0,0
ANDHRA PRADESH,KURNOOL,OTHERS,0.5-1.0,46,KOILKUNTLA,2329,1746,1746,0,1746,0,0,0,0,0
ANDHRA PRADESH,KURNOOL,OTHERS,0.5-1.0,47,RUDRAVARAM,2713,2019,2019,0,2019,0,0,0,0,0
ANDHRA PRADESH,KURNOOL,OTHERS,0.5-1.0,48,ALLAGADDA,4007,2975,1676,1299,2975,0,0,0,0,0
ANDHRA PRADESH,KURNOOL,OTHERS,0.5-1.0,49,DORNIPADU,1652,1229,1229,0,1229,0,0,0,0,0
ANDHRA PRADESH,KURNOOL,OTHERS,0.5-1.0,50,SANJAMALA,2082,1560,1560,0,1560,0,0,0,0,0
ANDHRA PRADESH,KURNOOL,OTHERS,0.5-1.0,51,KOLIMIGUNDLA,1146,866,866,0,866,0,0,0,0,0
ANDHRA PRADESH,KURNOOL,OTHERS,0.5-1.0,52,UYYALAWADA,1612,1202,1202,0,1202,0,0,0,0,0
ANDHRA PRADESH,KURNOOL,OTHERS,0.5-1.0,53,CHAGALAMARRI,2709,2008,785,1223,2008,0,0,0,0,0
ANDHRA PRADESH,KURNOOL,OTHERS,0.5-1.0,54,CHAGALAMARRI,2709,2008,785,1223,2008,0,0,0,0,0
ANDHRA PRADESH,KURNOOL,SCHEDULED TRIBES,0.5-1.0,1,MANTRALAYAM,43,33,33,0,33,0,0,0,0,0
ANDHRA PRADESH,KURNOOL,SCHEDULED TRIBES,0.5-1.0,2,KOSIGI,21,15,8,8,16,0,0,0,0,0
ANDHRA PRADESH,KURNOOL,SCHEDULED TRIBES,0.5-1.0,3,KOWTHALAM,126,95,95,0,95,0,0,0,0,0
ANDHRA PRADESH,KURNOOL,SCHEDULED TRIBES,0.5-1.0,4,PEDDA KADUBUR,6,4,2,2,4,0,0,0,0,0
ANDHRA PRADESH,KURNOOL,SCHEDULED TRIBES,0.5-1.0,5,YEMMIGANUR,4,3,2,2,4,0,0,0,0,0
ANDHRA PRADESH,KURNOOL,SCHEDULED TRIBES,0.5-1.0,6,NANDAVARAM,7,6,6,0,6,0,0,0,0,0
ANDHRA PRADESH,KURNOOL,SCHEDULED TRIBES,0.5-1.0,7,C.BELAGAL,6,4,2,2,4,0,0,0,0,0
ANDHRA PRADESH,KURNOOL,SCHEDULED TRIBES,0.5-1.0,8,GUDUR,0,0,0,0,0,0,0,0,0,0
ANDHRA PRADESH,KURNOOL,SCHEDULED TRIBES,0.5-1.0,9,KALLUR,46,35,35,0,35,0,0,0,0,0
ANDHRA PRADESH,KURNOOL,SCHEDULED TRIBES,0.5-1.0,10,KURNOOL,66,50,50,0,50,0,0,0,0,0
ANDHRA PRADESH,KURNOOL,SCHEDULED TRIBES,0.5-1.0,11,NANDIKOTKUR,43,32,29,3,32,0,0,0,0,0
ANDHRA PRADESH,KURNOOL,SCHEDULED TRIBES,0.5-1.0,12,PAGIDYALA,1,1,0,0,0,0,0,0,0,0
ANDHRA PRADESH,KURNOOL,SCHEDULED TRIBES,0.5-1.0,13,JUPADU BUNGALOW,14,11,8,1,9,0,2,0,2,0
ANDHRA PRADESH,KURNOOL,SCHEDULED TRIBES,0.5-1.0,14,KOTHAPALLE,91,71,61,10,71,0,0,0,0,0
ANDHRA PRADESH,KURNOOL,SCHEDULED TRIBES,0.5-1.0,15,ATMAKUR,180,136,136,0,136,0,0,0,0,0
ANDHRA PRADESH,KURNOOL,SCHEDULED TRIBES,0.5-1.0,16,PAMULAPADU,92,65,65,0,65,0,0,0,0,0
ANDHRA PRADESH,KURNOOL,SCHEDULED TRIBES,0.5-1.0,17,MIDTHUR,7,5,2,2,4,0,0,0,0,0
ANDHRA PRADESH,KURNOOL,SCHEDULED TRIBES,0.5-1.0,18,ORVAKAL,107,78,55,24,79,0,0,0,0,0
ANDHRA PRADESH,KURNOOL,SCHEDULED TRIBES,0.5-1.0,19,KODUMUR,3,2,1,1,2,0,0,0,0,0
ANDHRA PRADESH,KURNOOL,SCHEDULED TRIBES,0.5-1.0,20,GONEGANDLA,13,9,5,5,10,0,0,0,0,0
ANDHRA PRADESH,KURNOOL,SCHEDULED TRIBES,0.5-1.0,21,ADONI,10,8,8,0,8,0,0,0,0,0
ANDHRA PRADESH,KURNOOL,SCHEDULED TRIBES,0.5-1.0,22,HOLAGUNDA,71,53,53,0,53,0,0,0,0,0
ANDHRA PRADESH,KURNOOL,SCHEDULED TRIBES,0.5-1.0,23,HALAHARVI,1,1,0,0,0,0,0,0,0,0
ANDHRA PRADESH,KURNOOL,SCHEDULED TRIBES,0.5-1.0,24,ALUR,55,43,43,0,43,0,0,0,0,0
ANDHRA PRADESH,KURNOOL,SCHEDULED TRIBES,0.5-1.0,25,ASPARI,20,16,8,8,16,0,0,0,0,0
ANDHRA PRADESH,KURNOOL,SCHEDULED TRIBES,0.5-1.0,26,DEVANAKONDA,27,21,21,0,21,0,0,0,0,0
ANDHRA PRADESH,KURNOOL,SCHEDULED TRIBES,0.5-1.0,27,KRISHNAGIRI,55,42,42,0,42,0,0,0,0,0
ANDHRA PRADESH,KURNOOL,SCHEDULED TRIBES,0.5-1.0,28,VELDURTHI,26,21,11,11,22,0,0,0,0,0
ANDHRA PRADESH,KURNOOL,SCHEDULED TRIBES,0.5-1.0,29,BETHAMCHERLA,147,112,112,0,112,0,0,0,0,0
ANDHRA PRADESH,KURNOOL,SCHEDULED TRIBES,0.5-1.0,30,PANYAM,44,31,0,31,31,0,0,0,0,0
ANDHRA PRADESH,KURNOOL,SCHEDULED TRIBES,0.5-1.0,31,GADIVEMULA,133,99,99,0,99,0,0,0,0,0
ANDHRA PRADESH,KURNOOL,SCHEDULED TRIBES,0.5-1.0,32,VELGODE,71,55,55,0,55,0,0,0,0,0
ANDHRA PRADESH,KURNOOL,SCHEDULED TRIBES,0.5-1.0,33,BANDI ATMAKUR,101,73,70,2,72,0,0,0,0,0
ANDHRA PRADESH,KURNOOL,SCHEDULED TRIBES,0.5-1.0,34,NANDYAL,16,11,11,0,11,0,0,0,0,0
ANDHRA PRADESH,KURNOOL,SCHEDULED TRIBES,0.5-1.0,35,MAHANANDI,35,26,13,13,26,0,0,0,0,0
ANDHRA PRADESH,KURNOOL,SCHEDULED TRIBES,0.5-1.0,36,SIRVEL,75,54,54,0,54,0,0,0,0,0
ANDHRA PRADESH,KURNOOL,SCHEDULED TRIBES,0.5-1.0,37,GOSPADU,13,9,4,5,9,0,0,0,0,0
ANDHRA PRADESH,KURNOOL,SCHEDULED TRIBES,0.5-1.0,38,BANAGANAPALLE,296,218,133,85,218,0,0,0,0,0
ANDHRA PRADESH,KURNOOL,SCHEDULED TRIBES,0.5-1.0,39,DHONE,122,91,91,0,91,0,0,0,0,0
ANDHRA PRADESH,KURNOOL,SCHEDULED TRIBES,0.5-1.0,40,PATTIKONDA,101,79,79,0,79,0,0,0,0,0
ANDHRA PRADESH,KURNOOL,SCHEDULED TRIBES,0.5-1.0,41,CHIPPAGIRI,5,4,4,0,4,0,0,0,0,0
ANDHRA PRADESH,KURNOOL,SCHEDULED TRIBES,0.5-1.0,42,MADDIKERA (EAST),34,28,26,1,27,0,0,0,0,0
ANDHRA PRADESH,KURNOOL,SCHEDULED TRIBES,0.5-1.0,43,TUGGALI,261,198,198,0,198,0,0,0,0,0
ANDHRA PRADESH,KURNOOL,SCHEDULED TRIBES,0.5-1.0,44,PEAPALLY,116,89,86,3,89,0,0,0,0,0
ANDHRA PRADESH,KURNOOL,SCHEDULED TRIBES,0.5-1.0,45,OWK,203,150,104,46,150,0,0,0,0,0
ANDHRA PRADESH,KURNOOL,SCHEDULED TRIBES,0.5-1.0,46,KOILKUNTLA,37,28,14,14,28,0,0,0,0,0
ANDHRA PRADESH,KURNOOL,SCHEDULED TRIBES,0.5-1.0,47,RUDRAVARAM,126,83,83,0,83,0,0,0,0,0
ANDHRA PRADESH,KURNOOL,SCHEDULED TRIBES,0.5-1.0,48,ALLAGADDA,94,68,34,34,68,0,0,0,0,0
ANDHRA PRADESH,KURNOOL,SCHEDULED TRIBES,0.5-1.0,49,DORNIPADU,14,10,5,5,10,0,0,0,0,0
ANDHRA PRADESH,KURNOOL,SCHEDULED TRIBES,0.5-1.0,50,SANJAMALA,26,18,18,0,18,0,0,0,0,0
ANDHRA PRADESH,KURNOOL,SCHEDULED TRIBES,0.5-1.0,51,KOLIMIGUNDLA,67,49,49,0,49,0,0,0,0,0
ANDHRA PRADESH,KURNOOL,SCHEDULED TRIBES,0.5-1.0,52,UYYALAWADA,9,6,6,0,6,0,0,0,0,0
ANDHRA PRADESH,KURNOOL,SCHEDULED TRIBES,0.5-1.0,53,CHAGALAMARRI,173,128,46,82,128,0,0,0,0,0
ANDHRA PRADESH,KURNOOL,SCHEDULED TRIBES,0.5-1.0,54,CHAGALAMARRI,173,128,46,82,128,0,0,0,0,0
ANDHRA PRADESH,KURNOOL,ALL SOCIAL GROUPS,0.5-1.0,1,MANTRALAYAM,3028,2232,2199,33,2232,0,0,0,0,0
ANDHRA PRADESH,KURNOOL,ALL SOCIAL GROUPS,0.5-1.0,2,KOSIGI,3773,2800,2772,28,2800,0,0,0,0,0
ANDHRA PRADESH,KURNOOL,ALL SOCIAL GROUPS,0.5-1.0,3,KOWTHALAM,4739,3566,3566,0,3566,0,0,0,0,0
ANDHRA PRADESH,KURNOOL,ALL SOCIAL GROUPS,0.5-1.0,4,PEDDA KADUBUR,2974,2205,2181,25,2206,0,0,0,0,0
ANDHRA PRADESH,KURNOOL,ALL SOCIAL GROUPS,0.5-1.0,5,YEMMIGANUR,4292,3169,3044,80,3124,1,28,0,29,15
ANDHRA PRADESH,KURNOOL,ALL SOCIAL GROUPS,0.5-1.0,6,NANDAVARAM,3619,2729,2672,30,2702,2,16,0,18,9
ANDHRA PRADESH,KURNOOL,ALL SOCIAL GROUPS,0.5-1.0,7,C.BELAGAL,3740,2748,2743,6,2749,0,0,0,0,0
ANDHRA PRADESH,KURNOOL,ALL SOCIAL GROUPS,0.5-1.0,8,GUDUR,2750,2051,2051,0,2051,0,0,0,0,0
ANDHRA PRADESH,KURNOOL,ALL SOCIAL GROUPS,0.5-1.0,9,KALLUR,3952,2947,2916,31,2947,0,0,0,0,0
ANDHRA PRADESH,KURNOOL,ALL SOCIAL GROUPS,0.5-1.0,10,KURNOOL,4043,2973,2907,66,2973,0,0,0,0,0
ANDHRA PRADESH,KURNOOL,ALL SOCIAL GROUPS,0.5-1.0,11,NANDIKOTKUR,2403,1765,1677,72,1749,6,5,0,11,6
ANDHRA PRADESH,KURNOOL,ALL SOCIAL GROUPS,0.5-1.0,12,PAGIDYALA,1264,924,520,383,903,0,12,0,12,9
ANDHRA PRADESH,KURNOOL,ALL SOCIAL GROUPS,0.5-1.0,13,JUPADU BUNGALOW,2421,1857,1695,136,1831,0,21,0,21,4
ANDHRA PRADESH,KURNOOL,ALL SOCIAL GROUPS,0.5-1.0,14,KOTHAPALLE,2180,1604,1474,130,1604,0,0,0,0,0
ANDHRA PRADESH,KURNOOL,ALL SOCIAL GROUPS,0.5-1.0,15,ATMAKUR,3291,2360,2360,0,2360,0,0,0,0,0
ANDHRA PRADESH,KURNOOL,ALL SOCIAL GROUPS,0.5-1.0,16,PAMULAPADU,3295,2372,2314,58,2372,0,0,0,0,0
ANDHRA PRADESH,KURNOOL,ALL SOCIAL GROUPS,0.5-1.0,17,MIDTHUR,2801,2083,2051,32,2083,0,0,0,0,0
ANDHRA PRADESH,KURNOOL,ALL SOCIAL GROUPS,0.5-1.0,18,ORVAKAL,4242,3149,2414,734,3148,0,0,0,0,0
ANDHRA PRADESH,KURNOOL,ALL SOCIAL GROUPS,0.5-1.0,19,KODUMUR,3316,2455,2451,4,2455,0,0,0,0,0
ANDHRA PRADESH,KURNOOL,ALL SOCIAL GROUPS,0.5-1.0,20,GONEGANDLA,3316,2457,2351,106,2457,0,0,0,0,0
ANDHRA PRADESH,KURNOOL,ALL SOCIAL GROUPS,0.5-1.0,21,ADONI,5709,4279,4134,145,4279,0,0,0,0,0
ANDHRA PRADESH,KURNOOL,ALL SOCIAL GROUPS,0.5-1.0,22,HOLAGUNDA,2836,2152,1959,193,2152,0,0,0,0,0
ANDHRA PRADESH,KURNOOL,ALL SOCIAL GROUPS,0.5-1.0,23,HALAHARVI,2627,1995,1990,5,1995,0,0,0,0,0
ANDHRA PRADESH,KURNOOL,ALL SOCIAL GROUPS,0.5-1.0,24,ALUR,2267,1784,1784,0,1784,0,0,0,0,0
ANDHRA PRADESH,KURNOOL,ALL SOCIAL GROUPS,0.5-1.0,25,ASPARI,3739,2865,2159,706,2865,0,0,0,0,0
ANDHRA PRADESH,KURNOOL,ALL SOCIAL GROUPS,0.5-1.0,26,DEVANAKONDA,3087,2348,2262,86,2348,0,0,0,0,0
ANDHRA PRADESH,KURNOOL,ALL SOCIAL GROUPS,0.5-1.0,27,KRISHNAGIRI,2258,1723,1723,0,1723,0,0,0,0,0
ANDHRA PRADESH,KURNOOL,ALL SOCIAL GROUPS,0.5-1.0,28,VELDURTHI,3205,2407,2134,271,2405,1,0,0,1,1
ANDHRA PRADESH,KURNOOL,ALL SOCIAL GROUPS,0.5-1.0,29,BETHAMCHERLA,2727,2070,2070,0,2070,0,0,0,0,0
ANDHRA PRADESH,KURNOOL,ALL SOCIAL GROUPS,0.5-1.0,30,PANYAM,2813,2104,1584,513,2097,0,7,0,7,1
ANDHRA PRADESH,KURNOOL,ALL SOCIAL GROUPS,0.5-1.0,31,GADIVEMULA,2606,1906,1866,28,1894,0,8,0,8,4
ANDHRA PRADESH,KURNOOL,ALL SOCIAL GROUPS,0.5-1.0,32,VELGODE,2250,1654,1654,0,1654,0,0,0,0,0
ANDHRA PRADESH,KURNOOL,ALL SOCIAL GROUPS,0.5-1.0,33,BANDI ATMAKUR,2986,2157,2134,22,2156,0,0,0,0,0
ANDHRA PRADESH,KURNOOL,ALL SOCIAL GROUPS,0.5-1.0,34,NANDYAL,3590,2600,2583,17,2600,0,0,0,0,0
ANDHRA PRADESH,KURNOOL,ALL SOCIAL GROUPS,0.5-1.0,35,MAHANANDI,1693,1242,1215,21,1236,0,0,4,4,2
ANDHRA PRADESH,KURNOOL,ALL SOCIAL GROUPS,0.5-1.0,36,SIRVEL,3377,2465,2465,0,2465,0,0,0,0,0
ANDHRA PRADESH,KURNOOL,ALL SOCIAL GROUPS,0.5-1.0,37,GOSPADU,2382,1732,1728,5,1733,0,0,0,0,0
ANDHRA PRADESH,KURNOOL,ALL SOCIAL GROUPS,0.5-1.0,38,BANAGANAPALLE,4820,3617,2637,981,3618,0,0,0,0,0
ANDHRA PRADESH,KURNOOL,ALL SOCIAL GROUPS,0.5-1.0,39,DHONE,2848,2154,2132,23,2155,0,0,0,0,0
ANDHRA PRADESH,KURNOOL,ALL SOCIAL GROUPS,0.5-1.0,40,PATTIKONDA,2218,1709,1706,3,1709,0,0,0,0,0
ANDHRA PRADESH,KURNOOL,ALL SOCIAL GROUPS,0.5-1.0,41,CHIPPAGIRI,2071,1603,1603,1,1604,0,0,0,0,0
ANDHRA PRADESH,KURNOOL,ALL SOCIAL GROUPS,0.5-1.0,42,MADDIKERA (EAST),2079,1629,1604,25,1629,0,0,0,0,0
ANDHRA PRADESH,KURNOOL,ALL SOCIAL GROUPS,0.5-1.0,43,TUGGALI,2195,1691,1691,0,1691,0,0,0,0,0
ANDHRA PRADESH,KURNOOL,ALL SOCIAL GROUPS,0.5-1.0,44,PEAPALLY,3267,2510,2440,70,2510,0,0,0,0,0
ANDHRA PRADESH,KURNOOL,ALL SOCIAL GROUPS,0.5-1.0,45,OWK,2116,1553,1383,170,1553,0,0,0,0,0
ANDHRA PRADESH,KURNOOL,ALL SOCIAL GROUPS,0.5-1.0,46,KOILKUNTLA,2855,2115,2101,14,2115,0,0,0,0,0
ANDHRA PRADESH,KURNOOL,ALL SOCIAL GROUPS,0.5-1.0,47,RUDRAVARAM,3377,2501,2501,0,2501,0,0,0,0,0
ANDHRA PRADESH,KURNOOL,ALL SOCIAL GROUPS,0.5-1.0,48,ALLAGADDA,4530,3357,1931,1425,3356,0,0,0,0,0
ANDHRA PRADESH,KURNOOL,ALL SOCIAL GROUPS,0.5-1.0,49,DORNIPADU,1864,1380,1375,5,1380,0,0,0,0,0
ANDHRA PRADESH,KURNOOL,ALL SOCIAL GROUPS,0.5-1.0,50,SANJAMALA,2417,1805,1805,0,1805,0,0,0,0,0
ANDHRA PRADESH,KURNOOL,ALL SOCIAL GROUPS,0.5-1.0,51,KOLIMIGUNDLA,1418,1068,1068,0,1068,0,0,0,0,0
ANDHRA PRADESH,KURNOOL,ALL SOCIAL GROUPS,0.5-1.0,52,UYYALAWADA,1964,1453,1453,0,1453,0,0,0,0,0
ANDHRA PRADESH,KURNOOL,ALL SOCIAL GROUPS,0.5-1.0,53,CHAGALAMARRI,3522,2598,967,1631,2598,0,0,0,0,0
ANDHRA PRADESH,KURNOOL,ALL SOCIAL GROUPS,0.5-1.0,54,CHAGALAMARRI,3522,2598,967,1631,2598,0,0,0,0,0
ANDHRA PRADESH,KURNOOL,INSTITUTIONAL,3.0-4.0,1,MANTRALAYAM,0,0,0,0,0,0,0,0,0,0
ANDHRA PRADESH,KURNOOL,INSTITUTIONAL,3.0-4.0,2,KOSIGI,0,0,0,0,0,0,0,0,0,0
ANDHRA PRADESH,KURNOOL,INSTITUTIONAL,3.0-4.0,3,KOWTHALAM,0,0,0,0,0,0,0,0,0,0
ANDHRA PRADESH,KURNOOL,INSTITUTIONAL,3.0-4.0,4,PEDDA KADUBUR,0,0,0,0,0,0,0,0,0,0
ANDHRA PRADESH,KURNOOL,INSTITUTIONAL,3.0-4.0,5,YEMMIGANUR,0,0,0,0,0,0,0,0,0,0
ANDHRA PRADESH,KURNOOL,INSTITUTIONAL,3.0-4.0,6,NANDAVARAM,0,0,0,0,0,0,0,0,0,0
ANDHRA PRADESH,KURNOOL,INSTITUTIONAL,3.0-4.0,7,C.BELAGAL,0,0,0,0,0,0,0,0,0,0
ANDHRA PRADESH,KURNOOL,INSTITUTIONAL,3.0-4.0,8,GUDUR,0,0,0,0,0,0,0,0,0,0
ANDHRA PRADESH,KURNOOL,INSTITUTIONAL,3.0-4.0,9,KALLUR,0,0,0,0,0,0,0,0,0,0
ANDHRA PRADESH,KURNOOL,INSTITUTIONAL,3.0-4.0,10,KURNOOL,0,0,0,0,0,0,0,0,0,0
ANDHRA PRADESH,KURNOOL,INSTITUTIONAL,3.0-4.0,11,NANDIKOTKUR,0,0,0,0,0,0,0,0,0,0
ANDHRA PRADESH,KURNOOL,INSTITUTIONAL,3.0-4.0,12,PAGIDYALA,0,0,0,0,0,0,0,0,0,0
ANDHRA PRADESH,KURNOOL,INSTITUTIONAL,3.0-4.0,13,JUPADU BUNGALOW,0,0,0,0,0,0,0,0,0,0
ANDHRA PRADESH,KURNOOL,INSTITUTIONAL,3.0-4.0,14,KOTHAPALLE,0,0,0,0,0,0,0,0,0,0
ANDHRA PRADESH,KURNOOL,INSTITUTIONAL,3.0-4.0,15,ATMAKUR,0,0,0,0,0,0,0,0,0,0
ANDHRA PRADESH,KURNOOL,INSTITUTIONAL,3.0-4.0,16,PAMULAPADU,0,0,0,0,0,0,0,0,0,0
ANDHRA PRADESH,KURNOOL,INSTITUTIONAL,3.0-4.0,17,MIDTHUR,0,0,0,0,0,0,0,0,0,0
ANDHRA PRADESH,KURNOOL,INSTITUTIONAL,3.0-4.0,18,ORVAKAL,0,0,0,0,0,0,0,0,0,0
ANDHRA PRADESH,KURNOOL,INSTITUTIONAL,3.0-4.0,19,KODUMUR,0,0,0,0,0,0,0,0,0,0
ANDHRA PRADESH,KURNOOL,INSTITUTIONAL,3.0-4.0,20,GONEGANDLA,0,0,0,0,0,0,0,0,0,0
ANDHRA PRADESH,KURNOOL,INSTITUTIONAL,3.0-4.0,21,ADONI,0,0,0,0,0,0,0,0,0,0
ANDHRA PRADESH,KURNOOL,INSTITUTIONAL,3.0-4.0,22,HOLAGUNDA,0,0,0,0,0,0,0,0,0,0
ANDHRA PRADESH,KURNOOL,INSTITUTIONAL,3.0-4.0,23,HALAHARVI,0,0,0,0,0,0,0,0,0,0
ANDHRA PRADESH,KURNOOL,INSTITUTIONAL,3.0-4.0,24,ALUR,0,0,0,0,0,0,0,0,0,0
ANDHRA PRADESH,KURNOOL,INSTITUTIONAL,3.0-4.0,25,ASPARI,0,0,0,0,0,0,0,0,0,0
ANDHRA PRADESH,KURNOOL,INSTITUTIONAL,3.0-4.0,26,DEVANAKONDA,0,0,0,0,0,0,0,0,0,0
ANDHRA PRADESH,KURNOOL,INSTITUTIONAL,3.0-4.0,27,KRISHNAGIRI,0,0,0,0,0,0,0,0,0,0
ANDHRA PRADESH,KURNOOL,INSTITUTIONAL,3.0-4.0,28,VELDURTHI,0,0,0,0,0,0,0,0,0,0
ANDHRA PRADESH,KURNOOL,INSTITUTIONAL,3.0-4.0,29,BETHAMCHERLA,0,0,0,0,0,0,0,0,0,0
ANDHRA PRADESH,KURNOOL,INSTITUTIONAL,3.0-4.0,30,PANYAM,1,3,2,2,4,0,0,0,0,0
ANDHRA PRADESH,KURNOOL,INSTITUTIONAL,3.0-4.0,31,GADIVEMULA,0,0,0,0,0,0,0,0,0,0
ANDHRA PRADESH,KURNOOL,INSTITUTIONAL,3.0-4.0,32,VELGODE,0,0,0,0,0,0,0,0,0,0
ANDHRA PRADESH,KURNOOL,INSTITUTIONAL,3.0-4.0,33,BANDI ATMAKUR,0,0,0,0,0,0,0,0,0,0
ANDHRA PRADESH,KURNOOL,INSTITUTIONAL,3.0-4.0,34,NANDYAL,0,0,0,0,0,0,0,0,0,0
ANDHRA PRADESH,KURNOOL,INSTITUTIONAL,3.0-4.0,35,MAHANANDI,0,0,0,0,0,0,0,0,0,0
ANDHRA PRADESH,KURNOOL,INSTITUTIONAL,3.0-4.0,36,SIRVEL,0,0,0,0,0,0,0,0,0,0
ANDHRA PRADESH,KURNOOL,INSTITUTIONAL,3.0-4.0,37,GOSPADU,0,0,0,0,0,0,0,0,0,0
ANDHRA PRADESH,KURNOOL,INSTITUTIONAL,3.0-4.0,38,BANAGANAPALLE,0,0,0,0,0,0,0,0,0,0
ANDHRA PRADESH,KURNOOL,INSTITUTIONAL,3.0-4.0,39,DHONE,0,0,0,0,0,0,0,0,0,0
ANDHRA PRADESH,KURNOOL,INSTITUTIONAL,3.0-4.0,40,PATTIKONDA,0,0,0,0,0,0,0,0,0,0
ANDHRA PRADESH,KURNOOL,INSTITUTIONAL,3.0-4.0,41,CHIPPAGIRI,0,0,0,0,0,0,0,0,0,0
ANDHRA PRADESH,KURNOOL,INSTITUTIONAL,3.0-4.0,42,MADDIKERA (EAST),0,0,0,0,0,0,0,0,0,0
ANDHRA PRADESH,KURNOOL,INSTITUTIONAL,3.0-4.0,43,TUGGALI,0,0,0,0,0,0,0,0,0,0
ANDHRA PRADESH,KURNOOL,INSTITUTIONAL,3.0-4.0,44,PEAPALLY,0,0,0,0,0,0,0,0,0,0
ANDHRA PRADESH,KURNOOL,INSTITUTIONAL,3.0-4.0,45,OWK,0,0,0,0,0,0,0,0,0,0
ANDHRA PRADESH,KURNOOL,INSTITUTIONAL,3.0-4.0,46,KOILKUNTLA,0,0,0,0,0,0,0,0,0,0
ANDHRA PRADESH,KURNOOL,INSTITUTIONAL,3.0-4.0,47,RUDRAVARAM,0,0,0,0,0,0,0,0,0,0
ANDHRA PRADESH,KURNOOL,INSTITUTIONAL,3.0-4.0,48,ALLAGADDA,0,0,0,0,0,0,0,0,0,0
ANDHRA PRADESH,KURNOOL,INSTITUTIONAL,3.0-4.0,49,DORNIPADU,0,0,0,0,0,0,0,0,0,0
ANDHRA PRADESH,KURNOOL,INSTITUTIONAL,3.0-4.0,50,SANJAMALA,0,0,0,0,0,0,0,0,0,0
ANDHRA PRADESH,KURNOOL,INSTITUTIONAL,3.0-4.0,51,KOLIMIGUNDLA,0,0,0,0,0,0,0,0,0,0
ANDHRA PRADESH,KURNOOL,INSTITUTIONAL,3.0-4.0,52,UYYALAWADA,0,0,0,0,0,0,0,0,0,0
ANDHRA PRADESH,KURNOOL,INSTITUTIONAL,3.0-4.0,53,CHAGALAMARRI,0,0,0,0,0,0,0,0,0,0
ANDHRA PRADESH,KURNOOL,INSTITUTIONAL,3.0-4.0,54,CHAGALAMARRI,0,0,0,0,0,0,0,0,0,0
ANDHRA PRADESH,KURNOOL,SCHEDULED CASTE,3.0-4.0,1,MANTRALAYAM,30,101,79,23,102,0,0,0,0,0
ANDHRA PRADESH,KURNOOL,SCHEDULED CASTE,3.0-4.0,2,KOSIGI,14,46,46,0,46,0,0,0,0,0
ANDHRA PRADESH,KURNOOL,SCHEDULED CASTE,3.0-4.0,3,KOWTHALAM,70,238,238,0,238,0,0,0,0,0
ANDHRA PRADESH,KURNOOL,SCHEDULED CASTE,3.0-4.0,4,PEDDA KADUBUR,45,154,145,9,154,0,0,0,0,0
ANDHRA PRADESH,KURNOOL,SCHEDULED CASTE,3.0-4.0,5,YEMMIGANUR,37,124,124,0,124,0,0,0,0,0
ANDHRA PRADESH,KURNOOL,SCHEDULED CASTE,3.0-4.0,6,NANDAVARAM,36,123,113,0,113,3,4,0,7,3
ANDHRA PRADESH,KURNOOL,SCHEDULED CASTE,3.0-4.0,7,C.BELAGAL,16,54,54,0,54,0,0,0,0,0
ANDHRA PRADESH,KURNOOL,SCHEDULED CASTE,3.0-4.0,8,GUDUR,16,53,40,13,53,0,0,0,0,0
ANDHRA PRADESH,KURNOOL,SCHEDULED CASTE,3.0-4.0,9,KALLUR,24,83,83,0,83,0,0,0,0,0
ANDHRA PRADESH,KURNOOL,SCHEDULED CASTE,3.0-4.0,10,KURNOOL,47,162,162,0,162,0,0,0,0,0
ANDHRA PRADESH,KURNOOL,SCHEDULED CASTE,3.0-4.0,11,NANDIKOTKUR,22,76,70,5,75,0,0,0,0,0
ANDHRA PRADESH,KURNOOL,SCHEDULED CASTE,3.0-4.0,12,PAGIDYALA,12,42,21,21,42,0,0,0,0,0
ANDHRA PRADESH,KURNOOL,SCHEDULED CASTE,3.0-4.0,13,JUPADU BUNGALOW,30,102,102,0,102,0,0,0,0,0
ANDHRA PRADESH,KURNOOL,SCHEDULED CASTE,3.0-4.0,14,KOTHAPALLE,38,132,83,48,131,0,0,0,0,0
ANDHRA PRADESH,KURNOOL,SCHEDULED CASTE,3.0-4.0,15,ATMAKUR,11,36,36,0,36,0,0,0,0,0
ANDHRA PRADESH,KURNOOL,SCHEDULED CASTE,3.0-4.0,16,PAMULAPADU,13,44,44,0,44,0,0,0,0,0
ANDHRA PRADESH,KURNOOL,SCHEDULED CASTE,3.0-4.0,17,MIDTHUR,68,230,230,0,230,0,0,0,0,0
ANDHRA PRADESH,KURNOOL,SCHEDULED CASTE,3.0-4.0,18,ORVAKAL,21,72,43,29,72,0,0,0,0,0
ANDHRA PRADESH,KURNOOL,SCHEDULED CASTE,3.0-4.0,19,KODUMUR,22,73,73,0,73,0,0,0,0,0
ANDHRA PRADESH,KURNOOL,SCHEDULED CASTE,3.0-4.0,20,GONEGANDLA,14,47,24,23,47,0,0,0,0,0
ANDHRA PRADESH,KURNOOL,SCHEDULED CASTE,3.0-4.0,21,ADONI,73,251,251,0,251,0,0,0,0,0
ANDHRA PRADESH,KURNOOL,SCHEDULED CASTE,3.0-4.0,22,HOLAGUNDA,51,177,89,87,176,0,0,0,0,0
ANDHRA PRADESH,KURNOOL,SCHEDULED CASTE,3.0-4.0,23,HALAHARVI,16,55,28,28,56,0,0,0,0,0
ANDHRA PRADESH,KURNOOL,SCHEDULED CASTE,3.0-4.0,24,ALUR,101,344,326,15,341,0,2,0,2,0
ANDHRA PRADESH,KURNOOL,SCHEDULED CASTE,3.0-4.0,25,ASPARI,116,401,384,17,401,0,0,0,0,0
ANDHRA PRADESH,KURNOOL,SCHEDULED CASTE,3.0-4.0,26,DEVANAKONDA,121,415,399,16,415,0,0,0,0,0
ANDHRA PRADESH,KURNOOL,SCHEDULED CASTE,3.0-4.0,27,KRISHNAGIRI,64,218,204,14,218,0,0,0,0,0
ANDHRA PRADESH,KURNOOL,SCHEDULED CASTE,3.0-4.0,28,VELDURTHI,50,174,174,0,174,0,0,0,0,0
ANDHRA PRADESH,KURNOOL,SCHEDULED CASTE,3.0-4.0,29,BETHAMCHERLA,24,83,83,0,83,0,0,0,0,0
ANDHRA PRADESH,KURNOOL,SCHEDULED CASTE,3.0-4.0,30,PANYAM,28,95,86,9,95,0,0,0,0,0
ANDHRA PRADESH,KURNOOL,SCHEDULED CASTE,3.0-4.0,31,GADIVEMULA,36,124,124,0,124,0,0,0,0,0
ANDHRA PRADESH,KURNOOL,SCHEDULED CASTE,3.0-4.0,32,VELGODE,8,27,27,0,27,0,0,0,0,0
ANDHRA PRADESH,KURNOOL,SCHEDULED CASTE,3.0-4.0,33,BANDI ATMAKUR,9,30,30,0,30,0,0,0,0,0
ANDHRA PRADESH,KURNOOL,SCHEDULED CASTE,3.0-4.0,34,NANDYAL,17,58,58,0,58,0,0,0,0,0
ANDHRA PRADESH,KURNOOL,SCHEDULED CASTE,3.0-4.0,35,MAHANANDI,14,49,24,0,24,0,2,9,11,14
ANDHRA PRADESH,KURNOOL,SCHEDULED CASTE,3.0-4.0,36,SIRVEL,8,27,13,13,26,0,0,0,0,0
ANDHRA PRADESH,KURNOOL,SCHEDULED CASTE,3.0-4.0,37,GOSPADU,6,20,20,0,20,0,0,0,0,0
ANDHRA PRADESH,KURNOOL,SCHEDULED CASTE,3.0-4.0,38,BANAGANAPALLE,29,97,97,0,97,0,0,0,0,0
ANDHRA PRADESH,KURNOOL,SCHEDULED CASTE,3.0-4.0,39,DHONE,41,139,139,0,139,0,0,0,0,0
ANDHRA PRADESH,KURNOOL,SCHEDULED CASTE,3.0-4.0,40,PATTIKONDA,80,271,215,56,271,0,0,0,0,0
ANDHRA PRADESH,KURNOOL,SCHEDULED CASTE,3.0-4.0,41,CHIPPAGIRI,33,114,114,0,114,0,0,0,0,0
ANDHRA PRADESH,KURNOOL,SCHEDULED CASTE,3.0-4.0,42,MADDIKERA (EAST),27,91,91,0,91,0,0,0,0,0
ANDHRA PRADESH,KURNOOL,SCHEDULED CASTE,3.0-4.0,43,TUGGALI,88,304,304,0,304,0,0,0,0,0
ANDHRA PRADESH,KURNOOL,SCHEDULED CASTE,3.0-4.0,44,PEAPALLY,25,83,83,0,83,0,0,0,0,0
ANDHRA PRADESH,KURNOOL,SCHEDULED CASTE,3.0-4.0,45,OWK,29,98,98,0,98,0,0,0,0,0
ANDHRA PRADESH,KURNOOL,SCHEDULED CASTE,3.0-4.0,46,KOILKUNTLA,21,72,72,0,72,0,0,0,0,0
ANDHRA PRADESH,KURNOOL,SCHEDULED CASTE,3.0-4.0,47,RUDRAVARAM,38,129,129,0,129,0,0,0,0,0
ANDHRA PRADESH,KURNOOL,SCHEDULED CASTE,3.0-4.0,48,ALLAGADDA,7,24,0,24,24,0,0,0,0,0
ANDHRA PRADESH,KURNOOL,SCHEDULED CASTE,3.0-4.0,49,DORNIPADU,14,47,24,24,48,0,0,0,0,0
ANDHRA PRADESH,KURNOOL,SCHEDULED CASTE,3.0-4.0,50,SANJAMALA,23,78,78,0,78,0,0,0,0,0
ANDHRA PRADESH,KURNOOL,SCHEDULED CASTE,3.0-4.0,51,KOLIMIGUNDLA,38,131,131,0,131,0,0,0,0,0
ANDHRA PRADESH,KURNOOL,SCHEDULED CASTE,3.0-4.0,52,UYYALAWADA,11,37,37,0,37,0,0,0,0,0
ANDHRA PRADESH,KURNOOL,SCHEDULED CASTE,3.0-4.0,53,CHAGALAMARRI,11,37,0,37,37,0,0,0,0,0
ANDHRA PRADESH,KURNOOL,SCHEDULED CASTE,3.0-4.0,54,CHAGALAMARRI,11,37,0,37,37,0,0,0,0,0
ANDHRA PRADESH,KURNOOL,OTHERS,3.0-4.0,1,MANTRALAYAM,442,1518,1339,180,1519,0,0,0,0,0
ANDHRA PRADESH,KURNOOL,OTHERS,3.0-4.0,2,KOSIGI,359,1232,1115,117,1232,0,0,0,0,0
ANDHRA PRADESH,KURNOOL,OTHERS,3.0-4.0,3,KOWTHALAM,880,3053,3053,0,3053,0,0,0,0,0
ANDHRA PRADESH,KURNOOL,OTHERS,3.0-4.0,4,PEDDA KADUBUR,408,1404,1327,76,1403,0,0,0,0,0
ANDHRA PRADESH,KURNOOL,OTHERS,3.0-4.0,5,YEMMIGANUR,759,2611,2537,33,2570,3,23,0,26,14
ANDHRA PRADESH,KURNOOL,OTHERS,3.0-4.0,6,NANDAVARAM,731,2527,2421,75,2496,3,17,0,20,11
ANDHRA PRADESH,KURNOOL,OTHERS,3.0-4.0,7,C.BELAGAL,308,1049,1028,21,1049,0,0,0,0,0
ANDHRA PRADESH,KURNOOL,OTHERS,3.0-4.0,8,GUDUR,351,1204,1021,184,1205,0,0,0,0,0
ANDHRA PRADESH,KURNOOL,OTHERS,3.0-4.0,9,KALLUR,647,2224,2202,22,2224,0,0,0,0,0
ANDHRA PRADESH,KURNOOL,OTHERS,3.0-4.0,10,KURNOOL,530,1833,1829,4,1833,0,0,0,0,0
ANDHRA PRADESH,KURNOOL,OTHERS,3.0-4.0,11,NANDIKOTKUR,355,1235,1096,118,1214,4,5,0,9,12
ANDHRA PRADESH,KURNOOL,OTHERS,3.0-4.0,12,PAGIDYALA,191,665,463,199,662,0,2,0,2,2
ANDHRA PRADESH,KURNOOL,OTHERS,3.0-4.0,13,JUPADU BUNGALOW,334,1168,1010,158,1168,0,0,0,0,0
ANDHRA PRADESH,KURNOOL,OTHERS,3.0-4.0,14,KOTHAPALLE,225,781,608,173,781,0,0,0,0,0
ANDHRA PRADESH,KURNOOL,OTHERS,3.0-4.0,15,ATMAKUR,211,729,729,0,729,0,0,0,0,0
ANDHRA PRADESH,KURNOOL,OTHERS,3.0-4.0,16,PAMULAPADU,170,586,560,25,585,0,0,0,0,0
ANDHRA PRADESH,KURNOOL,OTHERS,3.0-4.0,17,MIDTHUR,733,2533,2483,50,2533,0,0,0,0,0
ANDHRA PRADESH,KURNOOL,OTHERS,3.0-4.0,18,ORVAKAL,603,2065,1787,278,2065,0,0,0,0,0
ANDHRA PRADESH,KURNOOL,OTHERS,3.0-4.0,19,KODUMUR,498,1705,1654,51,1705,0,0,0,0,0
ANDHRA PRADESH,KURNOOL,OTHERS,3.0-4.0,20,GONEGANDLA,721,2438,2070,368,2438,0,0,0,0,0
ANDHRA PRADESH,KURNOOL,OTHERS,3.0-4.0,21,ADONI,1210,4171,4127,43,4170,0,0,0,0,0
ANDHRA PRADESH,KURNOOL,OTHERS,3.0-4.0,22,HOLAGUNDA,754,2603,1524,1067,2591,0,8,0,8,4
ANDHRA PRADESH,KURNOOL,OTHERS,3.0-4.0,23,HALAHARVI,608,2096,2096,0,2096,0,0,0,0,0
ANDHRA PRADESH,KURNOOL,OTHERS,3.0-4.0,24,ALUR,988,3395,3263,120,3383,0,7,0,7,4
ANDHRA PRADESH,KURNOOL,OTHERS,3.0-4.0,25,ASPARI,992,3442,2795,647,3442,0,0,0,0,0
ANDHRA PRADESH,KURNOOL,OTHERS,3.0-4.0,26,DEVANAKONDA,980,3367,3266,101,3367,0,0,0,0,0
ANDHRA PRADESH,KURNOOL,OTHERS,3.0-4.0,27,KRISHNAGIRI,888,3055,2883,171,3054,0,0,0,0,0
ANDHRA PRADESH,KURNOOL,OTHERS,3.0-4.0,28,VELDURTHI,675,2345,1581,764,2345,0,0,0,0,0
ANDHRA PRADESH,KURNOOL,OTHERS,3.0-4.0,29,BETHAMCHERLA,529,1820,1773,48,1821,0,0,0,0,0
ANDHRA PRADESH,KURNOOL,OTHERS,3.0-4.0,30,PANYAM,505,1744,1191,544,1735,0,6,0,6,3
ANDHRA PRADESH,KURNOOL,OTHERS,3.0-4.0,31,GADIVEMULA,481,1643,1588,40,1628,0,10,0,10,6
ANDHRA PRADESH,KURNOOL,OTHERS,3.0-4.0,32,VELGODE,217,748,737,10,747,0,0,0,0,0
ANDHRA PRADESH,KURNOOL,OTHERS,3.0-4.0,33,BANDI ATMAKUR,412,1412,1336,63,1399,4,3,2,9,4
ANDHRA PRADESH,KURNOOL,OTHERS,3.0-4.0,34,NANDYAL,434,1506,1486,20,1506,0,0,0,0,0
ANDHRA PRADESH,KURNOOL,OTHERS,3.0-4.0,35,MAHANANDI,207,715,668,4,672,6,6,16,28,15
ANDHRA PRADESH,KURNOOL,OTHERS,3.0-4.0,36,SIRVEL,375,1290,1290,0,1290,0,0,0,0,0
ANDHRA PRADESH,KURNOOL,OTHERS,3.0-4.0,37,GOSPADU,347,1192,1192,0,1192,0,0,0,0,0
ANDHRA PRADESH,KURNOOL,OTHERS,3.0-4.0,38,BANAGANAPALLE,893,3081,2210,871,3081,0,0,0,0,0
ANDHRA PRADESH,KURNOOL,OTHERS,3.0-4.0,39,DHONE,829,2855,2817,38,2855,0,0,0,0,0
ANDHRA PRADESH,KURNOOL,OTHERS,3.0-4.0,40,PATTIKONDA,901,3101,2407,694,3101,0,0,0,0,0
ANDHRA PRADESH,KURNOOL,OTHERS,3.0-4.0,41,CHIPPAGIRI,921,3194,3194,0,3194,0,0,0,0,0
ANDHRA PRADESH,KURNOOL,OTHERS,3.0-4.0,42,MADDIKERA (EAST),797,2741,2680,62,2742,0,0,0,0,0
ANDHRA PRADESH,KURNOOL,OTHERS,3.0-4.0,43,TUGGALI,881,3039,3039,0,3039,0,0,0,0,0
ANDHRA PRADESH,KURNOOL,OTHERS,3.0-4.0,44,PEAPALLY,695,2372,2144,228,2372,0,0,0,0,0
ANDHRA PRADESH,KURNOOL,OTHERS,3.0-4.0,45,OWK,505,1753,1753,0,1753,0,0,0,0,0
ANDHRA PRADESH,KURNOOL,OTHERS,3.0-4.0,46,KOILKUNTLA,586,2025,1988,37,2025,0,0,0,0,0
ANDHRA PRADESH,KURNOOL,OTHERS,3.0-4.0,47,RUDRAVARAM,636,2181,2181,0,2181,0,0,0,0,0
ANDHRA PRADESH,KURNOOL,OTHERS,3.0-4.0,48,ALLAGADDA,489,1699,871,828,1699,0,0,0,0,0
ANDHRA PRADESH,KURNOOL,OTHERS,3.0-4.0,49,DORNIPADU,351,1198,1198,0,1198,0,0,0,0,0
ANDHRA PRADESH,KURNOOL,OTHERS,3.0-4.0,50,SANJAMALA,660,2271,2271,0,2271,0,0,0,0,0
ANDHRA PRADESH,KURNOOL,OTHERS,3.0-4.0,51,KOLIMIGUNDLA,504,1739,1739,0,1739,0,0,0,0,0
ANDHRA PRADESH,KURNOOL,OTHERS,3.0-4.0,52,UYYALAWADA,638,2205,2183,22,2205,0,0,0,0,0
ANDHRA PRADESH,KURNOOL,OTHERS,3.0-4.0,53,CHAGALAMARRI,282,962,551,410,961,0,0,0,0,0
ANDHRA PRADESH,KURNOOL,OTHERS,3.0-4.0,54,CHAGALAMARRI,282,962,551,410,961,0,0,0,0,0
ANDHRA PRADESH,KURNOOL,SCHEDULED TRIBES,3.0-4.0,1,MANTRALAYAM,1,3,2,2,4,0,0,0,0,0
ANDHRA PRADESH,KURNOOL,SCHEDULED TRIBES,3.0-4.0,2,KOSIGI,0,0,0,0,0,0,0,0,0,0
ANDHRA PRADESH,KURNOOL,SCHEDULED TRIBES,3.0-4.0,3,KOWTHALAM,19,66,66,0,66,0,0,0,0,0
ANDHRA PRADESH,KURNOOL,SCHEDULED TRIBES,3.0-4.0,4,PEDDA KADUBUR,1,4,2,2,4,0,0,0,0,0
ANDHRA PRADESH,KURNOOL,SCHEDULED TRIBES,3.0-4.0,5,YEMMIGANUR,0,0,0,0,0,0,0,0,0,0
ANDHRA PRADESH,KURNOOL,SCHEDULED TRIBES,3.0-4.0,6,NANDAVARAM,0,0,0,0,0,0,0,0,0,0
ANDHRA PRADESH,KURNOOL,SCHEDULED TRIBES,3.0-4.0,7,C.BELAGAL,0,0,0,0,0,0,0,0,0,0
ANDHRA PRADESH,KURNOOL,SCHEDULED TRIBES,3.0-4.0,8,GUDUR,1,4,2,2,4,0,0,0,0,0
ANDHRA PRADESH,KURNOOL,SCHEDULED TRIBES,3.0-4.0,9,KALLUR,23,78,78,0,78,0,0,0,0,0
ANDHRA PRADESH,KURNOOL,SCHEDULED TRIBES,3.0-4.0,10,KURNOOL,5,18,18,0,18,0,0,0,0,0
ANDHRA PRADESH,KURNOOL,SCHEDULED TRIBES,3.0-4.0,11,NANDIKOTKUR,0,0,0,0,0,0,0,0,0,0
ANDHRA PRADESH,KURNOOL,SCHEDULED TRIBES,3.0-4.0,12,PAGIDYALA,0,0,0,0,0,0,0,0,0,0
ANDHRA PRADESH,KURNOOL,SCHEDULED TRIBES,3.0-4.0,13,JUPADU BUNGALOW,1,3,2,2,4,0,0,0,0,0
ANDHRA PRADESH,KURNOOL,SCHEDULED TRIBES,3.0-4.0,14,KOTHAPALLE,8,28,14,14,28,0,0,0,0,0
ANDHRA PRADESH,KURNOOL,SCHEDULED TRIBES,3.0-4.0,15,ATMAKUR,4,13,6,6,12,0,0,0,0,0
ANDHRA PRADESH,KURNOOL,SCHEDULED TRIBES,3.0-4.0,16,PAMULAPADU,0,0,0,0,0,0,0,0,0,0
ANDHRA PRADESH,KURNOOL,SCHEDULED TRIBES,3.0-4.0,17,MIDTHUR,0,0,0,0,0,0,0,0,0,0
ANDHRA PRADESH,KURNOOL,SCHEDULED TRIBES,3.0-4.0,18,ORVAKAL,4,13,13,0,13,0,0,0,0,0
ANDHRA PRADESH,KURNOOL,SCHEDULED TRIBES,3.0-4.0,19,KODUMUR,1,3,2,2,4,0,0,0,0,0
ANDHRA PRADESH,KURNOOL,SCHEDULED TRIBES,3.0-4.0,20,GONEGANDLA,5,16,8,8,16,0,0,0,0,0
ANDHRA PRADESH,KURNOOL,SCHEDULED TRIBES,3.0-4.0,21,ADONI,2,7,4,4,8,0,0,0,0,0
ANDHRA PRADESH,KURNOOL,SCHEDULED TRIBES,3.0-4.0,22,HOLAGUNDA,7,24,14,11,25,0,0,0,0,0
ANDHRA PRADESH,KURNOOL,SCHEDULED TRIBES,3.0-4.0,23,HALAHARVI,1,3,2,2,4,0,0,0,0,0
ANDHRA PRADESH,KURNOOL,SCHEDULED TRIBES,3.0-4.0,24,ALUR,15,53,53,0,53,0,0,0,0,0
ANDHRA PRADESH,KURNOOL,SCHEDULED TRIBES,3.0-4.0,25,ASPARI,2,6,3,3,6,0,0,0,0,0
ANDHRA PRADESH,KURNOOL,SCHEDULED TRIBES,3.0-4.0,26,DEVANAKONDA,8,28,28,0,28,0,0,0,0,0
ANDHRA PRADESH,KURNOOL,SCHEDULED TRIBES,3.0-4.0,27,KRISHNAGIRI,21,71,71,0,71,0,0,0,0,0
ANDHRA PRADESH,KURNOOL,SCHEDULED TRIBES,3.0-4.0,28,VELDURTHI,3,10,5,5,10,0,0,0,0,0
ANDHRA PRADESH,KURNOOL,SCHEDULED TRIBES,3.0-4.0,29,BETHAMCHERLA,8,26,0,26,26,0,0,0,0,0
ANDHRA PRADESH,KURNOOL,SCHEDULED TRIBES,3.0-4.0,30,PANYAM,4,13,6,6,12,0,0,0,0,0
ANDHRA PRADESH,KURNOOL,SCHEDULED TRIBES,3.0-4.0,31,GADIVEMULA,25,87,87,0,87,0,0,0,0,0
ANDHRA PRADESH,KURNOOL,SCHEDULED TRIBES,3.0-4.0,32,VELGODE,1,3,2,2,4,0,0,0,0,0
ANDHRA PRADESH,KURNOOL,SCHEDULED TRIBES,3.0-4.0,33,BANDI ATMAKUR,4,13,7,7,14,0,0,0,0,0
ANDHRA PRADESH,KURNOOL,SCHEDULED TRIBES,3.0-4.0,34,NANDYAL,0,0,0,0,0,0,0,0,0,0
ANDHRA PRADESH,KURNOOL,SCHEDULED TRIBES,3.0-4.0,35,MAHANANDI,0,0,0,0,0,0,0,0,0,0
ANDHRA PRADESH,KURNOOL,SCHEDULED TRIBES,3.0-4.0,36,SIRVEL,4,13,7,7,14,0,0,0,0,0
ANDHRA PRADESH,KURNOOL,SCHEDULED TRIBES,3.0-4.0,37,GOSPADU,0,0,0,0,0,0,0,0,0,0
ANDHRA PRADESH,KURNOOL,SCHEDULED TRIBES,3.0-4.0,38,BANAGANAPALLE,26,88,86,2,88,0,0,0,0,0
ANDHRA PRADESH,KURNOOL,SCHEDULED TRIBES,3.0-4.0,39,DHONE,34,117,117,0,117,0,0,0,0,0
ANDHRA PRADESH,KURNOOL,SCHEDULED TRIBES,3.0-4.0,40,PATTIKONDA,82,283,186,97,283,0,0,0,0,0
ANDHRA PRADESH,KURNOOL,SCHEDULED TRIBES,3.0-4.0,41,CHIPPAGIRI,0,0,0,0,0,0,0,0,0,0
ANDHRA PRADESH,KURNOOL,SCHEDULED TRIBES,3.0-4.0,42,MADDIKERA (EAST),4,13,13,0,13,0,0,0,0,0
ANDHRA PRADESH,KURNOOL,SCHEDULED TRIBES,3.0-4.0,43,TUGGALI,74,257,257,0,257,0,0,0,0,0
ANDHRA PRADESH,KURNOOL,SCHEDULED TRIBES,3.0-4.0,44,PEAPALLY,14,46,46,0,46,0,0,0,0,0
ANDHRA PRADESH,KURNOOL,SCHEDULED TRIBES,3.0-4.0,45,OWK,18,60,60,0,60,0,0,0,0,0
ANDHRA PRADESH,KURNOOL,SCHEDULED TRIBES,3.0-4.0,46,KOILKUNTLA,6,20,20,0,20,0,0,0,0,0
ANDHRA PRADESH,KURNOOL,SCHEDULED TRIBES,3.0-4.0,47,RUDRAVARAM,9,29,29,0,29,0,0,0,0,0
ANDHRA PRADESH,KURNOOL,SCHEDULED TRIBES,3.0-4.0,48,ALLAGADDA,2,6,6,0,6,0,0,0,0,0
ANDHRA PRADESH,KURNOOL,SCHEDULED TRIBES,3.0-4.0,49,DORNIPADU,0,0,0,0,0,0,0,0,0,0
ANDHRA PRADESH,KURNOOL,SCHEDULED TRIBES,3.0-4.0,50,SANJAMALA,2,7,4,4,8,0,0,0,0,0
ANDHRA PRADESH,KURNOOL,SCHEDULED TRIBES,3.0-4.0,51,KOLIMIGUNDLA,2,6,3,3,6,0,0,0,0,0
ANDHRA PRADESH,KURNOOL,SCHEDULED TRIBES,3.0-4.0,52,UYYALAWADA,2,8,4,4,8,0,0,0,0,0
ANDHRA PRADESH,KURNOOL,SCHEDULED TRIBES,3.0-4.0,53,CHAGALAMARRI,3,10,0,10,10,0,0,0,0,0
ANDHRA PRADESH,KURNOOL,SCHEDULED TRIBES,3.0-4.0,54,CHAGALAMARRI,3,10,0,10,10,0,0,0,0,0
ANDHRA PRADESH,KURNOOL,ALL SOCIAL GROUPS,3.0-4.0,1,MANTRALAYAM,473,1623,1419,204,1623,0,0,0,0,0
ANDHRA PRADESH,KURNOOL,ALL SOCIAL GROUPS,3.0-4.0,2,KOSIGI,373,1278,1161,117,1278,0,0,0,0,0
ANDHRA PRADESH,KURNOOL,ALL SOCIAL GROUPS,3.0-4.0,3,KOWTHALAM,969,3357,3357,0,3357,0,0,0,0,0
ANDHRA PRADESH,KURNOOL,ALL SOCIAL GROUPS,3.0-4.0,4,PEDDA KADUBUR,454,1562,1474,87,1561,0,0,0,0,0
ANDHRA PRADESH,KURNOOL,ALL SOCIAL GROUPS,3.0-4.0,5,YEMMIGANUR,796,2735,2662,33,2695,3,23,0,26,14
ANDHRA PRADESH,KURNOOL,ALL SOCIAL GROUPS,3.0-4.0,6,NANDAVARAM,767,2650,2534,75,2609,6,21,0,27,14
ANDHRA PRADESH,KURNOOL,ALL SOCIAL GROUPS,3.0-4.0,7,C.BELAGAL,324,1103,1082,21,1103,0,0,0,0,0
ANDHRA PRADESH,KURNOOL,ALL SOCIAL GROUPS,3.0-4.0,8,GUDUR,368,1261,1062,199,1261,0,0,0,0,0
ANDHRA PRADESH,KURNOOL,ALL SOCIAL GROUPS,3.0-4.0,9,KALLUR,694,2385,2363,22,2385,0,0,0,0,0
ANDHRA PRADESH,KURNOOL,ALL SOCIAL GROUPS,3.0-4.0,10,KURNOOL,582,2013,2009,4,2013,0,0,0,0,0
ANDHRA PRADESH,KURNOOL,ALL SOCIAL GROUPS,3.0-4.0,11,NANDIKOTKUR,377,1311,1166,123,1289,4,5,0,9,13
ANDHRA PRADESH,KURNOOL,ALL SOCIAL GROUPS,3.0-4.0,12,PAGIDYALA,203,707,484,220,704,0,2,0,2,2
ANDHRA PRADESH,KURNOOL,ALL SOCIAL GROUPS,3.0-4.0,13,JUPADU BUNGALOW,365,1274,1114,159,1273,0,0,0,0,0
ANDHRA PRADESH,KURNOOL,ALL SOCIAL GROUPS,3.0-4.0,14,KOTHAPALLE,271,940,705,235,940,0,0,0,0,0
ANDHRA PRADESH,KURNOOL,ALL SOCIAL GROUPS,3.0-4.0,15,ATMAKUR,226,778,772,6,778,0,0,0,0,0
ANDHRA PRADESH,KURNOOL,ALL SOCIAL GROUPS,3.0-4.0,16,PAMULAPADU,183,630,604,25,629,0,0,0,0,0
ANDHRA PRADESH,KURNOOL,ALL SOCIAL GROUPS,3.0-4.0,17,MIDTHUR,801,2763,2713,50,2763,0,0,0,0,0
ANDHRA PRADESH,KURNOOL,ALL SOCIAL GROUPS,3.0-4.0,18,ORVAKAL,628,2150,1843,307,2150,0,0,0,0,0
ANDHRA PRADESH,KURNOOL,ALL SOCIAL GROUPS,3.0-4.0,19,KODUMUR,521,1782,1729,53,1782,0,0,0,0,0
ANDHRA PRADESH,KURNOOL,ALL SOCIAL GROUPS,3.0-4.0,20,GONEGANDLA,740,2501,2102,399,2501,0,0,0,0,0
ANDHRA PRADESH,KURNOOL,ALL SOCIAL GROUPS,3.0-4.0,21,ADONI,1285,4429,4382,47,4429,0,0,0,0,0
ANDHRA PRADESH,KURNOOL,ALL SOCIAL GROUPS,3.0-4.0,22,HOLAGUNDA,812,2804,1627,1165,2792,0,8,0,8,4
ANDHRA PRADESH,KURNOOL,ALL SOCIAL GROUPS,3.0-4.0,23,HALAHARVI,625,2154,2125,29,2154,0,0,0,0,0
ANDHRA PRADESH,KURNOOL,ALL SOCIAL GROUPS,3.0-4.0,24,ALUR,1104,3791,3643,136,3779,0,9,0,9,4
ANDHRA PRADESH,KURNOOL,ALL SOCIAL GROUPS,3.0-4.0,25,ASPARI,1110,3850,3183,667,3850,0,0,0,0,0
ANDHRA PRADESH,KURNOOL,ALL SOCIAL GROUPS,3.0-4.0,26,DEVANAKONDA,1109,3810,3693,118,3811,0,0,0,0,0
ANDHRA PRADESH,KURNOOL,ALL SOCIAL GROUPS,3.0-4.0,27,KRISHNAGIRI,973,3344,3158,186,3344,0,0,0,0,0
ANDHRA PRADESH,KURNOOL,ALL SOCIAL GROUPS,3.0-4.0,28,VELDURTHI,728,2529,1759,770,2529,0,0,0,0,0
ANDHRA PRADESH,KURNOOL,ALL SOCIAL GROUPS,3.0-4.0,29,BETHAMCHERLA,561,1930,1856,74,1930,0,0,0,0,0
ANDHRA PRADESH,KURNOOL,ALL SOCIAL GROUPS,3.0-4.0,30,PANYAM,538,1855,1285,561,1846,0,6,0,6,3
ANDHRA PRADESH,KURNOOL,ALL SOCIAL GROUPS,3.0-4.0,31,GADIVEMULA,542,1854,1798,40,1838,0,10,0,10,6
ANDHRA PRADESH,KURNOOL,ALL SOCIAL GROUPS,3.0-4.0,32,VELGODE,226,778,766,12,778,0,0,0,0,0
ANDHRA PRADESH,KURNOOL,ALL SOCIAL GROUPS,3.0-4.0,33,BANDI ATMAKUR,425,1455,1372,69,1441,4,3,2,9,4
ANDHRA PRADESH,KURNOOL,ALL SOCIAL GROUPS,3.0-4.0,34,NANDYAL,451,1565,1544,20,1564,0,0,0,0,0
ANDHRA PRADESH,KURNOOL,ALL SOCIAL GROUPS,3.0-4.0,35,MAHANANDI,221,764,692,4,696,6,8,25,39,29
ANDHRA PRADESH,KURNOOL,ALL SOCIAL GROUPS,3.0-4.0,36,SIRVEL,387,1330,1310,20,1330,0,0,0,0,0
ANDHRA PRADESH,KURNOOL,ALL SOCIAL GROUPS,3.0-4.0,37,GOSPADU,353,1212,1212,0,1212,0,0,0,0,0
ANDHRA PRADESH,KURNOOL,ALL SOCIAL GROUPS,3.0-4.0,38,BANAGANAPALLE,948,3266,2394,873,3267,0,0,0,0,0
ANDHRA PRADESH,KURNOOL,ALL SOCIAL GROUPS,3.0-4.0,39,DHONE,904,3111,3073,38,3111,0,0,0,0,0
ANDHRA PRADESH,KURNOOL,ALL SOCIAL GROUPS,3.0-4.0,40,PATTIKONDA,1063,3655,2808,848,3656,0,0,0,0,0
ANDHRA PRADESH,KURNOOL,ALL SOCIAL GROUPS,3.0-4.0,41,CHIPPAGIRI,954,3308,3308,0,3308,0,0,0,0,0
ANDHRA PRADESH,KURNOOL,ALL SOCIAL GROUPS,3.0-4.0,42,MADDIKERA (EAST),828,2846,2784,62,2846,0,0,0,0,0
ANDHRA PRADESH,KURNOOL,ALL SOCIAL GROUPS,3.0-4.0,43,TUGGALI,1043,3599,3599,0,3599,0,0,0,0,0
ANDHRA PRADESH,KURNOOL,ALL SOCIAL GROUPS,3.0-4.0,44,PEAPALLY,734,2502,2274,228,2502,0,0,0,0,0
ANDHRA PRADESH,KURNOOL,ALL SOCIAL GROUPS,3.0-4.0,45,OWK,552,1911,1911,0,1911,0,0,0,0,0
ANDHRA PRADESH,KURNOOL,ALL SOCIAL GROUPS,3.0-4.0,46,KOILKUNTLA,613,2116,2079,37,2116,0,0,0,0,0
ANDHRA PRADESH,KURNOOL,ALL SOCIAL GROUPS,3.0-4.0,47,RUDRAVARAM,683,2339,2339,0,2339,0,0,0,0,0
ANDHRA PRADESH,KURNOOL,ALL SOCIAL GROUPS,3.0-4.0,48,ALLAGADDA,498,1730,878,852,1730,0,0,0,0,0
ANDHRA PRADESH,KURNOOL,ALL SOCIAL GROUPS,3.0-4.0,49,DORNIPADU,365,1245,1221,24,1245,0,0,0,0,0
ANDHRA PRADESH,KURNOOL,ALL SOCIAL GROUPS,3.0-4.0,50,SANJAMALA,685,2357,2353,4,2357,0,0,0,0,0
ANDHRA PRADESH,KURNOOL,ALL SOCIAL GROUPS,3.0-4.0,51,KOLIMIGUNDLA,544,1877,1874,3,1877,0,0,0,0,0
ANDHRA PRADESH,KURNOOL,ALL SOCIAL GROUPS,3.0-4.0,52,UYYALAWADA,651,2249,2224,25,2249,0,0,0,0,0
ANDHRA PRADESH,KURNOOL,ALL SOCIAL GROUPS,3.0-4.0,53,CHAGALAMARRI,296,1009,551,458,1009,0,0,0,0,0
ANDHRA PRADESH,KURNOOL,ALL SOCIAL GROUPS,3.0-4.0,54,CHAGALAMARRI,296,1009,551,458,1009,0,0,0,0,0
ANDHRA PRADESH,KURNOOL,INSTITUTIONAL,10.0-20.0,1,MANTRALAYAM,0,0,0,0,0,0,0,0,0,0
ANDHRA PRADESH,KURNOOL,INSTITUTIONAL,10.0-20.0,2,KOSIGI,0,0,0,0,0,0,0,0,0,0
ANDHRA PRADESH,KURNOOL,INSTITUTIONAL,10.0-20.0,3,KOWTHALAM,0,0,0,0,0,0,0,0,0,0
ANDHRA PRADESH,KURNOOL,INSTITUTIONAL,10.0-20.0,4,PEDDA KADUBUR,0,0,0,0,0,0,0,0,0,0
ANDHRA PRADESH,KURNOOL,INSTITUTIONAL,10.0-20.0,5,YEMMIGANUR,1,11,6,6,12,0,0,0,0,0
ANDHRA PRADESH,KURNOOL,INSTITUTIONAL,10.0-20.0,6,NANDAVARAM,0,0,0,0,0,0,0,0,0,0
ANDHRA PRADESH,KURNOOL,INSTITUTIONAL,10.0-20.0,7,C.BELAGAL,0,0,0,0,0,0,0,0,0,0
ANDHRA PRADESH,KURNOOL,INSTITUTIONAL,10.0-20.0,8,GUDUR,0,0,0,0,0,0,0,0,0,0
ANDHRA PRADESH,KURNOOL,INSTITUTIONAL,10.0-20.0,9,KALLUR,0,0,0,0,0,0,0,0,0,0
ANDHRA PRADESH,KURNOOL,INSTITUTIONAL,10.0-20.0,10,KURNOOL,0,0,0,0,0,0,0,0,0,0
ANDHRA PRADESH,KURNOOL,INSTITUTIONAL,10.0-20.0,11,NANDIKOTKUR,3,35,3,32,35,0,0,0,0,0
ANDHRA PRADESH,KURNOOL,INSTITUTIONAL,10.0-20.0,12,PAGIDYALA,0,0,0,0,0,0,0,0,0,0
ANDHRA PRADESH,KURNOOL,INSTITUTIONAL,10.0-20.0,13,JUPADU BUNGALOW,0,0,0,0,0,0,0,0,0,0
ANDHRA PRADESH,KURNOOL,INSTITUTIONAL,10.0-20.0,14,KOTHAPALLE,0,0,0,0,0,0,0,0,0,0
ANDHRA PRADESH,KURNOOL,INSTITUTIONAL,10.0-20.0,15,ATMAKUR,0,0,0,0,0,0,0,0,0,0
ANDHRA PRADESH,KURNOOL,INSTITUTIONAL,10.0-20.0,16,PAMULAPADU,0,0,0,0,0,0,0,0,0,0
ANDHRA PRADESH,KURNOOL,INSTITUTIONAL,10.0-20.0,17,MIDTHUR,0,0,0,0,0,0,0,0,0,0
ANDHRA PRADESH,KURNOOL,INSTITUTIONAL,10.0-20.0,18,ORVAKAL,1,17,8,10,18,0,0,0,0,0
ANDHRA PRADESH,KURNOOL,INSTITUTIONAL,10.0-20.0,19,KODUMUR,0,0,0,0,0,0,0,0,0,0
ANDHRA PRADESH,KURNOOL,INSTITUTIONAL,10.0-20.0,20,GONEGANDLA,0,0,0,0,0,0,0,0,0,0
ANDHRA PRADESH,KURNOOL,INSTITUTIONAL,10.0-20.0,21,ADONI,0,0,0,0,0,0,0,0,0,0
ANDHRA PRADESH,KURNOOL,INSTITUTIONAL,10.0-20.0,22,HOLAGUNDA,0,0,0,0,0,0,0,0,0,0
ANDHRA PRADESH,KURNOOL,INSTITUTIONAL,10.0-20.0,23,HALAHARVI,0,0,0,0,0,0,0,0,0,0
ANDHRA PRADESH,KURNOOL,INSTITUTIONAL,10.0-20.0,24,ALUR,0,0,0,0,0,0,0,0,0,0
ANDHRA PRADESH,KURNOOL,INSTITUTIONAL,10.0-20.0,25,ASPARI,0,0,0,0,0,0,0,0,0,0
ANDHRA PRADESH,KURNOOL,INSTITUTIONAL,10.0-20.0,26,DEVANAKONDA,0,0,0,0,0,0,0,0,0,0
ANDHRA PRADESH,KURNOOL,INSTITUTIONAL,10.0-20.0,27,KRISHNAGIRI,0,0,0,0,0,0,0,0,0,0
ANDHRA PRADESH,KURNOOL,INSTITUTIONAL,10.0-20.0,28,VELDURTHI,0,0,0,0,0,0,0,0,0,0
ANDHRA PRADESH,KURNOOL,INSTITUTIONAL,10.0-20.0,29,BETHAMCHERLA,0,0,0,0,0,0,0,0,0,0
ANDHRA PRADESH,KURNOOL,INSTITUTIONAL,10.0-20.0,30,PANYAM,3,53,27,27,54,0,0,0,0,0
ANDHRA PRADESH,KURNOOL,INSTITUTIONAL,10.0-20.0,31,GADIVEMULA,0,0,0,0,0,0,0,0,0,0
ANDHRA PRADESH,KURNOOL,INSTITUTIONAL,10.0-20.0,32,VELGODE,0,0,0,0,0,0,0,0,0,0
ANDHRA PRADESH,KURNOOL,INSTITUTIONAL,10.0-20.0,33,BANDI ATMAKUR,0,0,0,0,0,0,0,0,0,0
ANDHRA PRADESH,KURNOOL,INSTITUTIONAL,10.0-20.0,34,NANDYAL,0,0,0,0,0,0,0,0,0,0
ANDHRA PRADESH,KURNOOL,INSTITUTIONAL,10.0-20.0,35,MAHANANDI,0,0,0,0,0,0,0,0,0,0
ANDHRA PRADESH,KURNOOL,INSTITUTIONAL,10.0-20.0,36,SIRVEL,0,0,0,0,0,0,0,0,0,0
ANDHRA PRADESH,KURNOOL,INSTITUTIONAL,10.0-20.0,37,GOSPADU,0,0,0,0,0,0,0,0,0,0
ANDHRA PRADESH,KURNOOL,INSTITUTIONAL,10.0-20.0,38,BANAGANAPALLE,0,0,0,0,0,0,0,0,0,0
ANDHRA PRADESH,KURNOOL,INSTITUTIONAL,10.0-20.0,39,DHONE,0,0,0,0,0,0,0,0,0,0
ANDHRA PRADESH,KURNOOL,INSTITUTIONAL,10.0-20.0,40,PATTIKONDA,0,0,0,0,0,0,0,0,0,0
ANDHRA PRADESH,KURNOOL,INSTITUTIONAL,10.0-20.0,41,CHIPPAGIRI,0,0,0,0,0,0,0,0,0,0
ANDHRA PRADESH,KURNOOL,INSTITUTIONAL,10.0-20.0,42,MADDIKERA (EAST),0,0,0,0,0,0,0,0,0,0
ANDHRA PRADESH,KURNOOL,INSTITUTIONAL,10.0-20.0,43,TUGGALI,0,0,0,0,0,0,0,0,0,0
ANDHRA PRADESH,KURNOOL,INSTITUTIONAL,10.0-20.0,44,PEAPALLY,0,0,0,0,0,0,0,0,0,0
ANDHRA PRADESH,KURNOOL,INSTITUTIONAL,10.0-20.0,45,OWK,0,0,0,0,0,0,0,0,0,0
ANDHRA PRADESH,KURNOOL,INSTITUTIONAL,10.0-20.0,46,KOILKUNTLA,0,0,0,0,0,0,0,0,0,0
ANDHRA PRADESH,KURNOOL,INSTITUTIONAL,10.0-20.0,47,RUDRAVARAM,0,0,0,0,0,0,0,0,0,0
ANDHRA PRADESH,KURNOOL,INSTITUTIONAL,10.0-20.0,48,ALLAGADDA,0,0,0,0,0,0,0,0,0,0
ANDHRA PRADESH,KURNOOL,INSTITUTIONAL,10.0-20.0,49,DORNIPADU,0,0,0,0,0,0,0,0,0,0
ANDHRA PRADESH,KURNOOL,INSTITUTIONAL,10.0-20.0,50,SANJAMALA,0,0,0,0,0,0,0,0,0,0
ANDHRA PRADESH,KURNOOL,INSTITUTIONAL,10.0-20.0,51,KOLIMIGUNDLA,0,0,0,0,0,0,0,0,0,0
ANDHRA PRADESH,KURNOOL,INSTITUTIONAL,10.0-20.0,52,UYYALAWADA,0,0,0,0,0,0,0,0,0,0
ANDHRA PRADESH,KURNOOL,INSTITUTIONAL,10.0-20.0,53,CHAGALAMARRI,0,0,0,0,0,0,0,0,0,0
ANDHRA PRADESH,KURNOOL,INSTITUTIONAL,10.0-20.0,54,CHAGALAMARRI,0,0,0,0,0,0,0,0,0,0
ANDHRA PRADESH,KURNOOL,SCHEDULED CASTE,10.0-20.0,1,MANTRALAYAM,2,22,22,0,22,0,0,0,0,0
ANDHRA PRADESH,KURNOOL,SCHEDULED CASTE,10.0-20.0,2,KOSIGI,0,0,0,0,0,0,0,0,0,0
ANDHRA PRADESH,KURNOOL,SCHEDULED CASTE,10.0-20.0,3,KOWTHALAM,3,39,39,0,39,0,0,0,0,0
ANDHRA PRADESH,KURNOOL,SCHEDULED CASTE,10.0-20.0,4,PEDDA KADUBUR,3,46,23,23,46,0,0,0,0,0
ANDHRA PRADESH,KURNOOL,SCHEDULED CASTE,10.0-20.0,5,YEMMIGANUR,1,11,6,6,12,0,0,0,0,0
ANDHRA PRADESH,KURNOOL,SCHEDULED CASTE,10.0-20.0,6,NANDAVARAM,0,0,0,0,0,0,0,0,0,0
ANDHRA PRADESH,KURNOOL,SCHEDULED CASTE,10.0-20.0,7,C.BELAGAL,1,14,7,7,14,0,0,0,0,0
ANDHRA PRADESH,KURNOOL,SCHEDULED CASTE,10.0-20.0,8,GUDUR,0,0,0,0,0,0,0,0,0,0
ANDHRA PRADESH,KURNOOL,SCHEDULED CASTE,10.0-20.0,9,KALLUR,0,0,0,0,0,0,0,0,0,0
ANDHRA PRADESH,KURNOOL,SCHEDULED CASTE,10.0-20.0,10,KURNOOL,4,48,48,0,48,0,0,0,0,0
ANDHRA PRADESH,KURNOOL,SCHEDULED CASTE,10.0-20.0,11,NANDIKOTKUR,0,0,0,0,0,0,0,0,0,0
ANDHRA PRADESH,KURNOOL,SCHEDULED CASTE,10.0-20.0,12,PAGIDYALA,0,0,0,0,0,0,0,0,0,0
ANDHRA PRADESH,KURNOOL,SCHEDULED CASTE,10.0-20.0,13,JUPADU BUNGALOW,0,0,0,0,0,0,0,0,0,0
ANDHRA PRADESH,KURNOOL,SCHEDULED CASTE,10.0-20.0,14,KOTHAPALLE,2,23,12,12,24,0,0,0,0,0
ANDHRA PRADESH,KURNOOL,SCHEDULED CASTE,10.0-20.0,15,ATMAKUR,0,0,0,0,0,0,0,0,0,0
ANDHRA PRADESH,KURNOOL,SCHEDULED CASTE,10.0-20.0,16,PAMULAPADU,0,0,0,0,0,0,0,0,0,0
ANDHRA PRADESH,KURNOOL,SCHEDULED CASTE,10.0-20.0,17,MIDTHUR,0,0,0,0,0,0,0,0,0,0
ANDHRA PRADESH,KURNOOL,SCHEDULED CASTE,10.0-20.0,18,ORVAKAL,2,28,5,23,28,0,0,0,0,0
ANDHRA PRADESH,KURNOOL,SCHEDULED CASTE,10.0-20.0,19,KODUMUR,0,0,0,0,0,0,0,0,0,0
ANDHRA PRADESH,KURNOOL,SCHEDULED CASTE,10.0-20.0,20,GONEGANDLA,0,0,0,0,0,0,0,0,0,0
ANDHRA PRADESH,KURNOOL,SCHEDULED CASTE,10.0-20.0,21,ADONI,3,35,18,18,36,0,0,0,0,0
ANDHRA PRADESH,KURNOOL,SCHEDULED CASTE,10.0-20.0,22,HOLAGUNDA,1,12,7,5,12,0,0,0,0,0
ANDHRA PRADESH,KURNOOL,SCHEDULED CASTE,10.0-20.0,23,HALAHARVI,3,33,17,17,34,0,0,0,0,0
ANDHRA PRADESH,KURNOOL,SCHEDULED CASTE,10.0-20.0,24,ALUR,3,40,20,20,40,0,0,0,0,0
ANDHRA PRADESH,KURNOOL,SCHEDULED CASTE,10.0-20.0,25,ASPARI,0,0,0,0,0,0,0,0,0,0
ANDHRA PRADESH,KURNOOL,SCHEDULED CASTE,10.0-20.0,26,DEVANAKONDA,0,0,0,0,0,0,0,0,0,0
ANDHRA PRADESH,KURNOOL,SCHEDULED CASTE,10.0-20.0,27,KRISHNAGIRI,1,11,6,6,12,0,0,0,0,0
ANDHRA PRADESH,KURNOOL,SCHEDULED CASTE,10.0-20.0,28,VELDURTHI,0,0,0,0,0,0,0,0,0,0
ANDHRA PRADESH,KURNOOL,SCHEDULED CASTE,10.0-20.0,29,BETHAMCHERLA,0,0,0,0,0,0,0,0,0,0
ANDHRA PRADESH,KURNOOL,SCHEDULED CASTE,10.0-20.0,30,PANYAM,0,0,0,0,0,0,0,0,0,0
ANDHRA PRADESH,KURNOOL,SCHEDULED CASTE,10.0-20.0,31,GADIVEMULA,2,22,11,11,22,0,0,0,0,0
ANDHRA PRADESH,KURNOOL,SCHEDULED CASTE,10.0-20.0,32,VELGODE,1,11,11,0,11,0,0,0,0,0
ANDHRA PRADESH,KURNOOL,SCHEDULED CASTE,10.0-20.0,33,BANDI ATMAKUR,0,0,0,0,0,0,0,0,0,0
ANDHRA PRADESH,KURNOOL,SCHEDULED CASTE,10.0-20.0,34,NANDYAL,0,0,0,0,0,0,0,0,0,0
ANDHRA PRADESH,KURNOOL,SCHEDULED CASTE,10.0-20.0,35,MAHANANDI,2,32,16,16,32,0,0,0,0,0
ANDHRA PRADESH,KURNOOL,SCHEDULED CASTE,10.0-20.0,36,SIRVEL,0,0,0,0,0,0,0,0,0,0
ANDHRA PRADESH,KURNOOL,SCHEDULED CASTE,10.0-20.0,37,GOSPADU,0,0,0,0,0,0,0,0,0,0
ANDHRA PRADESH,KURNOOL,SCHEDULED CASTE,10.0-20.0,38,BANAGANAPALLE,0,0,0,0,0,0,0,0,0,0
ANDHRA PRADESH,KURNOOL,SCHEDULED CASTE,10.0-20.0,39,DHONE,1,14,7,7,14,0,0,0,0,0
ANDHRA PRADESH,KURNOOL,SCHEDULED CASTE,10.0-20.0,40,PATTIKONDA,2,23,11,11,22,0,0,0,0,0
ANDHRA PRADESH,KURNOOL,SCHEDULED CASTE,10.0-20.0,41,CHIPPAGIRI,0,0,0,0,0,0,0,0,0,0
ANDHRA PRADESH,KURNOOL,SCHEDULED CASTE,10.0-20.0,42,MADDIKERA (EAST),0,0,0,0,0,0,0,0,0,0
ANDHRA PRADESH,KURNOOL,SCHEDULED CASTE,10.0-20.0,43,TUGGALI,4,47,47,0,47,0,0,0,0,0
ANDHRA PRADESH,KURNOOL,SCHEDULED CASTE,10.0-20.0,44,PEAPALLY,0,0,0,0,0,0,0,0,0,0
ANDHRA PRADESH,KURNOOL,SCHEDULED CASTE,10.0-20.0,45,OWK,6,80,80,0,80,0,0,0,0,0
ANDHRA PRADESH,KURNOOL,SCHEDULED CASTE,10.0-20.0,46,KOILKUNTLA,2,23,23,0,23,0,0,0,0,0
ANDHRA PRADESH,KURNOOL,SCHEDULED CASTE,10.0-20.0,47,RUDRAVARAM,1,11,5,5,10,0,0,0,0,0
ANDHRA PRADESH,KURNOOL,SCHEDULED CASTE,10.0-20.0,48,ALLAGADDA,1,11,6,6,12,0,0,0,0,0
ANDHRA PRADESH,KURNOOL,SCHEDULED CASTE,10.0-20.0,49,DORNIPADU,0,0,0,0,0,0,0,0,0,0
ANDHRA PRADESH,KURNOOL,SCHEDULED CASTE,10.0-20.0,50,SANJAMALA,0,0,0,0,0,0,0,0,0,0
ANDHRA PRADESH,KURNOOL,SCHEDULED CASTE,10.0-20.0,51,KOLIMIGUNDLA,0,0,0,0,0,0,0,0,0,0
ANDHRA PRADESH,KURNOOL,SCHEDULED CASTE,10.0-20.0,52,UYYALAWADA,0,0,0,0,0,0,0,0,0,0
ANDHRA PRADESH,KURNOOL,SCHEDULED CASTE,10.0-20.0,53,CHAGALAMARRI,0,0,0,0,0,0,0,0,0,0
ANDHRA PRADESH,KURNOOL,SCHEDULED CASTE,10.0-20.0,54,CHAGALAMARRI,0,0,0,0,0,0,0,0,0,0
ANDHRA PRADESH,KURNOOL,OTHERS,10.0-20.0,1,MANTRALAYAM,14,176,88,88,176,0,0,0,0,0
ANDHRA PRADESH,KURNOOL,OTHERS,10.0-20.0,2,KOSIGI,119,1389,698,691,1389,0,0,0,0,0
ANDHRA PRADESH,KURNOOL,OTHERS,10.0-20.0,3,KOWTHALAM,381,5048,5048,0,5048,0,0,0,0,0
ANDHRA PRADESH,KURNOOL,OTHERS,10.0-20.0,4,PEDDA KADUBUR,82,876,535,341,876,0,0,0,0,0
ANDHRA PRADESH,KURNOOL,OTHERS,10.0-20.0,5,YEMMIGANUR,80,1057,966,29,995,0,40,0,40,23
ANDHRA PRADESH,KURNOOL,OTHERS,10.0-20.0,6,NANDAVARAM,50,649,642,0,642,0,4,0,4,3
ANDHRA PRADESH,KURNOOL,OTHERS,10.0-20.0,7,C.BELAGAL,46,609,577,32,609,0,0,0,0,0
ANDHRA PRADESH,KURNOOL,OTHERS,10.0-20.0,8,GUDUR,25,301,243,59,302,0,0,0,0,0
ANDHRA PRADESH,KURNOOL,OTHERS,10.0-20.0,9,KALLUR,39,495,427,68,495,0,0,0,0,0
ANDHRA PRADESH,KURNOOL,OTHERS,10.0-20.0,10,KURNOOL,120,1633,1633,0,1633,0,0,0,0,0
ANDHRA PRADESH,KURNOOL,OTHERS,10.0-20.0,11,NANDIKOTKUR,53,641,350,266,616,10,5,3,18,8
ANDHRA PRADESH,KURNOOL,OTHERS,10.0-20.0,12,PAGIDYALA,18,213,106,106,212,0,0,0,0,0
ANDHRA PRADESH,KURNOOL,OTHERS,10.0-20.0,13,JUPADU BUNGALOW,25,310,78,170,248,0,39,0,39,22
ANDHRA PRADESH,KURNOOL,OTHERS,10.0-20.0,14,KOTHAPALLE,18,241,241,0,241,0,0,0,0,0
ANDHRA PRADESH,KURNOOL,OTHERS,10.0-20.0,15,ATMAKUR,8,93,47,47,94,0,0,0,0,0
ANDHRA PRADESH,KURNOOL,OTHERS,10.0-20.0,16,PAMULAPADU,19,233,233,0,233,0,0,0,0,0
ANDHRA PRADESH,KURNOOL,OTHERS,10.0-20.0,17,MIDTHUR,97,1237,1219,18,1237,0,0,0,0,0
ANDHRA PRADESH,KURNOOL,OTHERS,10.0-20.0,18,ORVAKAL,88,1112,728,384,1112,0,0,0,0,0
ANDHRA PRADESH,KURNOOL,OTHERS,10.0-20.0,19,KODUMUR,57,749,721,28,749,0,0,0,0,0
ANDHRA PRADESH,KURNOOL,OTHERS,10.0-20.0,20,GONEGANDLA,19,202,130,71,201,0,0,0,0,0
ANDHRA PRADESH,KURNOOL,OTHERS,10.0-20.0,21,ADONI,168,2131,2131,0,2131,0,0,0,0,0
ANDHRA PRADESH,KURNOOL,OTHERS,10.0-20.0,22,HOLAGUNDA,176,2272,973,1247,2220,0,34,0,34,19
ANDHRA PRADESH,KURNOOL,OTHERS,10.0-20.0,23,HALAHARVI,98,1216,975,241,1216,0,0,0,0,0
ANDHRA PRADESH,KURNOOL,OTHERS,10.0-20.0,24,ALUR,164,2050,1801,149,1950,0,63,0,63,36
ANDHRA PRADESH,KURNOOL,OTHERS,10.0-20.0,25,ASPARI,131,1643,1395,248,1643,0,0,0,0,0
ANDHRA PRADESH,KURNOOL,OTHERS,10.0-20.0,26,DEVANAKONDA,80,990,880,111,991,0,0,0,0,0
ANDHRA PRADESH,KURNOOL,OTHERS,10.0-20.0,27,KRISHNAGIRI,173,2242,1772,469,2241,0,0,0,0,0
ANDHRA PRADESH,KURNOOL,OTHERS,10.0-20.0,28,VELDURTHI,44,732,380,351,731,1,0,0,1,0
ANDHRA PRADESH,KURNOOL,OTHERS,10.0-20.0,29,BETHAMCHERLA,39,496,260,236,496,0,0,0,0,0
ANDHRA PRADESH,KURNOOL,OTHERS,10.0-20.0,30,PANYAM,55,689,588,94,682,0,5,0,5,3
ANDHRA PRADESH,KURNOOL,OTHERS,10.0-20.0,31,GADIVEMULA,30,353,353,0,353,0,0,0,0,0
ANDHRA PRADESH,KURNOOL,OTHERS,10.0-20.0,32,VELGODE,46,547,540,7,547,0,0,0,0,0
ANDHRA PRADESH,KURNOOL,OTHERS,10.0-20.0,33,BANDI ATMAKUR,19,242,202,25,227,2,4,5,11,4
ANDHRA PRADESH,KURNOOL,OTHERS,10.0-20.0,34,NANDYAL,47,559,559,0,559,0,0,0,0,0
ANDHRA PRADESH,KURNOOL,OTHERS,10.0-20.0,35,MAHANANDI,7,76,71,2,73,0,0,2,2,1
ANDHRA PRADESH,KURNOOL,OTHERS,10.0-20.0,36,SIRVEL,20,229,115,115,230,0,0,0,0,0
ANDHRA PRADESH,KURNOOL,OTHERS,10.0-20.0,37,GOSPADU,29,353,353,0,353,0,0,0,0,0
ANDHRA PRADESH,KURNOOL,OTHERS,10.0-20.0,38,BANAGANAPALLE,69,869,725,144,869,0,0,0,0,0
ANDHRA PRADESH,KURNOOL,OTHERS,10.0-20.0,39,DHONE,54,684,600,84,684,0,0,0,0,0
ANDHRA PRADESH,KURNOOL,OTHERS,10.0-20.0,40,PATTIKONDA,85,1056,793,263,1056,0,0,0,0,0
ANDHRA PRADESH,KURNOOL,OTHERS,10.0-20.0,41,CHIPPAGIRI,143,1849,1801,49,1850,0,0,0,0,0
ANDHRA PRADESH,KURNOOL,OTHERS,10.0-20.0,42,MADDIKERA (EAST),77,927,927,0,927,0,0,0,0,0
ANDHRA PRADESH,KURNOOL,OTHERS,10.0-20.0,43,TUGGALI,55,648,648,0,648,0,0,0,0,0
ANDHRA PRADESH,KURNOOL,OTHERS,10.0-20.0,44,PEAPALLY,44,576,546,31,577,0,0,0,0,0
ANDHRA PRADESH,KURNOOL,OTHERS,10.0-20.0,45,OWK,75,933,933,0,933,0,0,0,0,0
ANDHRA PRADESH,KURNOOL,OTHERS,10.0-20.0,46,KOILKUNTLA,72,865,865,0,865,0,0,0,0,0
ANDHRA PRADESH,KURNOOL,OTHERS,10.0-20.0,47,RUDRAVARAM,54,680,538,142,680,0,0,0,0,0
ANDHRA PRADESH,KURNOOL,OTHERS,10.0-20.0,48,ALLAGADDA,26,288,288,0,288,0,0,0,0,0
ANDHRA PRADESH,KURNOOL,OTHERS,10.0-20.0,49,DORNIPADU,33,398,199,199,398,0,0,0,0,0
ANDHRA PRADESH,KURNOOL,OTHERS,10.0-20.0,50,SANJAMALA,82,1056,1056,0,1056,0,0,0,0,0
ANDHRA PRADESH,KURNOOL,OTHERS,10.0-20.0,51,KOLIMIGUNDLA,111,1375,1375,0,1375,0,0,0,0,0
ANDHRA PRADESH,KURNOOL,OTHERS,10.0-20.0,52,UYYALAWADA,103,1316,1316,0,1316,0,0,0,0,0
ANDHRA PRADESH,KURNOOL,OTHERS,10.0-20.0,53,CHAGALAMARRI,9,99,67,31,98,0,0,0,0,0
ANDHRA PRADESH,KURNOOL,OTHERS,10.0-20.0,54,CHAGALAMARRI,9,99,67,31,98,0,0,0,0,0
ANDHRA PRADESH,KURNOOL,SCHEDULED TRIBES,10.0-20.0,1,MANTRALAYAM,0,0,0,0,0,0,0,0,0,0
ANDHRA PRADESH,KURNOOL,SCHEDULED TRIBES,10.0-20.0,2,KOSIGI,0,0,0,0,0,0,0,0,0,0
ANDHRA PRADESH,KURNOOL,SCHEDULED TRIBES,10.0-20.0,3,KOWTHALAM,1,17,8,8,16,0,0,0,0,0
ANDHRA PRADESH,KURNOOL,SCHEDULED TRIBES,10.0-20.0,4,PEDDA KADUBUR,0,0,0,0,0,0,0,0,0,0
ANDHRA PRADESH,KURNOOL,SCHEDULED TRIBES,10.0-20.0,5,YEMMIGANUR,0,0,0,0,0,0,0,0,0,0
ANDHRA PRADESH,KURNOOL,SCHEDULED TRIBES,10.0-20.0,6,NANDAVARAM,0,0,0,0,0,0,0,0,0,0
ANDHRA PRADESH,KURNOOL,SCHEDULED TRIBES,10.0-20.0,7,C.BELAGAL,0,0,0,0,0,0,0,0,0,0
ANDHRA PRADESH,KURNOOL,SCHEDULED TRIBES,10.0-20.0,8,GUDUR,0,0,0,0,0,0,0,0,0,0
ANDHRA PRADESH,KURNOOL,SCHEDULED TRIBES,10.0-20.0,9,KALLUR,0,0,0,0,0,0,0,0,0,0
ANDHRA PRADESH,KURNOOL,SCHEDULED TRIBES,10.0-20.0,10,KURNOOL,2,21,21,0,21,0,0,0,0,0
ANDHRA PRADESH,KURNOOL,SCHEDULED TRIBES,10.0-20.0,11,NANDIKOTKUR,0,0,0,0,0,0,0,0,0,0
ANDHRA PRADESH,KURNOOL,SCHEDULED TRIBES,10.0-20.0,12,PAGIDYALA,0,0,0,0,0,0,0,0,0,0
ANDHRA PRADESH,KURNOOL,SCHEDULED TRIBES,10.0-20.0,13,JUPADU BUNGALOW,0,0,0,0,0,0,0,0,0,0
ANDHRA PRADESH,KURNOOL,SCHEDULED TRIBES,10.0-20.0,14,KOTHAPALLE,1,11,5,5,10,0,0,0,0,0
ANDHRA PRADESH,KURNOOL,SCHEDULED TRIBES,10.0-20.0,15,ATMAKUR,1,10,5,5,10,0,0,0,0,0
ANDHRA PRADESH,KURNOOL,SCHEDULED TRIBES,10.0-20.0,16,PAMULAPADU,1,11,5,5,10,0,0,0,0,0
ANDHRA PRADESH,KURNOOL,SCHEDULED TRIBES,10.0-20.0,17,MIDTHUR,1,12,6,6,12,0,0,0,0,0
ANDHRA PRADESH,KURNOOL,SCHEDULED TRIBES,10.0-20.0,18,ORVAKAL,0,0,0,0,0,0,0,0,0,0
ANDHRA PRADESH,KURNOOL,SCHEDULED TRIBES,10.0-20.0,19,KODUMUR,0,0,0,0,0,0,0,0,0,0
ANDHRA PRADESH,KURNOOL,SCHEDULED TRIBES,10.0-20.0,20,GONEGANDLA,0,0,0,0,0,0,0,0,0,0
ANDHRA PRADESH,KURNOOL,SCHEDULED TRIBES,10.0-20.0,21,ADONI,0,0,0,0,0,0,0,0,0,0
ANDHRA PRADESH,KURNOOL,SCHEDULED TRIBES,10.0-20.0,22,HOLAGUNDA,0,0,0,0,0,0,0,0,0,0
ANDHRA PRADESH,KURNOOL,SCHEDULED TRIBES,10.0-20.0,23,HALAHARVI,0,0,0,0,0,0,0,0,0,0
ANDHRA PRADESH,KURNOOL,SCHEDULED TRIBES,10.0-20.0,24,ALUR,0,0,0,0,0,0,0,0,0,0
ANDHRA PRADESH,KURNOOL,SCHEDULED TRIBES,10.0-20.0,25,ASPARI,1,16,15,0,15,0,0,0,0,0
ANDHRA PRADESH,KURNOOL,SCHEDULED TRIBES,10.0-20.0,26,DEVANAKONDA,0,0,0,0,0,0,0,0,0,0
ANDHRA PRADESH,KURNOOL,SCHEDULED TRIBES,10.0-20.0,27,KRISHNAGIRI,0,0,0,0,0,0,0,0,0,0
ANDHRA PRADESH,KURNOOL,SCHEDULED TRIBES,10.0-20.0,28,VELDURTHI,0,0,0,0,0,0,0,0,0,0
ANDHRA PRADESH,KURNOOL,SCHEDULED TRIBES,10.0-20.0,29,BETHAMCHERLA,0,0,0,0,0,0,0,0,0,0
ANDHRA PRADESH,KURNOOL,SCHEDULED TRIBES,10.0-20.0,30,PANYAM,0,0,0,0,0,0,0,0,0,0
ANDHRA PRADESH,KURNOOL,SCHEDULED TRIBES,10.0-20.0,31,GADIVEMULA,0,0,0,0,0,0,0,0,0,0
ANDHRA PRADESH,KURNOOL,SCHEDULED TRIBES,10.0-20.0,32,VELGODE,0,0,0,0,0,0,0,0,0,0
ANDHRA PRADESH,KURNOOL,SCHEDULED TRIBES,10.0-20.0,33,BANDI ATMAKUR,0,0,0,0,0,0,0,0,0,0
ANDHRA PRADESH,KURNOOL,SCHEDULED TRIBES,10.0-20.0,34,NANDYAL,0,0,0,0,0,0,0,0,0,0
ANDHRA PRADESH,KURNOOL,SCHEDULED TRIBES,10.0-20.0,35,MAHANANDI,0,0,0,0,0,0,0,0,0,0
ANDHRA PRADESH,KURNOOL,SCHEDULED TRIBES,10.0-20.0,36,SIRVEL,0,0,0,0,0,0,0,0,0,0
ANDHRA PRADESH,KURNOOL,SCHEDULED TRIBES,10.0-20.0,37,GOSPADU,0,0,0,0,0,0,0,0,0,0
ANDHRA PRADESH,KURNOOL,SCHEDULED TRIBES,10.0-20.0,38,BANAGANAPALLE,1,12,6,6,12,0,0,0,0,0
ANDHRA PRADESH,KURNOOL,SCHEDULED TRIBES,10.0-20.0,39,DHONE,2,21,11,11,22,0,0,0,0,0
ANDHRA PRADESH,KURNOOL,SCHEDULED TRIBES,10.0-20.0,40,PATTIKONDA,3,31,15,15,30,0,0,0,0,0
ANDHRA PRADESH,KURNOOL,SCHEDULED TRIBES,10.0-20.0,41,CHIPPAGIRI,0,0,0,0,0,0,0,0,0,0
ANDHRA PRADESH,KURNOOL,SCHEDULED TRIBES,10.0-20.0,42,MADDIKERA (EAST),0,0,0,0,0,0,0,0,0,0
ANDHRA PRADESH,KURNOOL,SCHEDULED TRIBES,10.0-20.0,43,TUGGALI,2,22,22,0,22,0,0,0,0,0
ANDHRA PRADESH,KURNOOL,SCHEDULED TRIBES,10.0-20.0,44,PEAPALLY,0,0,0,0,0,0,0,0,0,0
ANDHRA PRADESH,KURNOOL,SCHEDULED TRIBES,10.0-20.0,45,OWK,1,15,7,7,14,0,0,0,0,0
ANDHRA PRADESH,KURNOOL,SCHEDULED TRIBES,10.0-20.0,46,KOILKUNTLA,0,0,0,0,0,0,0,0,0,0
ANDHRA PRADESH,KURNOOL,SCHEDULED TRIBES,10.0-20.0,47,RUDRAVARAM,1,11,5,5,10,0,0,0,0,0
ANDHRA PRADESH,KURNOOL,SCHEDULED TRIBES,10.0-20.0,48,ALLAGADDA,0,0,0,0,0,0,0,0,0,0
ANDHRA PRADESH,KURNOOL,SCHEDULED TRIBES,10.0-20.0,49,DORNIPADU,0,0,0,0,0,0,0,0,0,0
ANDHRA PRADESH,KURNOOL,SCHEDULED TRIBES,10.0-20.0,50,SANJAMALA,0,0,0,0,0,0,0,0,0,0
ANDHRA PRADESH,KURNOOL,SCHEDULED TRIBES,10.0-20.0,51,KOLIMIGUNDLA,0,0,0,0,0,0,0,0,0,0
ANDHRA PRADESH,KURNOOL,SCHEDULED TRIBES,10.0-20.0,52,UYYALAWADA,0,0,0,0,0,0,0,0,0,0
ANDHRA PRADESH,KURNOOL,SCHEDULED TRIBES,10.0-20.0,53,CHAGALAMARRI,0,0,0,0,0,0,0,0,0,0
ANDHRA PRADESH,KURNOOL,SCHEDULED TRIBES,10.0-20.0,54,CHAGALAMARRI,0,0,0,0,0,0,0,0,0,0
ANDHRA PRADESH,KURNOOL,ALL SOCIAL GROUPS,10.0-20.0,1,MANTRALAYAM,16,198,110,88,198,0,0,0,0,0
ANDHRA PRADESH,KURNOOL,ALL SOCIAL GROUPS,10.0-20.0,2,KOSIGI,119,1389,698,691,1389,0,0,0,0,0
ANDHRA PRADESH,KURNOOL,ALL SOCIAL GROUPS,10.0-20.0,3,KOWTHALAM,385,5103,5095,8,5103,0,0,0,0,0
ANDHRA PRADESH,KURNOOL,ALL SOCIAL GROUPS,10.0-20.0,4,PEDDA KADUBUR,85,922,558,364,922,0,0,0,0,0
ANDHRA PRADESH,KURNOOL,ALL SOCIAL GROUPS,10.0-20.0,5,YEMMIGANUR,82,1080,977,40,1017,0,40,0,40,23
ANDHRA PRADESH,KURNOOL,ALL SOCIAL GROUPS,10.0-20.0,6,NANDAVARAM,50,649,642,0,642,0,4,0,4,3
ANDHRA PRADESH,KURNOOL,ALL SOCIAL GROUPS,10.0-20.0,7,C.BELAGAL,47,622,584,39,623,0,0,0,0,0
ANDHRA PRADESH,KURNOOL,ALL SOCIAL GROUPS,10.0-20.0,8,GUDUR,25,301,243,59,302,0,0,0,0,0
ANDHRA PRADESH,KURNOOL,ALL SOCIAL GROUPS,10.0-20.0,9,KALLUR,39,495,427,68,495,0,0,0,0,0
ANDHRA PRADESH,KURNOOL,ALL SOCIAL GROUPS,10.0-20.0,10,KURNOOL,126,1702,1702,0,1702,0,0,0,0,0
ANDHRA PRADESH,KURNOOL,ALL SOCIAL GROUPS,10.0-20.0,11,NANDIKOTKUR,56,676,354,298,652,10,5,3,18,8
ANDHRA PRADESH,KURNOOL,ALL SOCIAL GROUPS,10.0-20.0,12,PAGIDYALA,18,213,106,106,212,0,0,0,0,0
ANDHRA PRADESH,KURNOOL,ALL SOCIAL GROUPS,10.0-20.0,13,JUPADU BUNGALOW,25,310,78,170,248,0,39,0,39,22
ANDHRA PRADESH,KURNOOL,ALL SOCIAL GROUPS,10.0-20.0,14,KOTHAPALLE,21,275,258,17,275,0,0,0,0,0
ANDHRA PRADESH,KURNOOL,ALL SOCIAL GROUPS,10.0-20.0,15,ATMAKUR,9,104,52,52,104,0,0,0,0,0
ANDHRA PRADESH,KURNOOL,ALL SOCIAL GROUPS,10.0-20.0,16,PAMULAPADU,20,243,238,5,243,0,0,0,0,0
ANDHRA PRADESH,KURNOOL,ALL SOCIAL GROUPS,10.0-20.0,17,MIDTHUR,98,1249,1224,24,1248,0,0,0,0,0
ANDHRA PRADESH,KURNOOL,ALL SOCIAL GROUPS,10.0-20.0,18,ORVAKAL,91,1157,740,416,1156,0,0,0,0,0
ANDHRA PRADESH,KURNOOL,ALL SOCIAL GROUPS,10.0-20.0,19,KODUMUR,57,749,721,28,749,0,0,0,0,0
ANDHRA PRADESH,KURNOOL,ALL SOCIAL GROUPS,10.0-20.0,20,GONEGANDLA,19,202,130,71,201,0,0,0,0,0
ANDHRA PRADESH,KURNOOL,ALL SOCIAL GROUPS,10.0-20.0,21,ADONI,171,2166,2148,18,2166,0,0,0,0,0
ANDHRA PRADESH,KURNOOL,ALL SOCIAL GROUPS,10.0-20.0,22,HOLAGUNDA,177,2283,979,1252,2231,0,34,0,34,19
ANDHRA PRADESH,KURNOOL,ALL SOCIAL GROUPS,10.0-20.0,23,HALAHARVI,101,1249,991,258,1249,0,0,0,0,0
ANDHRA PRADESH,KURNOOL,ALL SOCIAL GROUPS,10.0-20.0,24,ALUR,167,2090,1821,170,1991,0,63,0,63,36
ANDHRA PRADESH,KURNOOL,ALL SOCIAL GROUPS,10.0-20.0,25,ASPARI,132,1659,1410,249,1659,0,0,0,0,0
ANDHRA PRADESH,KURNOOL,ALL SOCIAL GROUPS,10.0-20.0,26,DEVANAKONDA,80,990,880,111,991,0,0,0,0,0
ANDHRA PRADESH,KURNOOL,ALL SOCIAL GROUPS,10.0-20.0,27,KRISHNAGIRI,174,2253,1778,475,2253,0,0,0,0,0
ANDHRA PRADESH,KURNOOL,ALL SOCIAL GROUPS,10.0-20.0,28,VELDURTHI,44,732,380,351,731,1,0,0,1,0
ANDHRA PRADESH,KURNOOL,ALL SOCIAL GROUPS,10.0-20.0,29,BETHAMCHERLA,39,496,260,236,496,0,0,0,0,0
ANDHRA PRADESH,KURNOOL,ALL SOCIAL GROUPS,10.0-20.0,30,PANYAM,58,742,615,120,735,0,5,0,5,3
ANDHRA PRADESH,KURNOOL,ALL SOCIAL GROUPS,10.0-20.0,31,GADIVEMULA,32,375,364,11,375,0,0,0,0,0
ANDHRA PRADESH,KURNOOL,ALL SOCIAL GROUPS,10.0-20.0,32,VELGODE,47,558,551,7,558,0,0,0,0,0
ANDHRA PRADESH,KURNOOL,ALL SOCIAL GROUPS,10.0-20.0,33,BANDI ATMAKUR,19,242,202,25,227,2,4,5,11,4
ANDHRA PRADESH,KURNOOL,ALL SOCIAL GROUPS,10.0-20.0,34,NANDYAL,47,559,559,0,559,0,0,0,0,0
ANDHRA PRADESH,KURNOOL,ALL SOCIAL GROUPS,10.0-20.0,35,MAHANANDI,9,108,87,18,105,0,0,2,2,1
ANDHRA PRADESH,KURNOOL,ALL SOCIAL GROUPS,10.0-20.0,36,SIRVEL,20,229,115,115,230,0,0,0,0,0
ANDHRA PRADESH,KURNOOL,ALL SOCIAL GROUPS,10.0-20.0,37,GOSPADU,29,353,353,0,353,0,0,0,0,0
ANDHRA PRADESH,KURNOOL,ALL SOCIAL GROUPS,10.0-20.0,38,BANAGANAPALLE,70,881,731,150,881,0,0,0,0,0
ANDHRA PRADESH,KURNOOL,ALL SOCIAL GROUPS,10.0-20.0,39,DHONE,57,719,618,101,719,0,0,0,0,0
ANDHRA PRADESH,KURNOOL,ALL SOCIAL GROUPS,10.0-20.0,40,PATTIKONDA,90,1109,820,289,1109,0,0,0,0,0
ANDHRA PRADESH,KURNOOL,ALL SOCIAL GROUPS,10.0-20.0,41,CHIPPAGIRI,143,1849,1801,49,1850,0,0,0,0,0
ANDHRA PRADESH,KURNOOL,ALL SOCIAL GROUPS,10.0-20.0,42,MADDIKERA (EAST),77,927,927,0,927,0,0,0,0,0
ANDHRA PRADESH,KURNOOL,ALL SOCIAL GROUPS,10.0-20.0,43,TUGGALI,61,716,716,0,716,0,0,0,0,0
ANDHRA PRADESH,KURNOOL,ALL SOCIAL GROUPS,10.0-20.0,44,PEAPALLY,44,576,546,31,577,0,0,0,0,0
ANDHRA PRADESH,KURNOOL,ALL SOCIAL GROUPS,10.0-20.0,45,OWK,82,1029,1021,7,1028,0,0,0,0,0
ANDHRA PRADESH,KURNOOL,ALL SOCIAL GROUPS,10.0-20.0,46,KOILKUNTLA,74,888,888,0,888,0,0,0,0,0
ANDHRA PRADESH,KURNOOL,ALL SOCIAL GROUPS,10.0-20.0,47,RUDRAVARAM,56,701,548,153,701,0,0,0,0,0
ANDHRA PRADESH,KURNOOL,ALL SOCIAL GROUPS,10.0-20.0,48,ALLAGADDA,27,299,293,6,299,0,0,0,0,0
ANDHRA PRADESH,KURNOOL,ALL SOCIAL GROUPS,10.0-20.0,49,DORNIPADU,33,398,199,199,398,0,0,0,0,0
ANDHRA PRADESH,KURNOOL,ALL SOCIAL GROUPS,10.0-20.0,50,SANJAMALA,82,1056,1056,0,1056,0,0,0,0,0
ANDHRA PRADESH,KURNOOL,ALL SOCIAL GROUPS,10.0-20.0,51,KOLIMIGUNDLA,111,1375,1375,0,1375,0,0,0,0,0
ANDHRA PRADESH,KURNOOL,ALL SOCIAL GROUPS,10.0-20.0,52,UYYALAWADA,103,1316,1316,0,1316,0,0,0,0,0
ANDHRA PRADESH,KURNOOL,ALL SOCIAL GROUPS,10.0-20.0,53,CHAGALAMARRI,9,99,67,31,98,0,0,0,0,0
ANDHRA PRADESH,KURNOOL,ALL SOCIAL GROUPS,10.0-20.0,54,CHAGALAMARRI,9,99,67,31,98,0,0,0,0,0
ANDHRA PRADESH,KURNOOL,INSTITUTIONAL,7.5-10.0,1,MANTRALAYAM,0,0,0,0,0,0,0,0,0,0
ANDHRA PRADESH,KURNOOL,INSTITUTIONAL,7.5-10.0,2,KOSIGI,0,0,0,0,0,0,0,0,0,0
ANDHRA PRADESH,KURNOOL,INSTITUTIONAL,7.5-10.0,3,KOWTHALAM,0,0,0,0,0,0,0,0,0,0
ANDHRA PRADESH,KURNOOL,INSTITUTIONAL,7.5-10.0,4,PEDDA KADUBUR,0,0,0,0,0,0,0,0,0,0
ANDHRA PRADESH,KURNOOL,INSTITUTIONAL,7.5-10.0,5,YEMMIGANUR,0,0,0,0,0,0,0,0,0,0
ANDHRA PRADESH,KURNOOL,INSTITUTIONAL,7.5-10.0,6,NANDAVARAM,0,0,0,0,0,0,0,0,0,0
ANDHRA PRADESH,KURNOOL,INSTITUTIONAL,7.5-10.0,7,C.BELAGAL,0,0,0,0,0,0,0,0,0,0
ANDHRA PRADESH,KURNOOL,INSTITUTIONAL,7.5-10.0,8,GUDUR,0,0,0,0,0,0,0,0,0,0
ANDHRA PRADESH,KURNOOL,INSTITUTIONAL,7.5-10.0,9,KALLUR,0,0,0,0,0,0,0,0,0,0
ANDHRA PRADESH,KURNOOL,INSTITUTIONAL,7.5-10.0,10,KURNOOL,0,0,0,0,0,0,0,0,0,0
ANDHRA PRADESH,KURNOOL,INSTITUTIONAL,7.5-10.0,11,NANDIKOTKUR,0,0,0,0,0,0,0,0,0,0
ANDHRA PRADESH,KURNOOL,INSTITUTIONAL,7.5-10.0,12,PAGIDYALA,0,0,0,0,0,0,0,0,0,0
ANDHRA PRADESH,KURNOOL,INSTITUTIONAL,7.5-10.0,13,JUPADU BUNGALOW,0,0,0,0,0,0,0,0,0,0
ANDHRA PRADESH,KURNOOL,INSTITUTIONAL,7.5-10.0,14,KOTHAPALLE,0,0,0,0,0,0,0,0,0,0
ANDHRA PRADESH,KURNOOL,INSTITUTIONAL,7.5-10.0,15,ATMAKUR,0,0,0,0,0,0,0,0,0,0
ANDHRA PRADESH,KURNOOL,INSTITUTIONAL,7.5-10.0,16,PAMULAPADU,0,0,0,0,0,0,0,0,0,0
ANDHRA PRADESH,KURNOOL,INSTITUTIONAL,7.5-10.0,17,MIDTHUR,0,0,0,0,0,0,0,0,0,0
ANDHRA PRADESH,KURNOOL,INSTITUTIONAL,7.5-10.0,18,ORVAKAL,3,26,15,11,26,0,0,0,0,0
ANDHRA PRADESH,KURNOOL,INSTITUTIONAL,7.5-10.0,19,KODUMUR,0,0,0,0,0,0,0,0,0,0
ANDHRA PRADESH,KURNOOL,INSTITUTIONAL,7.5-10.0,20,GONEGANDLA,0,0,0,0,0,0,0,0,0,0
ANDHRA PRADESH,KURNOOL,INSTITUTIONAL,7.5-10.0,21,ADONI,0,0,0,0,0,0,0,0,0,0
ANDHRA PRADESH,KURNOOL,INSTITUTIONAL,7.5-10.0,22,HOLAGUNDA,0,0,0,0,0,0,0,0,0,0
ANDHRA PRADESH,KURNOOL,INSTITUTIONAL,7.5-10.0,23,HALAHARVI,0,0,0,0,0,0,0,0,0,0
ANDHRA PRADESH,KURNOOL,INSTITUTIONAL,7.5-10.0,24,ALUR,0,0,0,0,0,0,0,0,0,0
ANDHRA PRADESH,KURNOOL,INSTITUTIONAL,7.5-10.0,25,ASPARI,0,0,0,0,0,0,0,0,0,0
ANDHRA PRADESH,KURNOOL,INSTITUTIONAL,7.5-10.0,26,DEVANAKONDA,0,0,0,0,0,0,0,0,0,0
ANDHRA PRADESH,KURNOOL,INSTITUTIONAL,7.5-10.0,27,KRISHNAGIRI,0,0,0,0,0,0,0,0,0,0
ANDHRA PRADESH,KURNOOL,INSTITUTIONAL,7.5-10.0,28,VELDURTHI,0,0,0,0,0,0,0,0,0,0
ANDHRA PRADESH,KURNOOL,INSTITUTIONAL,7.5-10.0,29,BETHAMCHERLA,0,0,0,0,0,0,0,0,0,0
ANDHRA PRADESH,KURNOOL,INSTITUTIONAL,7.5-10.0,30,PANYAM,2,17,17,0,17,0,0,0,0,0
ANDHRA PRADESH,KURNOOL,INSTITUTIONAL,7.5-10.0,31,GADIVEMULA,0,0,0,0,0,0,0,0,0,0
ANDHRA PRADESH,KURNOOL,INSTITUTIONAL,7.5-10.0,32,VELGODE,0,0,0,0,0,0,0,0,0,0
ANDHRA PRADESH,KURNOOL,INSTITUTIONAL,7.5-10.0,33,BANDI ATMAKUR,0,0,0,0,0,0,0,0,0,0
ANDHRA PRADESH,KURNOOL,INSTITUTIONAL,7.5-10.0,34,NANDYAL,1,10,5,5,10,0,0,0,0,0
ANDHRA PRADESH,KURNOOL,INSTITUTIONAL,7.5-10.0,35,MAHANANDI,0,0,0,0,0,0,0,0,0,0
ANDHRA PRADESH,KURNOOL,INSTITUTIONAL,7.5-10.0,36,SIRVEL,0,0,0,0,0,0,0,0,0,0
ANDHRA PRADESH,KURNOOL,INSTITUTIONAL,7.5-10.0,37,GOSPADU,0,0,0,0,0,0,0,0,0,0
ANDHRA PRADESH,KURNOOL,INSTITUTIONAL,7.5-10.0,38,BANAGANAPALLE,0,0,0,0,0,0,0,0,0,0
ANDHRA PRADESH,KURNOOL,INSTITUTIONAL,7.5-10.0,39,DHONE,0,0,0,0,0,0,0,0,0,0
ANDHRA PRADESH,KURNOOL,INSTITUTIONAL,7.5-10.0,40,PATTIKONDA,0,0,0,0,0,0,0,0,0,0
ANDHRA PRADESH,KURNOOL,INSTITUTIONAL,7.5-10.0,41,CHIPPAGIRI,0,0,0,0,0,0,0,0,0,0
ANDHRA PRADESH,KURNOOL,INSTITUTIONAL,7.5-10.0,42,MADDIKERA (EAST),0,0,0,0,0,0,0,0,0,0
ANDHRA PRADESH,KURNOOL,INSTITUTIONAL,7.5-10.0,43,TUGGALI,0,0,0,0,0,0,0,0,0,0
ANDHRA PRADESH,KURNOOL,INSTITUTIONAL,7.5-10.0,44,PEAPALLY,0,0,0,0,0,0,0,0,0,0
ANDHRA PRADESH,KURNOOL,INSTITUTIONAL,7.5-10.0,45,OWK,0,0,0,0,0,0,0,0,0,0
ANDHRA PRADESH,KURNOOL,INSTITUTIONAL,7.5-10.0,46,KOILKUNTLA,0,0,0,0,0,0,0,0,0,0
ANDHRA PRADESH,KURNOOL,INSTITUTIONAL,7.5-10.0,47,RUDRAVARAM,0,0,0,0,0,0,0,0,0,0
ANDHRA PRADESH,KURNOOL,INSTITUTIONAL,7.5-10.0,48,ALLAGADDA,0,0,0,0,0,0,0,0,0,0
ANDHRA PRADESH,KURNOOL,INSTITUTIONAL,7.5-10.0,49,DORNIPADU,0,0,0,0,0,0,0,0,0,0
ANDHRA PRADESH,KURNOOL,INSTITUTIONAL,7.5-10.0,50,SANJAMALA,0,0,0,0,0,0,0,0,0,0
ANDHRA PRADESH,KURNOOL,INSTITUTIONAL,7.5-10.0,51,KOLIMIGUNDLA,0,0,0,0,0,0,0,0,0,0
ANDHRA PRADESH,KURNOOL,INSTITUTIONAL,7.5-10.0,52,UYYALAWADA,0,0,0,0,0,0,0,0,0,0
ANDHRA PRADESH,KURNOOL,INSTITUTIONAL,7.5-10.0,53,CHAGALAMARRI,0,0,0,0,0,0,0,0,0,0
ANDHRA PRADESH,KURNOOL,INSTITUTIONAL,7.5-10.0,54,CHAGALAMARRI,0,0,0,0,0,0,0,0,0,0
ANDHRA PRADESH,KURNOOL,SCHEDULED CASTE,7.5-10.0,1,MANTRALAYAM,5,45,22,24,46,0,0,0,0,0
ANDHRA PRADESH,KURNOOL,SCHEDULED CASTE,7.5-10.0,2,KOSIGI,0,0,0,0,0,0,0,0,0,0
ANDHRA PRADESH,KURNOOL,SCHEDULED CASTE,7.5-10.0,3,KOWTHALAM,5,41,41,0,41,0,0,0,0,0
ANDHRA PRADESH,KURNOOL,SCHEDULED CASTE,7.5-10.0,4,PEDDA KADUBUR,11,91,46,46,92,0,0,0,0,0
ANDHRA PRADESH,KURNOOL,SCHEDULED CASTE,7.5-10.0,5,YEMMIGANUR,2,16,8,8,16,0,0,0,0,0
ANDHRA PRADESH,KURNOOL,SCHEDULED CASTE,7.5-10.0,6,NANDAVARAM,2,16,16,0,16,0,0,0,0,0
ANDHRA PRADESH,KURNOOL,SCHEDULED CASTE,7.5-10.0,7,C.BELAGAL,0,0,0,0,0,0,0,0,0,0
ANDHRA PRADESH,KURNOOL,SCHEDULED CASTE,7.5-10.0,8,GUDUR,0,0,0,0,0,0,0,0,0,0
ANDHRA PRADESH,KURNOOL,SCHEDULED CASTE,7.5-10.0,9,KALLUR,2,16,16,0,16,0,0,0,0,0
ANDHRA PRADESH,KURNOOL,SCHEDULED CASTE,7.5-10.0,10,KURNOOL,13,115,115,0,115,0,0,0,0,0
ANDHRA PRADESH,KURNOOL,SCHEDULED CASTE,7.5-10.0,11,NANDIKOTKUR,1,9,4,4,8,0,0,0,0,0
ANDHRA PRADESH,KURNOOL,SCHEDULED CASTE,7.5-10.0,12,PAGIDYALA,1,9,4,4,8,0,0,0,0,0
ANDHRA PRADESH,KURNOOL,SCHEDULED CASTE,7.5-10.0,13,JUPADU BUNGALOW,1,9,4,4,8,0,0,0,0,0
ANDHRA PRADESH,KURNOOL,SCHEDULED CASTE,7.5-10.0,14,KOTHAPALLE,2,19,9,9,18,0,0,0,0,0
ANDHRA PRADESH,KURNOOL,SCHEDULED CASTE,7.5-10.0,15,ATMAKUR,0,0,0,0,0,0,0,0,0,0
ANDHRA PRADESH,KURNOOL,SCHEDULED CASTE,7.5-10.0,16,PAMULAPADU,0,0,0,0,0,0,0,0,0,0
ANDHRA PRADESH,KURNOOL,SCHEDULED CASTE,7.5-10.0,17,MIDTHUR,3,27,13,13,26,0,0,0,0,0
ANDHRA PRADESH,KURNOOL,SCHEDULED CASTE,7.5-10.0,18,ORVAKAL,1,8,1,7,8,0,0,0,0,0
ANDHRA PRADESH,KURNOOL,SCHEDULED CASTE,7.5-10.0,19,KODUMUR,0,0,0,0,0,0,0,0,0,0
ANDHRA PRADESH,KURNOOL,SCHEDULED CASTE,7.5-10.0,20,GONEGANDLA,2,17,9,9,18,0,0,0,0,0
ANDHRA PRADESH,KURNOOL,SCHEDULED CASTE,7.5-10.0,21,ADONI,4,37,19,19,38,0,0,0,0,0
ANDHRA PRADESH,KURNOOL,SCHEDULED CASTE,7.5-10.0,22,HOLAGUNDA,3,24,15,9,24,0,0,0,0,0
ANDHRA PRADESH,KURNOOL,SCHEDULED CASTE,7.5-10.0,23,HALAHARVI,7,58,29,29,58,0,0,0,0,0
ANDHRA PRADESH,KURNOOL,SCHEDULED CASTE,7.5-10.0,24,ALUR,10,86,86,0,86,0,0,0,0,0
ANDHRA PRADESH,KURNOOL,SCHEDULED CASTE,7.5-10.0,25,ASPARI,1,8,8,0,8,0,0,0,0,0
ANDHRA PRADESH,KURNOOL,SCHEDULED CASTE,7.5-10.0,26,DEVANAKONDA,5,41,41,0,41,0,0,0,0,0
ANDHRA PRADESH,KURNOOL,SCHEDULED CASTE,7.5-10.0,27,KRISHNAGIRI,10,84,46,38,84,0,0,0,0,0
ANDHRA PRADESH,KURNOOL,SCHEDULED CASTE,7.5-10.0,28,VELDURTHI,0,0,0,0,0,0,0,0,0,0
ANDHRA PRADESH,KURNOOL,SCHEDULED CASTE,7.5-10.0,29,BETHAMCHERLA,0,0,0,0,0,0,0,0,0,0
ANDHRA PRADESH,KURNOOL,SCHEDULED CASTE,7.5-10.0,30,PANYAM,0,0,0,0,0,0,0,0,0,0
ANDHRA PRADESH,KURNOOL,SCHEDULED CASTE,7.5-10.0,31,GADIVEMULA,5,41,20,20,40,0,0,0,0,0
ANDHRA PRADESH,KURNOOL,SCHEDULED CASTE,7.5-10.0,32,VELGODE,0,0,0,0,0,0,0,0,0,0
ANDHRA PRADESH,KURNOOL,SCHEDULED CASTE,7.5-10.0,33,BANDI ATMAKUR,2,17,8,8,16,0,0,0,0,0
ANDHRA PRADESH,KURNOOL,SCHEDULED CASTE,7.5-10.0,34,NANDYAL,0,0,0,0,0,0,0,0,0,0
ANDHRA PRADESH,KURNOOL,SCHEDULED CASTE,7.5-10.0,35,MAHANANDI,2,18,9,9,18,0,0,0,0,0
ANDHRA PRADESH,KURNOOL,SCHEDULED CASTE,7.5-10.0,36,SIRVEL,0,0,0,0,0,0,0,0,0,0
ANDHRA PRADESH,KURNOOL,SCHEDULED CASTE,7.5-10.0,37,GOSPADU,0,0,0,0,0,0,0,0,0,0
ANDHRA PRADESH,KURNOOL,SCHEDULED CASTE,7.5-10.0,38,BANAGANAPALLE,1,10,5,5,10,0,0,0,0,0
ANDHRA PRADESH,KURNOOL,SCHEDULED CASTE,7.5-10.0,39,DHONE,5,44,22,22,44,0,0,0,0,0
ANDHRA PRADESH,KURNOOL,SCHEDULED CASTE,7.5-10.0,40,PATTIKONDA,1,10,5,5,10,0,0,0,0,0
ANDHRA PRADESH,KURNOOL,SCHEDULED CASTE,7.5-10.0,41,CHIPPAGIRI,6,47,24,24,48,0,0,0,0,0
ANDHRA PRADESH,KURNOOL,SCHEDULED CASTE,7.5-10.0,42,MADDIKERA (EAST),0,0,0,0,0,0,0,0,0,0
ANDHRA PRADESH,KURNOOL,SCHEDULED CASTE,7.5-10.0,43,TUGGALI,14,117,117,0,117,0,0,0,0,0
ANDHRA PRADESH,KURNOOL,SCHEDULED CASTE,7.5-10.0,44,PEAPALLY,1,8,4,4,8,0,0,0,0,0
ANDHRA PRADESH,KURNOOL,SCHEDULED CASTE,7.5-10.0,45,OWK,1,10,5,5,10,0,0,0,0,0
ANDHRA PRADESH,KURNOOL,SCHEDULED CASTE,7.5-10.0,46,KOILKUNTLA,1,10,10,0,10,0,0,0,0,0
ANDHRA PRADESH,KURNOOL,SCHEDULED CASTE,7.5-10.0,47,RUDRAVARAM,7,61,61,0,61,0,0,0,0,0
ANDHRA PRADESH,KURNOOL,SCHEDULED CASTE,7.5-10.0,48,ALLAGADDA,0,0,0,0,0,0,0,0,0,0
ANDHRA PRADESH,KURNOOL,SCHEDULED CASTE,7.5-10.0,49,DORNIPADU,2,18,9,9,18,0,0,0,0,0
ANDHRA PRADESH,KURNOOL,SCHEDULED CASTE,7.5-10.0,50,SANJAMALA,2,15,12,4,16,0,0,0,0,0
ANDHRA PRADESH,KURNOOL,SCHEDULED CASTE,7.5-10.0,51,KOLIMIGUNDLA,8,64,32,32,64,0,0,0,0,0
ANDHRA PRADESH,KURNOOL,SCHEDULED CASTE,7.5-10.0,52,UYYALAWADA,0,0,0,0,0,0,0,0,0,0
ANDHRA PRADESH,KURNOOL,SCHEDULED CASTE,7.5-10.0,53,CHAGALAMARRI,8,62,31,31,62,0,0,0,0,0
ANDHRA PRADESH,KURNOOL,SCHEDULED CASTE,7.5-10.0,54,CHAGALAMARRI,8,62,31,31,62,0,0,0,0,0
ANDHRA PRADESH,KURNOOL,OTHERS,7.5-10.0,1,MANTRALAYAM,49,417,266,152,418,0,0,0,0,0
ANDHRA PRADESH,KURNOOL,OTHERS,7.5-10.0,2,KOSIGI,120,1057,304,753,1057,0,0,0,0,0
ANDHRA PRADESH,KURNOOL,OTHERS,7.5-10.0,3,KOWTHALAM,210,1850,1850,0,1850,0,0,0,0,0
ANDHRA PRADESH,KURNOOL,OTHERS,7.5-10.0,4,PEDDA KADUBUR,199,1710,1593,117,1710,0,0,0,0,0
ANDHRA PRADESH,KURNOOL,OTHERS,7.5-10.0,5,YEMMIGANUR,103,878,812,0,812,12,34,0,46,20
ANDHRA PRADESH,KURNOOL,OTHERS,7.5-10.0,6,NANDAVARAM,118,998,944,0,944,0,35,0,35,20
ANDHRA PRADESH,KURNOOL,OTHERS,7.5-10.0,7,C.BELAGAL,37,312,301,11,312,0,0,0,0,0
ANDHRA PRADESH,KURNOOL,OTHERS,7.5-10.0,8,GUDUR,64,553,478,75,553,0,0,0,0,0
ANDHRA PRADESH,KURNOOL,OTHERS,7.5-10.0,9,KALLUR,80,680,680,0,680,0,0,0,0,0
ANDHRA PRADESH,KURNOOL,OTHERS,7.5-10.0,10,KURNOOL,186,1600,1593,7,1600,0,0,0,0,0
ANDHRA PRADESH,KURNOOL,OTHERS,7.5-10.0,11,NANDIKOTKUR,78,668,470,170,640,6,11,1,18,10
ANDHRA PRADESH,KURNOOL,OTHERS,7.5-10.0,12,PAGIDYALA,24,204,102,102,204,0,0,0,0,0
ANDHRA PRADESH,KURNOOL,OTHERS,7.5-10.0,13,JUPADU BUNGALOW,43,378,204,174,378,0,0,0,0,0
ANDHRA PRADESH,KURNOOL,OTHERS,7.5-10.0,14,KOTHAPALLE,31,270,238,32,270,0,0,0,0,0
ANDHRA PRADESH,KURNOOL,OTHERS,7.5-10.0,15,ATMAKUR,23,197,197,0,197,0,0,0,0,0
ANDHRA PRADESH,KURNOOL,OTHERS,7.5-10.0,16,PAMULAPADU,21,177,177,0,177,0,0,0,0,0
ANDHRA PRADESH,KURNOOL,OTHERS,7.5-10.0,17,MIDTHUR,130,1116,1074,42,1116,0,0,0,0,0
ANDHRA PRADESH,KURNOOL,OTHERS,7.5-10.0,18,ORVAKAL,128,1081,853,228,1081,0,0,0,0,0
ANDHRA PRADESH,KURNOOL,OTHERS,7.5-10.0,19,KODUMUR,104,901,885,16,901,0,0,0,0,0
ANDHRA PRADESH,KURNOOL,OTHERS,7.5-10.0,20,GONEGANDLA,65,558,510,49,559,0,0,0,0,0
ANDHRA PRADESH,KURNOOL,OTHERS,7.5-10.0,21,ADONI,244,2079,2079,0,2079,0,0,0,0,0
ANDHRA PRADESH,KURNOOL,OTHERS,7.5-10.0,22,HOLAGUNDA,219,1873,962,867,1829,0,28,0,28,16
ANDHRA PRADESH,KURNOOL,OTHERS,7.5-10.0,23,HALAHARVI,168,1420,1420,0,1420,0,0,0,0,0
ANDHRA PRADESH,KURNOOL,OTHERS,7.5-10.0,24,ALUR,289,2456,2212,184,2396,0,38,0,38,22
ANDHRA PRADESH,KURNOOL,OTHERS,7.5-10.0,25,ASPARI,243,2071,1838,233,2071,0,0,0,0,0
ANDHRA PRADESH,KURNOOL,OTHERS,7.5-10.0,26,DEVANAKONDA,184,1574,1439,135,1574,0,0,0,0,0
ANDHRA PRADESH,KURNOOL,OTHERS,7.5-10.0,27,KRISHNAGIRI,237,2030,1780,251,2031,0,0,0,0,0
ANDHRA PRADESH,KURNOOL,OTHERS,7.5-10.0,28,VELDURTHI,59,544,428,116,544,0,0,0,0,0
ANDHRA PRADESH,KURNOOL,OTHERS,7.5-10.0,29,BETHAMCHERLA,59,514,344,170,514,0,0,0,0,0
ANDHRA PRADESH,KURNOOL,OTHERS,7.5-10.0,30,PANYAM,106,895,462,288,750,0,92,0,92,52
ANDHRA PRADESH,KURNOOL,OTHERS,7.5-10.0,31,GADIVEMULA,70,597,597,0,597,0,0,0,0,0
ANDHRA PRADESH,KURNOOL,OTHERS,7.5-10.0,32,VELGODE,38,327,327,0,327,0,0,0,0,0
ANDHRA PRADESH,KURNOOL,OTHERS,7.5-10.0,33,BANDI ATMAKUR,56,471,411,54,465,0,2,2,4,2
ANDHRA PRADESH,KURNOOL,OTHERS,7.5-10.0,34,NANDYAL,66,557,541,16,557,0,0,0,0,0
ANDHRA PRADESH,KURNOOL,OTHERS,7.5-10.0,35,MAHANANDI,25,210,192,1,193,2,1,8,11,5
ANDHRA PRADESH,KURNOOL,OTHERS,7.5-10.0,36,SIRVEL,69,599,300,300,600,0,0,0,0,0
ANDHRA PRADESH,KURNOOL,OTHERS,7.5-10.0,37,GOSPADU,77,642,642,0,642,0,0,0,0,0
ANDHRA PRADESH,KURNOOL,OTHERS,7.5-10.0,38,BANAGANAPALLE,131,1109,913,196,1109,0,0,0,0,0
ANDHRA PRADESH,KURNOOL,OTHERS,7.5-10.0,39,DHONE,125,1056,1045,11,1056,0,0,0,0,0
ANDHRA PRADESH,KURNOOL,OTHERS,7.5-10.0,40,PATTIKONDA,149,1261,854,407,1261,0,0,0,0,0
ANDHRA PRADESH,KURNOOL,OTHERS,7.5-10.0,41,CHIPPAGIRI,257,2183,2183,0,2183,0,0,0,0,0
ANDHRA PRADESH,KURNOOL,OTHERS,7.5-10.0,42,MADDIKERA (EAST),127,1074,880,194,1074,0,0,0,0,0
ANDHRA PRADESH,KURNOOL,OTHERS,7.5-10.0,43,TUGGALI,184,1565,1440,125,1565,0,0,0,0,0
ANDHRA PRADESH,KURNOOL,OTHERS,7.5-10.0,44,PEAPALLY,61,518,361,156,517,0,0,0,0,0
ANDHRA PRADESH,KURNOOL,OTHERS,7.5-10.0,45,OWK,106,908,908,0,908,0,0,0,0,0
ANDHRA PRADESH,KURNOOL,OTHERS,7.5-10.0,46,KOILKUNTLA,102,884,884,0,884,0,0,0,0,0
ANDHRA PRADESH,KURNOOL,OTHERS,7.5-10.0,47,RUDRAVARAM,102,866,822,43,865,0,0,0,0,0
ANDHRA PRADESH,KURNOOL,OTHERS,7.5-10.0,48,ALLAGADDA,53,445,399,46,445,0,0,0,0,0
ANDHRA PRADESH,KURNOOL,OTHERS,7.5-10.0,49,DORNIPADU,67,576,288,288,576,0,0,0,0,0
ANDHRA PRADESH,KURNOOL,OTHERS,7.5-10.0,50,SANJAMALA,162,1384,1302,83,1385,0,0,0,0,0
ANDHRA PRADESH,KURNOOL,OTHERS,7.5-10.0,51,KOLIMIGUNDLA,135,1162,1162,0,1162,0,0,0,0,0
ANDHRA PRADESH,KURNOOL,OTHERS,7.5-10.0,52,UYYALAWADA,181,1540,1540,0,1540,0,0,0,0,0
ANDHRA PRADESH,KURNOOL,OTHERS,7.5-10.0,53,CHAGALAMARRI,33,271,133,138,271,0,0,0,0,0
ANDHRA PRADESH,KURNOOL,OTHERS,7.5-10.0,54,CHAGALAMARRI,33,271,133,138,271,0,0,0,0,0
ANDHRA PRADESH,KURNOOL,SCHEDULED TRIBES,7.5-10.0,1,MANTRALAYAM,0,0,0,0,0,0,0,0,0,0
ANDHRA PRADESH,KURNOOL,SCHEDULED TRIBES,7.5-10.0,2,KOSIGI,0,0,0,0,0,0,0,0,0,0
ANDHRA PRADESH,KURNOOL,SCHEDULED TRIBES,7.5-10.0,3,KOWTHALAM,0,0,0,0,0,0,0,0,0,0
ANDHRA PRADESH,KURNOOL,SCHEDULED TRIBES,7.5-10.0,4,PEDDA KADUBUR,0,0,0,0,0,0,0,0,0,0
ANDHRA PRADESH,KURNOOL,SCHEDULED TRIBES,7.5-10.0,5,YEMMIGANUR,0,0,0,0,0,0,0,0,0,0
ANDHRA PRADESH,KURNOOL,SCHEDULED TRIBES,7.5-10.0,6,NANDAVARAM,0,0,0,0,0,0,0,0,0,0
ANDHRA PRADESH,KURNOOL,SCHEDULED TRIBES,7.5-10.0,7,C.BELAGAL,0,0,0,0,0,0,0,0,0,0
ANDHRA PRADESH,KURNOOL,SCHEDULED TRIBES,7.5-10.0,8,GUDUR,0,0,0,0,0,0,0,0,0,0
ANDHRA PRADESH,KURNOOL,SCHEDULED TRIBES,7.5-10.0,9,KALLUR,0,0,0,0,0,0,0,0,0,0
ANDHRA PRADESH,KURNOOL,SCHEDULED TRIBES,7.5-10.0,10,KURNOOL,3,27,13,13,26,0,0,0,0,0
ANDHRA PRADESH,KURNOOL,SCHEDULED TRIBES,7.5-10.0,11,NANDIKOTKUR,0,0,0,0,0,0,0,0,0,0
ANDHRA PRADESH,KURNOOL,SCHEDULED TRIBES,7.5-10.0,12,PAGIDYALA,0,0,0,0,0,0,0,0,0,0
ANDHRA PRADESH,KURNOOL,SCHEDULED TRIBES,7.5-10.0,13,JUPADU BUNGALOW,0,0,0,0,0,0,0,0,0,0
ANDHRA PRADESH,KURNOOL,SCHEDULED TRIBES,7.5-10.0,14,KOTHAPALLE,0,0,0,0,0,0,0,0,0,0
ANDHRA PRADESH,KURNOOL,SCHEDULED TRIBES,7.5-10.0,15,ATMAKUR,0,0,0,0,0,0,0,0,0,0
ANDHRA PRADESH,KURNOOL,SCHEDULED TRIBES,7.5-10.0,16,PAMULAPADU,1,8,4,4,8,0,0,0,0,0
ANDHRA PRADESH,KURNOOL,SCHEDULED TRIBES,7.5-10.0,17,MIDTHUR,0,0,0,0,0,0,0,0,0,0
ANDHRA PRADESH,KURNOOL,SCHEDULED TRIBES,7.5-10.0,18,ORVAKAL,3,26,13,13,26,0,0,0,0,0
ANDHRA PRADESH,KURNOOL,SCHEDULED TRIBES,7.5-10.0,19,KODUMUR,0,0,0,0,0,0,0,0,0,0
ANDHRA PRADESH,KURNOOL,SCHEDULED TRIBES,7.5-10.0,20,GONEGANDLA,1,9,5,5,10,0,0,0,0,0
ANDHRA PRADESH,KURNOOL,SCHEDULED TRIBES,7.5-10.0,21,ADONI,0,0,0,0,0,0,0,0,0,0
ANDHRA PRADESH,KURNOOL,SCHEDULED TRIBES,7.5-10.0,22,HOLAGUNDA,1,8,6,2,8,0,0,0,0,0
ANDHRA PRADESH,KURNOOL,SCHEDULED TRIBES,7.5-10.0,23,HALAHARVI,0,0,0,0,0,0,0,0,0,0
ANDHRA PRADESH,KURNOOL,SCHEDULED TRIBES,7.5-10.0,24,ALUR,0,0,0,0,0,0,0,0,0,0
ANDHRA PRADESH,KURNOOL,SCHEDULED TRIBES,7.5-10.0,25,ASPARI,0,0,0,0,0,0,0,0,0,0
ANDHRA PRADESH,KURNOOL,SCHEDULED TRIBES,7.5-10.0,26,DEVANAKONDA,1,10,5,5,10,0,0,0,0,0
ANDHRA PRADESH,KURNOOL,SCHEDULED TRIBES,7.5-10.0,27,KRISHNAGIRI,2,18,9,9,18,0,0,0,0,0
ANDHRA PRADESH,KURNOOL,SCHEDULED TRIBES,7.5-10.0,28,VELDURTHI,0,0,0,0,0,0,0,0,0,0
ANDHRA PRADESH,KURNOOL,SCHEDULED TRIBES,7.5-10.0,29,BETHAMCHERLA,0,0,0,0,0,0,0,0,0,0
ANDHRA PRADESH,KURNOOL,SCHEDULED TRIBES,7.5-10.0,30,PANYAM,1,8,4,4,8,0,0,0,0,0
ANDHRA PRADESH,KURNOOL,SCHEDULED TRIBES,7.5-10.0,31,GADIVEMULA,1,10,5,5,10,0,0,0,0,0
ANDHRA PRADESH,KURNOOL,SCHEDULED TRIBES,7.5-10.0,32,VELGODE,1,9,9,0,9,0,0,0,0,0
ANDHRA PRADESH,KURNOOL,SCHEDULED TRIBES,7.5-10.0,33,BANDI ATMAKUR,1,9,4,4,8,0,0,0,0,0
ANDHRA PRADESH,KURNOOL,SCHEDULED TRIBES,7.5-10.0,34,NANDYAL,0,0,0,0,0,0,0,0,0,0
ANDHRA PRADESH,KURNOOL,SCHEDULED TRIBES,7.5-10.0,35,MAHANANDI,0,0,0,0,0,0,0,0,0,0
ANDHRA PRADESH,KURNOOL,SCHEDULED TRIBES,7.5-10.0,36,SIRVEL,0,0,0,0,0,0,0,0,0,0
ANDHRA PRADESH,KURNOOL,SCHEDULED TRIBES,7.5-10.0,37,GOSPADU,0,0,0,0,0,0,0,0,0,0
ANDHRA PRADESH,KURNOOL,SCHEDULED TRIBES,7.5-10.0,38,BANAGANAPALLE,2,17,8,8,16,0,0,0,0,0
ANDHRA PRADESH,KURNOOL,SCHEDULED TRIBES,7.5-10.0,39,DHONE,5,44,22,22,44,0,0,0,0,0
ANDHRA PRADESH,KURNOOL,SCHEDULED TRIBES,7.5-10.0,40,PATTIKONDA,9,78,39,39,78,0,0,0,0,0
ANDHRA PRADESH,KURNOOL,SCHEDULED TRIBES,7.5-10.0,41,CHIPPAGIRI,0,0,0,0,0,0,0,0,0,0
ANDHRA PRADESH,KURNOOL,SCHEDULED TRIBES,7.5-10.0,42,MADDIKERA (EAST),0,0,0,0,0,0,0,0,0,0
ANDHRA PRADESH,KURNOOL,SCHEDULED TRIBES,7.5-10.0,43,TUGGALI,21,179,160,19,179,0,0,0,0,0
ANDHRA PRADESH,KURNOOL,SCHEDULED TRIBES,7.5-10.0,44,PEAPALLY,1,9,4,4,8,0,0,0,0,0
ANDHRA PRADESH,KURNOOL,SCHEDULED TRIBES,7.5-10.0,45,OWK,2,18,9,9,18,0,0,0,0,0
ANDHRA PRADESH,KURNOOL,SCHEDULED TRIBES,7.5-10.0,46,KOILKUNTLA,0,0,0,0,0,0,0,0,0,0
ANDHRA PRADESH,KURNOOL,SCHEDULED TRIBES,7.5-10.0,47,RUDRAVARAM,0,0,0,0,0,0,0,0,0,0
ANDHRA PRADESH,KURNOOL,SCHEDULED TRIBES,7.5-10.0,48,ALLAGADDA,0,0,0,0,0,0,0,0,0,0
ANDHRA PRADESH,KURNOOL,SCHEDULED TRIBES,7.5-10.0,49,DORNIPADU,0,0,0,0,0,0,0,0,0,0
ANDHRA PRADESH,KURNOOL,SCHEDULED TRIBES,7.5-10.0,50,SANJAMALA,0,0,0,0,0,0,0,0,0,0
ANDHRA PRADESH,KURNOOL,SCHEDULED TRIBES,7.5-10.0,51,KOLIMIGUNDLA,1,8,4,4,8,0,0,0,0,0
ANDHRA PRADESH,KURNOOL,SCHEDULED TRIBES,7.5-10.0,52,UYYALAWADA,1,8,4,4,8,0,0,0,0,0
ANDHRA PRADESH,KURNOOL,SCHEDULED TRIBES,7.5-10.0,53,CHAGALAMARRI,0,0,0,0,0,0,0,0,0,0
ANDHRA PRADESH,KURNOOL,SCHEDULED TRIBES,7.5-10.0,54,CHAGALAMARRI,0,0,0,0,0,0,0,0,0,0
ANDHRA PRADESH,KURNOOL,ALL SOCIAL GROUPS,7.5-10.0,1,MANTRALAYAM,54,463,288,175,463,0,0,0,0,0
ANDHRA PRADESH,KURNOOL,ALL SOCIAL GROUPS,7.5-10.0,2,KOSIGI,120,1057,304,753,1057,0,0,0,0,0
ANDHRA PRADESH,KURNOOL,ALL SOCIAL GROUPS,7.5-10.0,3,KOWTHALAM,215,1891,1891,0,1891,0,0,0,0,0
ANDHRA PRADESH,KURNOOL,ALL SOCIAL GROUPS,7.5-10.0,4,PEDDA KADUBUR,210,1801,1639,162,1801,0,0,0,0,0
ANDHRA PRADESH,KURNOOL,ALL SOCIAL GROUPS,7.5-10.0,5,YEMMIGANUR,105,894,820,8,828,12,34,0,46,20
ANDHRA PRADESH,KURNOOL,ALL SOCIAL GROUPS,7.5-10.0,6,NANDAVARAM,120,1014,960,0,960,0,35,0,35,20
ANDHRA PRADESH,KURNOOL,ALL SOCIAL GROUPS,7.5-10.0,7,C.BELAGAL,37,312,301,11,312,0,0,0,0,0
ANDHRA PRADESH,KURNOOL,ALL SOCIAL GROUPS,7.5-10.0,8,GUDUR,64,553,478,75,553,0,0,0,0,0
ANDHRA PRADESH,KURNOOL,ALL SOCIAL GROUPS,7.5-10.0,9,KALLUR,82,696,696,0,696,0,0,0,0,0
ANDHRA PRADESH,KURNOOL,ALL SOCIAL GROUPS,7.5-10.0,10,KURNOOL,202,1742,1721,21,1742,0,0,0,0,0
ANDHRA PRADESH,KURNOOL,ALL SOCIAL GROUPS,7.5-10.0,11,NANDIKOTKUR,79,676,474,174,648,6,11,1,18,10
ANDHRA PRADESH,KURNOOL,ALL SOCIAL GROUPS,7.5-10.0,12,PAGIDYALA,25,212,106,106,212,0,0,0,0,0
ANDHRA PRADESH,KURNOOL,ALL SOCIAL GROUPS,7.5-10.0,13,JUPADU BUNGALOW,44,387,209,178,387,0,0,0,0,0
ANDHRA PRADESH,KURNOOL,ALL SOCIAL GROUPS,7.5-10.0,14,KOTHAPALLE,33,289,247,42,289,0,0,0,0,0
ANDHRA PRADESH,KURNOOL,ALL SOCIAL GROUPS,7.5-10.0,15,ATMAKUR,23,197,197,0,197,0,0,0,0,0
ANDHRA PRADESH,KURNOOL,ALL SOCIAL GROUPS,7.5-10.0,16,PAMULAPADU,22,185,181,4,185,0,0,0,0,0
ANDHRA PRADESH,KURNOOL,ALL SOCIAL GROUPS,7.5-10.0,17,MIDTHUR,133,1143,1087,56,1143,0,0,0,0,0
ANDHRA PRADESH,KURNOOL,ALL SOCIAL GROUPS,7.5-10.0,18,ORVAKAL,135,1141,882,259,1141,0,0,0,0,0
ANDHRA PRADESH,KURNOOL,ALL SOCIAL GROUPS,7.5-10.0,19,KODUMUR,104,901,885,16,901,0,0,0,0,0
ANDHRA PRADESH,KURNOOL,ALL SOCIAL GROUPS,7.5-10.0,20,GONEGANDLA,68,585,523,62,585,0,0,0,0,0
ANDHRA PRADESH,KURNOOL,ALL SOCIAL GROUPS,7.5-10.0,21,ADONI,248,2116,2097,19,2116,0,0,0,0,0
ANDHRA PRADESH,KURNOOL,ALL SOCIAL GROUPS,7.5-10.0,22,HOLAGUNDA,223,1905,983,878,1861,0,28,0,28,16
ANDHRA PRADESH,KURNOOL,ALL SOCIAL GROUPS,7.5-10.0,23,HALAHARVI,175,1478,1449,29,1478,0,0,0,0,0
ANDHRA PRADESH,KURNOOL,ALL SOCIAL GROUPS,7.5-10.0,24,ALUR,299,2541,2298,184,2482,0,38,0,38,22
ANDHRA PRADESH,KURNOOL,ALL SOCIAL GROUPS,7.5-10.0,25,ASPARI,244,2079,1846,233,2079,0,0,0,0,0
ANDHRA PRADESH,KURNOOL,ALL SOCIAL GROUPS,7.5-10.0,26,DEVANAKONDA,190,1625,1485,140,1625,0,0,0,0,0
ANDHRA PRADESH,KURNOOL,ALL SOCIAL GROUPS,7.5-10.0,27,KRISHNAGIRI,249,2132,1834,298,2132,0,0,0,0,0
ANDHRA PRADESH,KURNOOL,ALL SOCIAL GROUPS,7.5-10.0,28,VELDURTHI,59,544,428,116,544,0,0,0,0,0
ANDHRA PRADESH,KURNOOL,ALL SOCIAL GROUPS,7.5-10.0,29,BETHAMCHERLA,59,514,344,170,514,0,0,0,0,0
ANDHRA PRADESH,KURNOOL,ALL SOCIAL GROUPS,7.5-10.0,30,PANYAM,109,920,484,292,776,0,92,0,92,52
ANDHRA PRADESH,KURNOOL,ALL SOCIAL GROUPS,7.5-10.0,31,GADIVEMULA,76,648,623,25,648,0,0,0,0,0
ANDHRA PRADESH,KURNOOL,ALL SOCIAL GROUPS,7.5-10.0,32,VELGODE,39,336,336,0,336,0,0,0,0,0
ANDHRA PRADESH,KURNOOL,ALL SOCIAL GROUPS,7.5-10.0,33,BANDI ATMAKUR,59,496,424,66,490,0,2,2,4,2
ANDHRA PRADESH,KURNOOL,ALL SOCIAL GROUPS,7.5-10.0,34,NANDYAL,67,567,546,21,567,0,0,0,0,0
ANDHRA PRADESH,KURNOOL,ALL SOCIAL GROUPS,7.5-10.0,35,MAHANANDI,27,228,201,10,211,2,1,8,11,5
ANDHRA PRADESH,KURNOOL,ALL SOCIAL GROUPS,7.5-10.0,36,SIRVEL,69,599,300,300,600,0,0,0,0,0
ANDHRA PRADESH,KURNOOL,ALL SOCIAL GROUPS,7.5-10.0,37,GOSPADU,77,642,642,0,642,0,0,0,0,0
ANDHRA PRADESH,KURNOOL,ALL SOCIAL GROUPS,7.5-10.0,38,BANAGANAPALLE,134,1135,926,209,1135,0,0,0,0,0
ANDHRA PRADESH,KURNOOL,ALL SOCIAL GROUPS,7.5-10.0,39,DHONE,135,1144,1089,54,1143,0,0,0,0,0
ANDHRA PRADESH,KURNOOL,ALL SOCIAL GROUPS,7.5-10.0,40,PATTIKONDA,159,1349,898,451,1349,0,0,0,0,0
ANDHRA PRADESH,KURNOOL,ALL SOCIAL GROUPS,7.5-10.0,41,CHIPPAGIRI,263,2230,2206,24,2230,0,0,0,0,0
ANDHRA PRADESH,KURNOOL,ALL SOCIAL GROUPS,7.5-10.0,42,MADDIKERA (EAST),127,1074,880,194,1074,0,0,0,0,0
ANDHRA PRADESH,KURNOOL,ALL SOCIAL GROUPS,7.5-10.0,43,TUGGALI,219,1861,1717,144,1861,0,0,0,0,0
ANDHRA PRADESH,KURNOOL,ALL SOCIAL GROUPS,7.5-10.0,44,PEAPALLY,63,534,370,165,535,0,0,0,0,0
ANDHRA PRADESH,KURNOOL,ALL SOCIAL GROUPS,7.5-10.0,45,OWK,109,936,922,14,936,0,0,0,0,0
ANDHRA PRADESH,KURNOOL,ALL SOCIAL GROUPS,7.5-10.0,46,KOILKUNTLA,103,893,893,0,893,0,0,0,0,0
ANDHRA PRADESH,KURNOOL,ALL SOCIAL GROUPS,7.5-10.0,47,RUDRAVARAM,109,927,884,43,927,0,0,0,0,0
ANDHRA PRADESH,KURNOOL,ALL SOCIAL GROUPS,7.5-10.0,48,ALLAGADDA,53,445,399,46,445,0,0,0,0,0
ANDHRA PRADESH,KURNOOL,ALL SOCIAL GROUPS,7.5-10.0,49,DORNIPADU,69,594,297,297,594,0,0,0,0,0
ANDHRA PRADESH,KURNOOL,ALL SOCIAL GROUPS,7.5-10.0,50,SANJAMALA,164,1400,1313,86,1399,0,0,0,0,0
ANDHRA PRADESH,KURNOOL,ALL SOCIAL GROUPS,7.5-10.0,51,KOLIMIGUNDLA,144,1235,1198,36,1234,0,0,0,0,0
ANDHRA PRADESH,KURNOOL,ALL SOCIAL GROUPS,7.5-10.0,52,UYYALAWADA,182,1548,1544,4,1548,0,0,0,0,0
ANDHRA PRADESH,KURNOOL,ALL SOCIAL GROUPS,7.5-10.0,53,CHAGALAMARRI,41,333,164,169,333,0,0,0,0,0
ANDHRA PRADESH,KURNOOL,ALL SOCIAL GROUPS,7.5-10.0,54,CHAGALAMARRI,41,333,164,169,333,0,0,0,0,0
ANDHRA PRADESH,KURNOOL,INSTITUTIONAL,2.0-3.0,1,MANTRALAYAM,0,0,0,0,0,0,0,0,0,0
ANDHRA PRADESH,KURNOOL,INSTITUTIONAL,2.0-3.0,2,KOSIGI,0,0,0,0,0,0,0,0,0,0
ANDHRA PRADESH,KURNOOL,INSTITUTIONAL,2.0-3.0,3,KOWTHALAM,0,0,0,0,0,0,0,0,0,0
ANDHRA PRADESH,KURNOOL,INSTITUTIONAL,2.0-3.0,4,PEDDA KADUBUR,0,0,0,0,0,0,0,0,0,0
ANDHRA PRADESH,KURNOOL,INSTITUTIONAL,2.0-3.0,5,YEMMIGANUR,0,0,0,0,0,0,0,0,0,0
ANDHRA PRADESH,KURNOOL,INSTITUTIONAL,2.0-3.0,6,NANDAVARAM,0,0,0,0,0,0,0,0,0,0
ANDHRA PRADESH,KURNOOL,INSTITUTIONAL,2.0-3.0,7,C.BELAGAL,0,0,0,0,0,0,0,0,0,0
ANDHRA PRADESH,KURNOOL,INSTITUTIONAL,2.0-3.0,8,GUDUR,0,0,0,0,0,0,0,0,0,0
ANDHRA PRADESH,KURNOOL,INSTITUTIONAL,2.0-3.0,9,KALLUR,0,0,0,0,0,0,0,0,0,0
ANDHRA PRADESH,KURNOOL,INSTITUTIONAL,2.0-3.0,10,KURNOOL,0,0,0,0,0,0,0,0,0,0
ANDHRA PRADESH,KURNOOL,INSTITUTIONAL,2.0-3.0,11,NANDIKOTKUR,2,5,2,3,5,0,0,0,0,0
ANDHRA PRADESH,KURNOOL,INSTITUTIONAL,2.0-3.0,12,PAGIDYALA,0,0,0,0,0,0,0,0,0,0
ANDHRA PRADESH,KURNOOL,INSTITUTIONAL,2.0-3.0,13,JUPADU BUNGALOW,0,0,0,0,0,0,0,0,0,0
ANDHRA PRADESH,KURNOOL,INSTITUTIONAL,2.0-3.0,14,KOTHAPALLE,0,0,0,0,0,0,0,0,0,0
ANDHRA PRADESH,KURNOOL,INSTITUTIONAL,2.0-3.0,15,ATMAKUR,0,0,0,0,0,0,0,0,0,0
ANDHRA PRADESH,KURNOOL,INSTITUTIONAL,2.0-3.0,16,PAMULAPADU,0,0,0,0,0,0,0,0,0,0
ANDHRA PRADESH,KURNOOL,INSTITUTIONAL,2.0-3.0,17,MIDTHUR,0,0,0,0,0,0,0,0,0,0
ANDHRA PRADESH,KURNOOL,INSTITUTIONAL,2.0-3.0,18,ORVAKAL,0,0,0,0,0,0,0,0,0,0
ANDHRA PRADESH,KURNOOL,INSTITUTIONAL,2.0-3.0,19,KODUMUR,0,0,0,0,0,0,0,0,0,0
ANDHRA PRADESH,KURNOOL,INSTITUTIONAL,2.0-3.0,20,GONEGANDLA,0,0,0,0,0,0,0,0,0,0
ANDHRA PRADESH,KURNOOL,INSTITUTIONAL,2.0-3.0,21,ADONI,0,0,0,0,0,0,0,0,0,0
ANDHRA PRADESH,KURNOOL,INSTITUTIONAL,2.0-3.0,22,HOLAGUNDA,0,0,0,0,0,0,0,0,0,0
ANDHRA PRADESH,KURNOOL,INSTITUTIONAL,2.0-3.0,23,HALAHARVI,0,0,0,0,0,0,0,0,0,0
ANDHRA PRADESH,KURNOOL,INSTITUTIONAL,2.0-3.0,24,ALUR,0,0,0,0,0,0,0,0,0,0
ANDHRA PRADESH,KURNOOL,INSTITUTIONAL,2.0-3.0,25,ASPARI,0,0,0,0,0,0,0,0,0,0
ANDHRA PRADESH,KURNOOL,INSTITUTIONAL,2.0-3.0,26,DEVANAKONDA,0,0,0,0,0,0,0,0,0,0
ANDHRA PRADESH,KURNOOL,INSTITUTIONAL,2.0-3.0,27,KRISHNAGIRI,0,0,0,0,0,0,0,0,0,0
ANDHRA PRADESH,KURNOOL,INSTITUTIONAL,2.0-3.0,28,VELDURTHI,0,0,0,0,0,0,0,0,0,0
ANDHRA PRADESH,KURNOOL,INSTITUTIONAL,2.0-3.0,29,BETHAMCHERLA,0,0,0,0,0,0,0,0,0,0
ANDHRA PRADESH,KURNOOL,INSTITUTIONAL,2.0-3.0,30,PANYAM,2,5,2,2,4,0,0,0,0,0
ANDHRA PRADESH,KURNOOL,INSTITUTIONAL,2.0-3.0,31,GADIVEMULA,0,0,0,0,0,0,0,0,0,0
ANDHRA PRADESH,KURNOOL,INSTITUTIONAL,2.0-3.0,32,VELGODE,0,0,0,0,0,0,0,0,0,0
ANDHRA PRADESH,KURNOOL,INSTITUTIONAL,2.0-3.0,33,BANDI ATMAKUR,0,0,0,0,0,0,0,0,0,0
ANDHRA PRADESH,KURNOOL,INSTITUTIONAL,2.0-3.0,34,NANDYAL,0,0,0,0,0,0,0,0,0,0
ANDHRA PRADESH,KURNOOL,INSTITUTIONAL,2.0-3.0,35,MAHANANDI,0,0,0,0,0,0,0,0,0,0
ANDHRA PRADESH,KURNOOL,INSTITUTIONAL,2.0-3.0,36,SIRVEL,0,0,0,0,0,0,0,0,0,0
ANDHRA PRADESH,KURNOOL,INSTITUTIONAL,2.0-3.0,37,GOSPADU,0,0,0,0,0,0,0,0,0,0
ANDHRA PRADESH,KURNOOL,INSTITUTIONAL,2.0-3.0,38,BANAGANAPALLE,0,0,0,0,0,0,0,0,0,0
ANDHRA PRADESH,KURNOOL,INSTITUTIONAL,2.0-3.0,39,DHONE,0,0,0,0,0,0,0,0,0,0
ANDHRA PRADESH,KURNOOL,INSTITUTIONAL,2.0-3.0,40,PATTIKONDA,0,0,0,0,0,0,0,0,0,0
ANDHRA PRADESH,KURNOOL,INSTITUTIONAL,2.0-3.0,41,CHIPPAGIRI,0,0,0,0,0,0,0,0,0,0
ANDHRA PRADESH,KURNOOL,INSTITUTIONAL,2.0-3.0,42,MADDIKERA (EAST),0,0,0,0,0,0,0,0,0,0
ANDHRA PRADESH,KURNOOL,INSTITUTIONAL,2.0-3.0,43,TUGGALI,0,0,0,0,0,0,0,0,0,0
ANDHRA PRADESH,KURNOOL,INSTITUTIONAL,2.0-3.0,44,PEAPALLY,0,0,0,0,0,0,0,0,0,0
ANDHRA PRADESH,KURNOOL,INSTITUTIONAL,2.0-3.0,45,OWK,0,0,0,0,0,0,0,0,0,0
ANDHRA PRADESH,KURNOOL,INSTITUTIONAL,2.0-3.0,46,KOILKUNTLA,0,0,0,0,0,0,0,0,0,0
ANDHRA PRADESH,KURNOOL,INSTITUTIONAL,2.0-3.0,47,RUDRAVARAM,0,0,0,0,0,0,0,0,0,0
ANDHRA PRADESH,KURNOOL,INSTITUTIONAL,2.0-3.0,48,ALLAGADDA,0,0,0,0,0,0,0,0,0,0
ANDHRA PRADESH,KURNOOL,INSTITUTIONAL,2.0-3.0,49,DORNIPADU,0,0,0,0,0,0,0,0,0,0
ANDHRA PRADESH,KURNOOL,INSTITUTIONAL,2.0-3.0,50,SANJAMALA,0,0,0,0,0,0,0,0,0,0
ANDHRA PRADESH,KURNOOL,INSTITUTIONAL,2.0-3.0,51,KOLIMIGUNDLA,0,0,0,0,0,0,0,0,0,0
ANDHRA PRADESH,KURNOOL,INSTITUTIONAL,2.0-3.0,52,UYYALAWADA,0,0,0,0,0,0,0,0,0,0
ANDHRA PRADESH,KURNOOL,INSTITUTIONAL,2.0-3.0,53,CHAGALAMARRI,0,0,0,0,0,0,0,0,0,0
ANDHRA PRADESH,KURNOOL,INSTITUTIONAL,2.0-3.0,54,CHAGALAMARRI,0,0,0,0,0,0,0,0,0,0
ANDHRA PRADESH,KURNOOL,SCHEDULED CASTE,2.0-3.0,1,MANTRALAYAM,87,215,215,0,215,0,0,0,0,0
ANDHRA PRADESH,KURNOOL,SCHEDULED CASTE,2.0-3.0,2,KOSIGI,62,140,70,70,140,0,0,0,0,0
ANDHRA PRADESH,KURNOOL,SCHEDULED CASTE,2.0-3.0,3,KOWTHALAM,228,536,536,0,536,0,0,0,0,0
ANDHRA PRADESH,KURNOOL,SCHEDULED CASTE,2.0-3.0,4,PEDDA KADUBUR,126,303,288,15,303,0,0,0,0,0
ANDHRA PRADESH,KURNOOL,SCHEDULED CASTE,2.0-3.0,5,YEMMIGANUR,142,333,333,0,333,0,0,0,0,0
ANDHRA PRADESH,KURNOOL,SCHEDULED CASTE,2.0-3.0,6,NANDAVARAM,149,357,306,0,306,1,50,0,51,1
ANDHRA PRADESH,KURNOOL,SCHEDULED CASTE,2.0-3.0,7,C.BELAGAL,71,164,164,0,164,0,0,0,0,0
ANDHRA PRADESH,KURNOOL,SCHEDULED CASTE,2.0-3.0,8,GUDUR,57,140,125,14,139,0,0,0,0,0
ANDHRA PRADESH,KURNOOL,SCHEDULED CASTE,2.0-3.0,9,KALLUR,149,362,351,11,362,0,0,0,0,0
ANDHRA PRADESH,KURNOOL,SCHEDULED CASTE,2.0-3.0,10,KURNOOL,93,223,218,5,223,0,0,0,0,0
ANDHRA PRADESH,KURNOOL,SCHEDULED CASTE,2.0-3.0,11,NANDIKOTKUR,67,159,131,28,159,0,0,0,0,0
ANDHRA PRADESH,KURNOOL,SCHEDULED CASTE,2.0-3.0,12,PAGIDYALA,29,69,34,34,68,0,0,0,0,0
ANDHRA PRADESH,KURNOOL,SCHEDULED CASTE,2.0-3.0,13,JUPADU BUNGALOW,134,297,295,2,297,0,0,0,0,0
ANDHRA PRADESH,KURNOOL,SCHEDULED CASTE,2.0-3.0,14,KOTHAPALLE,150,348,262,86,348,0,0,0,0,0
ANDHRA PRADESH,KURNOOL,SCHEDULED CASTE,2.0-3.0,15,ATMAKUR,52,125,125,0,125,0,0,0,0,0
ANDHRA PRADESH,KURNOOL,SCHEDULED CASTE,2.0-3.0,16,PAMULAPADU,76,165,165,0,165,0,0,0,0,0
ANDHRA PRADESH,KURNOOL,SCHEDULED CASTE,2.0-3.0,17,MIDTHUR,306,676,663,13,676,0,0,0,0,0
ANDHRA PRADESH,KURNOOL,SCHEDULED CASTE,2.0-3.0,18,ORVAKAL,132,299,204,96,300,0,0,0,0,0
ANDHRA PRADESH,KURNOOL,SCHEDULED CASTE,2.0-3.0,19,KODUMUR,60,142,142,0,142,0,0,0,0,0
ANDHRA PRADESH,KURNOOL,SCHEDULED CASTE,2.0-3.0,20,GONEGANDLA,82,194,116,78,194,0,0,0,0,0
ANDHRA PRADESH,KURNOOL,SCHEDULED CASTE,2.0-3.0,21,ADONI,190,457,441,16,457,0,0,0,0,0
ANDHRA PRADESH,KURNOOL,SCHEDULED CASTE,2.0-3.0,22,HOLAGUNDA,97,229,140,89,229,0,0,0,0,0
ANDHRA PRADESH,KURNOOL,SCHEDULED CASTE,2.0-3.0,23,HALAHARVI,79,192,96,96,192,0,0,0,0,0
ANDHRA PRADESH,KURNOOL,SCHEDULED CASTE,2.0-3.0,24,ALUR,280,662,659,3,662,0,0,0,0,0
ANDHRA PRADESH,KURNOOL,SCHEDULED CASTE,2.0-3.0,25,ASPARI,83,195,189,6,195,0,0,0,0,0
ANDHRA PRADESH,KURNOOL,SCHEDULED CASTE,2.0-3.0,26,DEVANAKONDA,342,781,771,10,781,0,0,0,0,0
ANDHRA PRADESH,KURNOOL,SCHEDULED CASTE,2.0-3.0,27,KRISHNAGIRI,246,564,564,0,564,0,0,0,0,0
ANDHRA PRADESH,KURNOOL,SCHEDULED CASTE,2.0-3.0,28,VELDURTHI,138,337,266,71,337,0,0,0,0,0
ANDHRA PRADESH,KURNOOL,SCHEDULED CASTE,2.0-3.0,29,BETHAMCHERLA,100,230,230,0,230,0,0,0,0,0
ANDHRA PRADESH,KURNOOL,SCHEDULED CASTE,2.0-3.0,30,PANYAM,47,111,53,58,111,0,0,0,0,0
ANDHRA PRADESH,KURNOOL,SCHEDULED CASTE,2.0-3.0,31,GADIVEMULA,157,363,239,62,301,0,63,0,63,0
ANDHRA PRADESH,KURNOOL,SCHEDULED CASTE,2.0-3.0,32,VELGODE,36,81,81,0,81,0,0,0,0,0
ANDHRA PRADESH,KURNOOL,SCHEDULED CASTE,2.0-3.0,33,BANDI ATMAKUR,39,94,92,0,92,0,0,1,1,1
ANDHRA PRADESH,KURNOOL,SCHEDULED CASTE,2.0-3.0,34,NANDYAL,43,100,100,0,100,0,0,0,0,0
ANDHRA PRADESH,KURNOOL,SCHEDULED CASTE,2.0-3.0,35,MAHANANDI,26,61,61,0,61,0,0,0,0,0
ANDHRA PRADESH,KURNOOL,SCHEDULED CASTE,2.0-3.0,36,SIRVEL,55,129,129,0,129,0,0,0,0,0
ANDHRA PRADESH,KURNOOL,SCHEDULED CASTE,2.0-3.0,37,GOSPADU,33,82,82,0,82,0,0,0,0,0
ANDHRA PRADESH,KURNOOL,SCHEDULED CASTE,2.0-3.0,38,BANAGANAPALLE,100,231,175,57,232,0,0,0,0,0
ANDHRA PRADESH,KURNOOL,SCHEDULED CASTE,2.0-3.0,39,DHONE,200,456,447,10,457,0,0,0,0,0
ANDHRA PRADESH,KURNOOL,SCHEDULED CASTE,2.0-3.0,40,PATTIKONDA,175,417,385,32,417,0,0,0,0,0
ANDHRA PRADESH,KURNOOL,SCHEDULED CASTE,2.0-3.0,41,CHIPPAGIRI,129,306,306,0,306,0,0,0,0,0
ANDHRA PRADESH,KURNOOL,SCHEDULED CASTE,2.0-3.0,42,MADDIKERA (EAST),85,194,187,8,195,0,0,0,0,0
ANDHRA PRADESH,KURNOOL,SCHEDULED CASTE,2.0-3.0,43,TUGGALI,235,550,550,0,550,0,0,0,0,0
ANDHRA PRADESH,KURNOOL,SCHEDULED CASTE,2.0-3.0,44,PEAPALLY,153,352,330,22,352,0,0,0,0,0
ANDHRA PRADESH,KURNOOL,SCHEDULED CASTE,2.0-3.0,45,OWK,121,286,240,46,286,0,0,0,0,0
ANDHRA PRADESH,KURNOOL,SCHEDULED CASTE,2.0-3.0,46,KOILKUNTLA,67,159,159,0,159,0,0,0,0,0
ANDHRA PRADESH,KURNOOL,SCHEDULED CASTE,2.0-3.0,47,RUDRAVARAM,162,378,356,22,378,0,0,0,0,0
ANDHRA PRADESH,KURNOOL,SCHEDULED CASTE,2.0-3.0,48,ALLAGADDA,66,153,100,54,154,0,0,0,0,0
ANDHRA PRADESH,KURNOOL,SCHEDULED CASTE,2.0-3.0,49,DORNIPADU,30,75,38,37,75,0,0,0,0,0
ANDHRA PRADESH,KURNOOL,SCHEDULED CASTE,2.0-3.0,50,SANJAMALA,81,188,188,0,188,0,0,0,0,0
ANDHRA PRADESH,KURNOOL,SCHEDULED CASTE,2.0-3.0,51,KOLIMIGUNDLA,103,247,247,0,247,0,0,0,0,0
ANDHRA PRADESH,KURNOOL,SCHEDULED CASTE,2.0-3.0,52,UYYALAWADA,60,145,145,0,145,0,0,0,0,0
ANDHRA PRADESH,KURNOOL,SCHEDULED CASTE,2.0-3.0,53,CHAGALAMARRI,137,319,178,141,319,0,0,0,0,0
ANDHRA PRADESH,KURNOOL,SCHEDULED CASTE,2.0-3.0,54,CHAGALAMARRI,137,319,178,141,319,0,0,0,0,0
ANDHRA PRADESH,KURNOOL,OTHERS,2.0-3.0,1,MANTRALAYAM,1058,2555,2456,98,2554,0,0,0,0,0
ANDHRA PRADESH,KURNOOL,OTHERS,2.0-3.0,2,KOSIGI,1064,2539,2425,115,2540,0,0,0,0,0
ANDHRA PRADESH,KURNOOL,OTHERS,2.0-3.0,3,KOWTHALAM,1919,4624,4624,0,4624,0,0,0,0,0
ANDHRA PRADESH,KURNOOL,OTHERS,2.0-3.0,4,PEDDA KADUBUR,944,2253,2081,172,2253,0,0,0,0,0
ANDHRA PRADESH,KURNOOL,OTHERS,2.0-3.0,5,YEMMIGANUR,1560,3758,3611,54,3665,4,55,0,59,34
ANDHRA PRADESH,KURNOOL,OTHERS,2.0-3.0,6,NANDAVARAM,1725,4170,4083,16,4099,7,38,0,45,26
ANDHRA PRADESH,KURNOOL,OTHERS,2.0-3.0,7,C.BELAGAL,858,2041,1997,44,2041,0,0,0,0,0
ANDHRA PRADESH,KURNOOL,OTHERS,2.0-3.0,8,GUDUR,874,2110,1956,154,2110,0,0,0,0,0
ANDHRA PRADESH,KURNOOL,OTHERS,2.0-3.0,9,KALLUR,1459,3507,3405,102,3507,0,0,0,0,0
ANDHRA PRADESH,KURNOOL,OTHERS,2.0-3.0,10,KURNOOL,1173,2824,2789,35,2824,0,0,0,0,0
ANDHRA PRADESH,KURNOOL,OTHERS,2.0-3.0,11,NANDIKOTKUR,722,1716,1532,161,1693,9,5,0,14,8
ANDHRA PRADESH,KURNOOL,OTHERS,2.0-3.0,12,PAGIDYALA,297,698,439,254,693,0,3,0,3,2
ANDHRA PRADESH,KURNOOL,OTHERS,2.0-3.0,13,JUPADU BUNGALOW,1046,2426,2273,149,2422,0,3,0,3,2
ANDHRA PRADESH,KURNOOL,OTHERS,2.0-3.0,14,KOTHAPALLE,660,1567,1361,206,1567,0,0,0,0,0
ANDHRA PRADESH,KURNOOL,OTHERS,2.0-3.0,15,ATMAKUR,651,1553,1553,0,1553,0,0,0,0,0
ANDHRA PRADESH,KURNOOL,OTHERS,2.0-3.0,16,PAMULAPADU,595,1379,1270,109,1379,0,0,0,0,0
ANDHRA PRADESH,KURNOOL,OTHERS,2.0-3.0,17,MIDTHUR,1626,3830,3813,17,3830,0,0,0,0,0
ANDHRA PRADESH,KURNOOL,OTHERS,2.0-3.0,18,ORVAKAL,1549,3656,3128,529,3657,0,0,0,0,0
ANDHRA PRADESH,KURNOOL,OTHERS,2.0-3.0,19,KODUMUR,1286,3050,3010,39,3049,0,0,0,0,0
ANDHRA PRADESH,KURNOOL,OTHERS,2.0-3.0,20,GONEGANDLA,1785,4252,3584,668,4252,0,0,0,0,0
ANDHRA PRADESH,KURNOOL,OTHERS,2.0-3.0,21,ADONI,2609,6286,6060,225,6285,0,0,0,0,0
ANDHRA PRADESH,KURNOOL,OTHERS,2.0-3.0,22,HOLAGUNDA,1543,3743,2700,1039,3739,0,3,0,3,2
ANDHRA PRADESH,KURNOOL,OTHERS,2.0-3.0,23,HALAHARVI,1499,3600,3600,0,3600,0,0,0,0,0
ANDHRA PRADESH,KURNOOL,OTHERS,2.0-3.0,24,ALUR,2020,4864,4697,143,4840,0,15,0,15,8
ANDHRA PRADESH,KURNOOL,OTHERS,2.0-3.0,25,ASPARI,2347,5631,4547,1083,5630,0,0,0,0,0
ANDHRA PRADESH,KURNOOL,OTHERS,2.0-3.0,26,DEVANAKONDA,2800,6535,6411,125,6536,0,0,0,0,0
ANDHRA PRADESH,KURNOOL,OTHERS,2.0-3.0,27,KRISHNAGIRI,2334,5452,5152,300,5452,0,0,0,0,0
ANDHRA PRADESH,KURNOOL,OTHERS,2.0-3.0,28,VELDURTHI,1611,4007,3307,700,4007,0,0,0,0,0
ANDHRA PRADESH,KURNOOL,OTHERS,2.0-3.0,29,BETHAMCHERLA,1352,3276,3211,65,3276,0,0,0,0,0
ANDHRA PRADESH,KURNOOL,OTHERS,2.0-3.0,30,PANYAM,968,2334,1689,640,2329,0,4,0,4,2
ANDHRA PRADESH,KURNOOL,OTHERS,2.0-3.0,31,GADIVEMULA,1016,2442,2324,47,2371,0,46,0,46,26
ANDHRA PRADESH,KURNOOL,OTHERS,2.0-3.0,32,VELGODE,570,1357,1357,0,1357,0,0,0,0,0
ANDHRA PRADESH,KURNOOL,OTHERS,2.0-3.0,33,BANDI ATMAKUR,890,2148,2101,45,2146,0,1,0,1,1
ANDHRA PRADESH,KURNOOL,OTHERS,2.0-3.0,34,NANDYAL,1011,2453,2443,10,2453,0,0,0,0,0
ANDHRA PRADESH,KURNOOL,OTHERS,2.0-3.0,35,MAHANANDI,549,1296,1253,8,1261,4,0,19,23,12
ANDHRA PRADESH,KURNOOL,OTHERS,2.0-3.0,36,SIRVEL,1029,2477,2476,1,2477,0,0,0,0,0
ANDHRA PRADESH,KURNOOL,OTHERS,2.0-3.0,37,GOSPADU,796,1922,1922,0,1922,0,0,0,0,0
ANDHRA PRADESH,KURNOOL,OTHERS,2.0-3.0,38,BANAGANAPALLE,2165,5160,3809,1351,5160,0,0,0,0,0
ANDHRA PRADESH,KURNOOL,OTHERS,2.0-3.0,39,DHONE,2286,5385,5184,201,5385,0,0,0,0,0
ANDHRA PRADESH,KURNOOL,OTHERS,2.0-3.0,40,PATTIKONDA,1712,4119,3840,279,4119,0,0,0,0,0
ANDHRA PRADESH,KURNOOL,OTHERS,2.0-3.0,41,CHIPPAGIRI,1902,4559,4546,13,4559,0,0,0,0,0
ANDHRA PRADESH,KURNOOL,OTHERS,2.0-3.0,42,MADDIKERA (EAST),1816,4332,4284,49,4333,0,0,0,0,0
ANDHRA PRADESH,KURNOOL,OTHERS,2.0-3.0,43,TUGGALI,2132,5069,5069,0,5069,0,0,0,0,0
ANDHRA PRADESH,KURNOOL,OTHERS,2.0-3.0,44,PEAPALLY,2287,5400,4940,461,5401,0,0,0,0,0
ANDHRA PRADESH,KURNOOL,OTHERS,2.0-3.0,45,OWK,1094,2632,2423,208,2631,0,0,0,0,0
ANDHRA PRADESH,KURNOOL,OTHERS,2.0-3.0,46,KOILKUNTLA,1152,2776,2765,12,2777,0,0,0,0,0
ANDHRA PRADESH,KURNOOL,OTHERS,2.0-3.0,47,RUDRAVARAM,1425,3429,3403,26,3429,0,0,0,0,0
ANDHRA PRADESH,KURNOOL,OTHERS,2.0-3.0,48,ALLAGADDA,1174,2819,1378,1441,2819,0,0,0,0,0
ANDHRA PRADESH,KURNOOL,OTHERS,2.0-3.0,49,DORNIPADU,716,1731,1731,0,1731,0,0,0,0,0
ANDHRA PRADESH,KURNOOL,OTHERS,2.0-3.0,50,SANJAMALA,1445,3477,3477,0,3477,0,0,0,0,0
ANDHRA PRADESH,KURNOOL,OTHERS,2.0-3.0,51,KOLIMIGUNDLA,913,2197,2197,0,2197,0,0,0,0,0
ANDHRA PRADESH,KURNOOL,OTHERS,2.0-3.0,52,UYYALAWADA,1102,2668,2668,0,2668,0,0,0,0,0
ANDHRA PRADESH,KURNOOL,OTHERS,2.0-3.0,53,CHAGALAMARRI,906,2145,1189,956,2145,0,0,0,0,0
ANDHRA PRADESH,KURNOOL,OTHERS,2.0-3.0,54,CHAGALAMARRI,906,2145,1189,956,2145,0,0,0,0,0
ANDHRA PRADESH,KURNOOL,SCHEDULED TRIBES,2.0-3.0,1,MANTRALAYAM,4,9,5,5,10,0,0,0,0,0
ANDHRA PRADESH,KURNOOL,SCHEDULED TRIBES,2.0-3.0,2,KOSIGI,6,14,7,7,14,0,0,0,0,0
ANDHRA PRADESH,KURNOOL,SCHEDULED TRIBES,2.0-3.0,3,KOWTHALAM,41,95,95,0,95,0,0,0,0,0
ANDHRA PRADESH,KURNOOL,SCHEDULED TRIBES,2.0-3.0,4,PEDDA KADUBUR,2,5,3,3,6,0,0,0,0,0
ANDHRA PRADESH,KURNOOL,SCHEDULED TRIBES,2.0-3.0,5,YEMMIGANUR,0,0,0,0,0,0,0,0,0,0
ANDHRA PRADESH,KURNOOL,SCHEDULED TRIBES,2.0-3.0,6,NANDAVARAM,3,8,4,4,8,0,0,0,0,0
ANDHRA PRADESH,KURNOOL,SCHEDULED TRIBES,2.0-3.0,7,C.BELAGAL,2,5,2,2,4,0,0,0,0,0
ANDHRA PRADESH,KURNOOL,SCHEDULED TRIBES,2.0-3.0,8,GUDUR,0,0,0,0,0,0,0,0,0,0
ANDHRA PRADESH,KURNOOL,SCHEDULED TRIBES,2.0-3.0,9,KALLUR,34,84,80,4,84,0,0,0,0,0
ANDHRA PRADESH,KURNOOL,SCHEDULED TRIBES,2.0-3.0,10,KURNOOL,10,22,22,0,22,0,0,0,0,0
ANDHRA PRADESH,KURNOOL,SCHEDULED TRIBES,2.0-3.0,11,NANDIKOTKUR,6,15,15,0,15,0,0,0,0,0
ANDHRA PRADESH,KURNOOL,SCHEDULED TRIBES,2.0-3.0,12,PAGIDYALA,0,0,0,0,0,0,0,0,0,0
ANDHRA PRADESH,KURNOOL,SCHEDULED TRIBES,2.0-3.0,13,JUPADU BUNGALOW,10,22,22,0,22,0,0,0,0,0
ANDHRA PRADESH,KURNOOL,SCHEDULED TRIBES,2.0-3.0,14,KOTHAPALLE,18,43,21,21,42,0,0,0,0,0
ANDHRA PRADESH,KURNOOL,SCHEDULED TRIBES,2.0-3.0,15,ATMAKUR,15,36,36,0,36,0,0,0,0,0
ANDHRA PRADESH,KURNOOL,SCHEDULED TRIBES,2.0-3.0,16,PAMULAPADU,13,29,29,0,29,0,0,0,0,0
ANDHRA PRADESH,KURNOOL,SCHEDULED TRIBES,2.0-3.0,17,MIDTHUR,0,0,0,0,0,0,0,0,0,0
ANDHRA PRADESH,KURNOOL,SCHEDULED TRIBES,2.0-3.0,18,ORVAKAL,85,182,50,132,182,0,0,0,0,0
ANDHRA PRADESH,KURNOOL,SCHEDULED TRIBES,2.0-3.0,19,KODUMUR,1,2,1,1,2,0,0,0,0,0
ANDHRA PRADESH,KURNOOL,SCHEDULED TRIBES,2.0-3.0,20,GONEGANDLA,8,20,10,10,20,0,0,0,0,0
ANDHRA PRADESH,KURNOOL,SCHEDULED TRIBES,2.0-3.0,21,ADONI,4,10,10,0,10,0,0,0,0,0
ANDHRA PRADESH,KURNOOL,SCHEDULED TRIBES,2.0-3.0,22,HOLAGUNDA,16,36,26,10,36,0,0,0,0,0
ANDHRA PRADESH,KURNOOL,SCHEDULED TRIBES,2.0-3.0,23,HALAHARVI,2,4,2,2,4,0,0,0,0,0
ANDHRA PRADESH,KURNOOL,SCHEDULED TRIBES,2.0-3.0,24,ALUR,28,65,65,0,65,0,0,0,0,0
ANDHRA PRADESH,KURNOOL,SCHEDULED TRIBES,2.0-3.0,25,ASPARI,16,37,19,19,38,0,0,0,0,0
ANDHRA PRADESH,KURNOOL,SCHEDULED TRIBES,2.0-3.0,26,DEVANAKONDA,13,30,30,0,30,0,0,0,0,0
ANDHRA PRADESH,KURNOOL,SCHEDULED TRIBES,2.0-3.0,27,KRISHNAGIRI,48,112,108,3,111,0,0,0,0,0
ANDHRA PRADESH,KURNOOL,SCHEDULED TRIBES,2.0-3.0,28,VELDURTHI,13,32,16,16,32,0,0,0,0,0
ANDHRA PRADESH,KURNOOL,SCHEDULED TRIBES,2.0-3.0,29,BETHAMCHERLA,49,111,96,15,111,0,0,0,0,0
ANDHRA PRADESH,KURNOOL,SCHEDULED TRIBES,2.0-3.0,30,PANYAM,5,13,6,6,12,0,0,0,0,0
ANDHRA PRADESH,KURNOOL,SCHEDULED TRIBES,2.0-3.0,31,GADIVEMULA,62,147,147,0,147,0,0,0,0,0
ANDHRA PRADESH,KURNOOL,SCHEDULED TRIBES,2.0-3.0,32,VELGODE,6,14,14,0,14,0,0,0,0,0
ANDHRA PRADESH,KURNOOL,SCHEDULED TRIBES,2.0-3.0,33,BANDI ATMAKUR,9,20,10,10,20,0,0,0,0,0
ANDHRA PRADESH,KURNOOL,SCHEDULED TRIBES,2.0-3.0,34,NANDYAL,0,0,0,0,0,0,0,0,0,0
ANDHRA PRADESH,KURNOOL,SCHEDULED TRIBES,2.0-3.0,35,MAHANANDI,1,2,1,1,2,0,0,0,0,0
ANDHRA PRADESH,KURNOOL,SCHEDULED TRIBES,2.0-3.0,36,SIRVEL,8,19,10,10,20,0,0,0,0,0
ANDHRA PRADESH,KURNOOL,SCHEDULED TRIBES,2.0-3.0,37,GOSPADU,1,2,1,1,2,0,0,0,0,0
ANDHRA PRADESH,KURNOOL,SCHEDULED TRIBES,2.0-3.0,38,BANAGANAPALLE,95,221,104,117,221,0,0,0,0,0
ANDHRA PRADESH,KURNOOL,SCHEDULED TRIBES,2.0-3.0,39,DHONE,161,379,355,23,378,0,0,0,0,0
ANDHRA PRADESH,KURNOOL,SCHEDULED TRIBES,2.0-3.0,40,PATTIKONDA,121,283,283,0,283,0,0,0,0,0
ANDHRA PRADESH,KURNOOL,SCHEDULED TRIBES,2.0-3.0,41,CHIPPAGIRI,4,10,5,5,10,0,0,0,0,0
ANDHRA PRADESH,KURNOOL,SCHEDULED TRIBES,2.0-3.0,42,MADDIKERA (EAST),24,56,56,0,56,0,0,0,0,0
ANDHRA PRADESH,KURNOOL,SCHEDULED TRIBES,2.0-3.0,43,TUGGALI,119,286,286,0,286,0,0,0,0,0
ANDHRA PRADESH,KURNOOL,SCHEDULED TRIBES,2.0-3.0,44,PEAPALLY,65,143,137,6,143,0,0,0,0,0
ANDHRA PRADESH,KURNOOL,SCHEDULED TRIBES,2.0-3.0,45,OWK,72,170,170,0,170,0,0,0,0,0
ANDHRA PRADESH,KURNOOL,SCHEDULED TRIBES,2.0-3.0,46,KOILKUNTLA,8,19,10,10,20,0,0,0,0,0
ANDHRA PRADESH,KURNOOL,SCHEDULED TRIBES,2.0-3.0,47,RUDRAVARAM,16,38,38,0,38,0,0,0,0,0
ANDHRA PRADESH,KURNOOL,SCHEDULED TRIBES,2.0-3.0,48,ALLAGADDA,19,45,14,31,45,0,0,0,0,0
ANDHRA PRADESH,KURNOOL,SCHEDULED TRIBES,2.0-3.0,49,DORNIPADU,2,5,2,2,4,0,0,0,0,0
ANDHRA PRADESH,KURNOOL,SCHEDULED TRIBES,2.0-3.0,50,SANJAMALA,8,18,9,9,18,0,0,0,0,0
ANDHRA PRADESH,KURNOOL,SCHEDULED TRIBES,2.0-3.0,51,KOLIMIGUNDLA,12,28,14,14,28,0,0,0,0,0
ANDHRA PRADESH,KURNOOL,SCHEDULED TRIBES,2.0-3.0,52,UYYALAWADA,3,7,4,4,8,0,0,0,0,0
ANDHRA PRADESH,KURNOOL,SCHEDULED TRIBES,2.0-3.0,53,CHAGALAMARRI,52,119,101,18,119,0,0,0,0,0
ANDHRA PRADESH,KURNOOL,SCHEDULED TRIBES,2.0-3.0,54,CHAGALAMARRI,52,119,101,18,119,0,0,0,0,0
ANDHRA PRADESH,KURNOOL,ALL SOCIAL GROUPS,2.0-3.0,1,MANTRALAYAM,1149,2778,2675,103,2778,0,0,0,0,0
ANDHRA PRADESH,KURNOOL,ALL SOCIAL GROUPS,2.0-3.0,2,KOSIGI,1132,2694,2502,192,2694,0,0,0,0,0
ANDHRA PRADESH,KURNOOL,ALL SOCIAL GROUPS,2.0-3.0,3,KOWTHALAM,2188,5255,5255,0,5255,0,0,0,0,0
ANDHRA PRADESH,KURNOOL,ALL SOCIAL GROUPS,2.0-3.0,4,PEDDA KADUBUR,1072,2561,2372,189,2561,0,0,0,0,0
ANDHRA PRADESH,KURNOOL,ALL SOCIAL GROUPS,2.0-3.0,5,YEMMIGANUR,1702,4091,3944,54,3998,4,55,0,59,34
ANDHRA PRADESH,KURNOOL,ALL SOCIAL GROUPS,2.0-3.0,6,NANDAVARAM,1877,4535,4393,20,4413,8,88,0,96,26
ANDHRA PRADESH,KURNOOL,ALL SOCIAL GROUPS,2.0-3.0,7,C.BELAGAL,931,2210,2163,47,2210,0,0,0,0,0
ANDHRA PRADESH,KURNOOL,ALL SOCIAL GROUPS,2.0-3.0,8,GUDUR,931,2249,2081,168,2249,0,0,0,0,0
ANDHRA PRADESH,KURNOOL,ALL SOCIAL GROUPS,2.0-3.0,9,KALLUR,1642,3954,3837,117,3954,0,0,0,0,0
ANDHRA PRADESH,KURNOOL,ALL SOCIAL GROUPS,2.0-3.0,10,KURNOOL,1276,3068,3029,39,3068,0,0,0,0,0
ANDHRA PRADESH,KURNOOL,ALL SOCIAL GROUPS,2.0-3.0,11,NANDIKOTKUR,797,1895,1678,193,1871,10,5,0,15,8
ANDHRA PRADESH,KURNOOL,ALL SOCIAL GROUPS,2.0-3.0,12,PAGIDYALA,326,767,473,289,762,0,3,0,3,2
ANDHRA PRADESH,KURNOOL,ALL SOCIAL GROUPS,2.0-3.0,13,JUPADU BUNGALOW,1190,2745,2590,151,2741,0,3,0,3,2
ANDHRA PRADESH,KURNOOL,ALL SOCIAL GROUPS,2.0-3.0,14,KOTHAPALLE,828,1957,1644,313,1957,0,0,0,0,0
ANDHRA PRADESH,KURNOOL,ALL SOCIAL GROUPS,2.0-3.0,15,ATMAKUR,718,1713,1713,0,1713,0,0,0,0,0
ANDHRA PRADESH,KURNOOL,ALL SOCIAL GROUPS,2.0-3.0,16,PAMULAPADU,684,1573,1465,109,1574,0,0,0,0,0
ANDHRA PRADESH,KURNOOL,ALL SOCIAL GROUPS,2.0-3.0,17,MIDTHUR,1932,4505,4476,29,4505,0,0,0,0,0
ANDHRA PRADESH,KURNOOL,ALL SOCIAL GROUPS,2.0-3.0,18,ORVAKAL,1766,4138,3381,757,4138,0,0,0,0,0
ANDHRA PRADESH,KURNOOL,ALL SOCIAL GROUPS,2.0-3.0,19,KODUMUR,1347,3193,3153,40,3193,0,0,0,0,0
ANDHRA PRADESH,KURNOOL,ALL SOCIAL GROUPS,2.0-3.0,20,GONEGANDLA,1875,4466,3710,756,4466,0,0,0,0,0
ANDHRA PRADESH,KURNOOL,ALL SOCIAL GROUPS,2.0-3.0,21,ADONI,2803,6752,6511,241,6752,0,0,0,0,0
ANDHRA PRADESH,KURNOOL,ALL SOCIAL GROUPS,2.0-3.0,22,HOLAGUNDA,1656,4008,2866,1138,4004,0,3,0,3,2
ANDHRA PRADESH,KURNOOL,ALL SOCIAL GROUPS,2.0-3.0,23,HALAHARVI,1580,3796,3698,98,3796,0,0,0,0,0
ANDHRA PRADESH,KURNOOL,ALL SOCIAL GROUPS,2.0-3.0,24,ALUR,2328,5591,5421,146,5567,0,15,0,15,8
ANDHRA PRADESH,KURNOOL,ALL SOCIAL GROUPS,2.0-3.0,25,ASPARI,2446,5863,4755,1108,5863,0,0,0,0,0
ANDHRA PRADESH,KURNOOL,ALL SOCIAL GROUPS,2.0-3.0,26,DEVANAKONDA,3155,7346,7211,135,7346,0,0,0,0,0
ANDHRA PRADESH,KURNOOL,ALL SOCIAL GROUPS,2.0-3.0,27,KRISHNAGIRI,2628,6128,5824,303,6127,0,0,0,0,0
ANDHRA PRADESH,KURNOOL,ALL SOCIAL GROUPS,2.0-3.0,28,VELDURTHI,1762,4376,3589,787,4376,0,0,0,0,0
ANDHRA PRADESH,KURNOOL,ALL SOCIAL GROUPS,2.0-3.0,29,BETHAMCHERLA,1501,3617,3537,80,3617,0,0,0,0,0
ANDHRA PRADESH,KURNOOL,ALL SOCIAL GROUPS,2.0-3.0,30,PANYAM,1022,2463,1750,707,2457,0,4,0,4,2
ANDHRA PRADESH,KURNOOL,ALL SOCIAL GROUPS,2.0-3.0,31,GADIVEMULA,1235,2952,2709,109,2818,0,108,0,108,26
ANDHRA PRADESH,KURNOOL,ALL SOCIAL GROUPS,2.0-3.0,32,VELGODE,612,1452,1452,0,1452,0,0,0,0,0
ANDHRA PRADESH,KURNOOL,ALL SOCIAL GROUPS,2.0-3.0,33,BANDI ATMAKUR,938,2262,2203,55,2258,0,1,1,2,2
ANDHRA PRADESH,KURNOOL,ALL SOCIAL GROUPS,2.0-3.0,34,NANDYAL,1054,2553,2543,10,2553,0,0,0,0,0
ANDHRA PRADESH,KURNOOL,ALL SOCIAL GROUPS,2.0-3.0,35,MAHANANDI,576,1359,1314,9,1323,4,0,19,23,12
ANDHRA PRADESH,KURNOOL,ALL SOCIAL GROUPS,2.0-3.0,36,SIRVEL,1092,2625,2614,11,2625,0,0,0,0,0
ANDHRA PRADESH,KURNOOL,ALL SOCIAL GROUPS,2.0-3.0,37,GOSPADU,830,2006,2005,1,2006,0,0,0,0,0
ANDHRA PRADESH,KURNOOL,ALL SOCIAL GROUPS,2.0-3.0,38,BANAGANAPALLE,2360,5613,4088,1524,5612,0,0,0,0,0
ANDHRA PRADESH,KURNOOL,ALL SOCIAL GROUPS,2.0-3.0,39,DHONE,2647,6220,5986,234,6220,0,0,0,0,0
ANDHRA PRADESH,KURNOOL,ALL SOCIAL GROUPS,2.0-3.0,40,PATTIKONDA,2008,4819,4508,311,4819,0,0,0,0,0
ANDHRA PRADESH,KURNOOL,ALL SOCIAL GROUPS,2.0-3.0,41,CHIPPAGIRI,2035,4875,4857,18,4875,0,0,0,0,0
ANDHRA PRADESH,KURNOOL,ALL SOCIAL GROUPS,2.0-3.0,42,MADDIKERA (EAST),1925,4583,4526,56,4582,0,0,0,0,0
ANDHRA PRADESH,KURNOOL,ALL SOCIAL GROUPS,2.0-3.0,43,TUGGALI,2486,5904,5904,0,5904,0,0,0,0,0
ANDHRA PRADESH,KURNOOL,ALL SOCIAL GROUPS,2.0-3.0,44,PEAPALLY,2505,5895,5406,489,5895,0,0,0,0,0
ANDHRA PRADESH,KURNOOL,ALL SOCIAL GROUPS,2.0-3.0,45,OWK,1287,3087,2833,254,3087,0,0,0,0,0
ANDHRA PRADESH,KURNOOL,ALL SOCIAL GROUPS,2.0-3.0,46,KOILKUNTLA,1227,2954,2933,21,2954,0,0,0,0,0
ANDHRA PRADESH,KURNOOL,ALL SOCIAL GROUPS,2.0-3.0,47,RUDRAVARAM,1603,3845,3797,48,3845,0,0,0,0,0
ANDHRA PRADESH,KURNOOL,ALL SOCIAL GROUPS,2.0-3.0,48,ALLAGADDA,1259,3017,1491,1526,3017,0,0,0,0,0
ANDHRA PRADESH,KURNOOL,ALL SOCIAL GROUPS,2.0-3.0,49,DORNIPADU,748,1811,1771,40,1811,0,0,0,0,0
ANDHRA PRADESH,KURNOOL,ALL SOCIAL GROUPS,2.0-3.0,50,SANJAMALA,1534,3683,3674,9,3683,0,0,0,0,0
ANDHRA PRADESH,KURNOOL,ALL SOCIAL GROUPS,2.0-3.0,51,KOLIMIGUNDLA,1028,2472,2458,14,2472,0,0,0,0,0
ANDHRA PRADESH,KURNOOL,ALL SOCIAL GROUPS,2.0-3.0,52,UYYALAWADA,1165,2820,2816,4,2820,0,0,0,0,0
ANDHRA PRADESH,KURNOOL,ALL SOCIAL GROUPS,2.0-3.0,53,CHAGALAMARRI,1095,2583,1468,1115,2583,0,0,0,0,0
ANDHRA PRADESH,KURNOOL,ALL SOCIAL GROUPS,2.0-3.0,54,CHAGALAMARRI,1095,2583,1468,1115,2583,0,0,0,0,0
ANDHRA PRADESH,KURNOOL,INSTITUTIONAL,5.0-7.5,1,MANTRALAYAM,0,0,0,0,0,0,0,0,0,0
ANDHRA PRADESH,KURNOOL,INSTITUTIONAL,5.0-7.5,2,KOSIGI,0,0,0,0,0,0,0,0,0,0
ANDHRA PRADESH,KURNOOL,INSTITUTIONAL,5.0-7.5,3,KOWTHALAM,0,0,0,0,0,0,0,0,0,0
ANDHRA PRADESH,KURNOOL,INSTITUTIONAL,5.0-7.5,4,PEDDA KADUBUR,0,0,0,0,0,0,0,0,0,0
ANDHRA PRADESH,KURNOOL,INSTITUTIONAL,5.0-7.5,5,YEMMIGANUR,0,0,0,0,0,0,0,0,0,0
ANDHRA PRADESH,KURNOOL,INSTITUTIONAL,5.0-7.5,6,NANDAVARAM,0,0,0,0,0,0,0,0,0,0
ANDHRA PRADESH,KURNOOL,INSTITUTIONAL,5.0-7.5,7,C.BELAGAL,0,0,0,0,0,0,0,0,0,0
ANDHRA PRADESH,KURNOOL,INSTITUTIONAL,5.0-7.5,8,GUDUR,0,0,0,0,0,0,0,0,0,0
ANDHRA PRADESH,KURNOOL,INSTITUTIONAL,5.0-7.5,9,KALLUR,0,0,0,0,0,0,0,0,0,0
ANDHRA PRADESH,KURNOOL,INSTITUTIONAL,5.0-7.5,10,KURNOOL,0,0,0,0,0,0,0,0,0,0
ANDHRA PRADESH,KURNOOL,INSTITUTIONAL,5.0-7.5,11,NANDIKOTKUR,2,14,7,7,14,0,0,0,0,0
ANDHRA PRADESH,KURNOOL,INSTITUTIONAL,5.0-7.5,12,PAGIDYALA,0,0,0,0,0,0,0,0,0,0
ANDHRA PRADESH,KURNOOL,INSTITUTIONAL,5.0-7.5,13,JUPADU BUNGALOW,0,0,0,0,0,0,0,0,0,0
ANDHRA PRADESH,KURNOOL,INSTITUTIONAL,5.0-7.5,14,KOTHAPALLE,0,0,0,0,0,0,0,0,0,0
ANDHRA PRADESH,KURNOOL,INSTITUTIONAL,5.0-7.5,15,ATMAKUR,0,0,0,0,0,0,0,0,0,0
ANDHRA PRADESH,KURNOOL,INSTITUTIONAL,5.0-7.5,16,PAMULAPADU,0,0,0,0,0,0,0,0,0,0
ANDHRA PRADESH,KURNOOL,INSTITUTIONAL,5.0-7.5,17,MIDTHUR,0,0,0,0,0,0,0,0,0,0
ANDHRA PRADESH,KURNOOL,INSTITUTIONAL,5.0-7.5,18,ORVAKAL,0,0,0,0,0,0,0,0,0,0
ANDHRA PRADESH,KURNOOL,INSTITUTIONAL,5.0-7.5,19,KODUMUR,0,0,0,0,0,0,0,0,0,0
ANDHRA PRADESH,KURNOOL,INSTITUTIONAL,5.0-7.5,20,GONEGANDLA,0,0,0,0,0,0,0,0,0,0
ANDHRA PRADESH,KURNOOL,INSTITUTIONAL,5.0-7.5,21,ADONI,0,0,0,0,0,0,0,0,0,0
ANDHRA PRADESH,KURNOOL,INSTITUTIONAL,5.0-7.5,22,HOLAGUNDA,0,0,0,0,0,0,0,0,0,0
ANDHRA PRADESH,KURNOOL,INSTITUTIONAL,5.0-7.5,23,HALAHARVI,0,0,0,0,0,0,0,0,0,0
ANDHRA PRADESH,KURNOOL,INSTITUTIONAL,5.0-7.5,24,ALUR,0,0,0,0,0,0,0,0,0,0
ANDHRA PRADESH,KURNOOL,INSTITUTIONAL,5.0-7.5,25,ASPARI,0,0,0,0,0,0,0,0,0,0
ANDHRA PRADESH,KURNOOL,INSTITUTIONAL,5.0-7.5,26,DEVANAKONDA,0,0,0,0,0,0,0,0,0,0
ANDHRA PRADESH,KURNOOL,INSTITUTIONAL,5.0-7.5,27,KRISHNAGIRI,0,0,0,0,0,0,0,0,0,0
ANDHRA PRADESH,KURNOOL,INSTITUTIONAL,5.0-7.5,28,VELDURTHI,0,0,0,0,0,0,0,0,0,0
ANDHRA PRADESH,KURNOOL,INSTITUTIONAL,5.0-7.5,29,BETHAMCHERLA,0,0,0,0,0,0,0,0,0,0
ANDHRA PRADESH,KURNOOL,INSTITUTIONAL,5.0-7.5,30,PANYAM,6,35,35,0,35,0,0,0,0,0
ANDHRA PRADESH,KURNOOL,INSTITUTIONAL,5.0-7.5,31,GADIVEMULA,0,0,0,0,0,0,0,0,0,0
ANDHRA PRADESH,KURNOOL,INSTITUTIONAL,5.0-7.5,32,VELGODE,0,0,0,0,0,0,0,0,0,0
ANDHRA PRADESH,KURNOOL,INSTITUTIONAL,5.0-7.5,33,BANDI ATMAKUR,0,0,0,0,0,0,0,0,0,0
ANDHRA PRADESH,KURNOOL,INSTITUTIONAL,5.0-7.5,34,NANDYAL,0,0,0,0,0,0,0,0,0,0
ANDHRA PRADESH,KURNOOL,INSTITUTIONAL,5.0-7.5,35,MAHANANDI,0,0,0,0,0,0,0,0,0,0
ANDHRA PRADESH,KURNOOL,INSTITUTIONAL,5.0-7.5,36,SIRVEL,0,0,0,0,0,0,0,0,0,0
ANDHRA PRADESH,KURNOOL,INSTITUTIONAL,5.0-7.5,37,GOSPADU,0,0,0,0,0,0,0,0,0,0
ANDHRA PRADESH,KURNOOL,INSTITUTIONAL,5.0-7.5,38,BANAGANAPALLE,0,0,0,0,0,0,0,0,0,0
ANDHRA PRADESH,KURNOOL,INSTITUTIONAL,5.0-7.5,39,DHONE,0,0,0,0,0,0,0,0,0,0
ANDHRA PRADESH,KURNOOL,INSTITUTIONAL,5.0-7.5,40,PATTIKONDA,0,0,0,0,0,0,0,0,0,0
ANDHRA PRADESH,KURNOOL,INSTITUTIONAL,5.0-7.5,41,CHIPPAGIRI,0,0,0,0,0,0,0,0,0,0
ANDHRA PRADESH,KURNOOL,INSTITUTIONAL,5.0-7.5,42,MADDIKERA (EAST),0,0,0,0,0,0,0,0,0,0
ANDHRA PRADESH,KURNOOL,INSTITUTIONAL,5.0-7.5,43,TUGGALI,0,0,0,0,0,0,0,0,0,0
ANDHRA PRADESH,KURNOOL,INSTITUTIONAL,5.0-7.5,44,PEAPALLY,0,0,0,0,0,0,0,0,0,0
ANDHRA PRADESH,KURNOOL,INSTITUTIONAL,5.0-7.5,45,OWK,0,0,0,0,0,0,0,0,0,0
ANDHRA PRADESH,KURNOOL,INSTITUTIONAL,5.0-7.5,46,KOILKUNTLA,0,0,0,0,0,0,0,0,0,0
ANDHRA PRADESH,KURNOOL,INSTITUTIONAL,5.0-7.5,47,RUDRAVARAM,0,0,0,0,0,0,0,0,0,0
ANDHRA PRADESH,KURNOOL,INSTITUTIONAL,5.0-7.5,48,ALLAGADDA,0,0,0,0,0,0,0,0,0,0
ANDHRA PRADESH,KURNOOL,INSTITUTIONAL,5.0-7.5,49,DORNIPADU,0,0,0,0,0,0,0,0,0,0
ANDHRA PRADESH,KURNOOL,INSTITUTIONAL,5.0-7.5,50,SANJAMALA,0,0,0,0,0,0,0,0,0,0
ANDHRA PRADESH,KURNOOL,INSTITUTIONAL,5.0-7.5,51,KOLIMIGUNDLA,0,0,0,0,0,0,0,0,0,0
ANDHRA PRADESH,KURNOOL,INSTITUTIONAL,5.0-7.5,52,UYYALAWADA,0,0,0,0,0,0,0,0,0,0
ANDHRA PRADESH,KURNOOL,INSTITUTIONAL,5.0-7.5,53,CHAGALAMARRI,0,0,0,0,0,0,0,0,0,0
ANDHRA PRADESH,KURNOOL,INSTITUTIONAL,5.0-7.5,54,CHAGALAMARRI,0,0,0,0,0,0,0,0,0,0
ANDHRA PRADESH,KURNOOL,SCHEDULED CASTE,5.0-7.5,1,MANTRALAYAM,5,30,15,15,30,0,0,0,0,0
ANDHRA PRADESH,KURNOOL,SCHEDULED CASTE,5.0-7.5,2,KOSIGI,2,13,6,6,12,0,0,0,0,0
ANDHRA PRADESH,KURNOOL,SCHEDULED CASTE,5.0-7.5,3,KOWTHALAM,21,126,126,0,126,0,0,0,0,0
ANDHRA PRADESH,KURNOOL,SCHEDULED CASTE,5.0-7.5,4,PEDDA KADUBUR,17,101,87,14,101,0,0,0,0,0
ANDHRA PRADESH,KURNOOL,SCHEDULED CASTE,5.0-7.5,5,YEMMIGANUR,6,38,38,0,38,0,0,0,0,0
ANDHRA PRADESH,KURNOOL,SCHEDULED CASTE,5.0-7.5,6,NANDAVARAM,11,61,31,31,62,0,0,0,0,0
ANDHRA PRADESH,KURNOOL,SCHEDULED CASTE,5.0-7.5,7,C.BELAGAL,4,23,23,0,23,0,0,0,0,0
ANDHRA PRADESH,KURNOOL,SCHEDULED CASTE,5.0-7.5,8,GUDUR,1,5,3,3,6,0,0,0,0,0
ANDHRA PRADESH,KURNOOL,SCHEDULED CASTE,5.0-7.5,9,KALLUR,13,76,53,23,76,0,0,0,0,0
ANDHRA PRADESH,KURNOOL,SCHEDULED CASTE,5.0-7.5,10,KURNOOL,23,133,133,0,133,0,0,0,0,0
ANDHRA PRADESH,KURNOOL,SCHEDULED CASTE,5.0-7.5,11,NANDIKOTKUR,5,28,14,14,28,0,0,0,0,0
ANDHRA PRADESH,KURNOOL,SCHEDULED CASTE,5.0-7.5,12,PAGIDYALA,3,16,8,8,16,0,0,0,0,0
ANDHRA PRADESH,KURNOOL,SCHEDULED CASTE,5.0-7.5,13,JUPADU BUNGALOW,5,29,22,7,29,0,0,0,0,0
ANDHRA PRADESH,KURNOOL,SCHEDULED CASTE,5.0-7.5,14,KOTHAPALLE,16,95,95,0,95,0,0,0,0,0
ANDHRA PRADESH,KURNOOL,SCHEDULED CASTE,5.0-7.5,15,ATMAKUR,9,52,52,0,52,0,0,0,0,0
ANDHRA PRADESH,KURNOOL,SCHEDULED CASTE,5.0-7.5,16,PAMULAPADU,17,94,94,0,94,0,0,0,0,0
ANDHRA PRADESH,KURNOOL,SCHEDULED CASTE,5.0-7.5,17,MIDTHUR,42,233,223,10,233,0,0,0,0,0
ANDHRA PRADESH,KURNOOL,SCHEDULED CASTE,5.0-7.5,18,ORVAKAL,8,47,47,0,47,0,0,0,0,0
ANDHRA PRADESH,KURNOOL,SCHEDULED CASTE,5.0-7.5,19,KODUMUR,5,28,20,8,28,0,0,0,0,0
ANDHRA PRADESH,KURNOOL,SCHEDULED CASTE,5.0-7.5,20,GONEGANDLA,53,294,192,102,294,0,0,0,0,0
ANDHRA PRADESH,KURNOOL,SCHEDULED CASTE,5.0-7.5,21,ADONI,26,150,150,0,150,0,0,0,0,0
ANDHRA PRADESH,KURNOOL,SCHEDULED CASTE,5.0-7.5,22,HOLAGUNDA,23,131,50,79,129,0,3,0,3,0
ANDHRA PRADESH,KURNOOL,SCHEDULED CASTE,5.0-7.5,23,HALAHARVI,28,172,86,86,172,0,0,0,0,0
ANDHRA PRADESH,KURNOOL,SCHEDULED CASTE,5.0-7.5,24,ALUR,49,283,283,0,283,0,0,0,0,0
ANDHRA PRADESH,KURNOOL,SCHEDULED CASTE,5.0-7.5,25,ASPARI,69,395,68,326,394,0,0,0,0,0
ANDHRA PRADESH,KURNOOL,SCHEDULED CASTE,5.0-7.5,26,DEVANAKONDA,27,153,153,0,153,0,0,0,0,0
ANDHRA PRADESH,KURNOOL,SCHEDULED CASTE,5.0-7.5,27,KRISHNAGIRI,56,325,163,163,326,0,0,0,0,0
ANDHRA PRADESH,KURNOOL,SCHEDULED CASTE,5.0-7.5,28,VELDURTHI,14,97,0,97,97,0,0,0,0,0
ANDHRA PRADESH,KURNOOL,SCHEDULED CASTE,5.0-7.5,29,BETHAMCHERLA,8,48,44,3,47,0,0,0,0,0
ANDHRA PRADESH,KURNOOL,SCHEDULED CASTE,5.0-7.5,30,PANYAM,6,34,34,0,34,0,0,0,0,0
ANDHRA PRADESH,KURNOOL,SCHEDULED CASTE,5.0-7.5,31,GADIVEMULA,14,85,42,42,84,0,0,0,0,0
ANDHRA PRADESH,KURNOOL,SCHEDULED CASTE,5.0-7.5,32,VELGODE,19,108,105,3,108,0,0,0,0,0
ANDHRA PRADESH,KURNOOL,SCHEDULED CASTE,5.0-7.5,33,BANDI ATMAKUR,7,41,37,0,37,1,1,1,3,2
ANDHRA PRADESH,KURNOOL,SCHEDULED CASTE,5.0-7.5,34,NANDYAL,2,14,7,7,14,0,0,0,0,0
ANDHRA PRADESH,KURNOOL,SCHEDULED CASTE,5.0-7.5,35,MAHANANDI,8,43,41,0,41,0,0,1,1,1
ANDHRA PRADESH,KURNOOL,SCHEDULED CASTE,5.0-7.5,36,SIRVEL,7,42,21,21,42,0,0,0,0,0
ANDHRA PRADESH,KURNOOL,SCHEDULED CASTE,5.0-7.5,37,GOSPADU,1,5,5,0,5,0,0,0,0,0
ANDHRA PRADESH,KURNOOL,SCHEDULED CASTE,5.0-7.5,38,BANAGANAPALLE,4,22,11,11,22,0,0,0,0,0
ANDHRA PRADESH,KURNOOL,SCHEDULED CASTE,5.0-7.5,39,DHONE,43,247,247,0,247,0,0,0,0,0
ANDHRA PRADESH,KURNOOL,SCHEDULED CASTE,5.0-7.5,40,PATTIKONDA,19,113,60,52,112,0,0,0,0,0
ANDHRA PRADESH,KURNOOL,SCHEDULED CASTE,5.0-7.5,41,CHIPPAGIRI,40,231,231,0,231,0,0,0,0,0
ANDHRA PRADESH,KURNOOL,SCHEDULED CASTE,5.0-7.5,42,MADDIKERA (EAST),8,50,50,0,50,0,0,0,0,0
ANDHRA PRADESH,KURNOOL,SCHEDULED CASTE,5.0-7.5,43,TUGGALI,43,253,245,8,253,0,0,0,0,0
ANDHRA PRADESH,KURNOOL,SCHEDULED CASTE,5.0-7.5,44,PEAPALLY,4,24,12,12,24,0,0,0,0,0
ANDHRA PRADESH,KURNOOL,SCHEDULED CASTE,5.0-7.5,45,OWK,16,91,91,0,91,0,0,0,0,0
ANDHRA PRADESH,KURNOOL,SCHEDULED CASTE,5.0-7.5,46,KOILKUNTLA,5,31,31,0,31,0,0,0,0,0
ANDHRA PRADESH,KURNOOL,SCHEDULED CASTE,5.0-7.5,47,RUDRAVARAM,11,68,68,0,68,0,0,0,0,0
ANDHRA PRADESH,KURNOOL,SCHEDULED CASTE,5.0-7.5,48,ALLAGADDA,7,44,44,0,44,0,0,0,0,0
ANDHRA PRADESH,KURNOOL,SCHEDULED CASTE,5.0-7.5,49,DORNIPADU,7,41,20,20,40,0,0,0,0,0
ANDHRA PRADESH,KURNOOL,SCHEDULED CASTE,5.0-7.5,50,SANJAMALA,9,53,53,0,53,0,0,0,0,0
ANDHRA PRADESH,KURNOOL,SCHEDULED CASTE,5.0-7.5,51,KOLIMIGUNDLA,16,92,92,0,92,0,0,0,0,0
ANDHRA PRADESH,KURNOOL,SCHEDULED CASTE,5.0-7.5,52,UYYALAWADA,9,53,53,0,53,0,0,0,0,0
ANDHRA PRADESH,KURNOOL,SCHEDULED CASTE,5.0-7.5,53,CHAGALAMARRI,32,216,108,108,216,0,0,0,0,0
ANDHRA PRADESH,KURNOOL,SCHEDULED CASTE,5.0-7.5,54,CHAGALAMARRI,32,216,108,108,216,0,0,0,0,0
ANDHRA PRADESH,KURNOOL,OTHERS,5.0-7.5,1,MANTRALAYAM,178,1068,607,461,1068,0,0,0,0,0
ANDHRA PRADESH,KURNOOL,OTHERS,5.0-7.5,2,KOSIGI,134,819,651,168,819,0,0,0,0,0
ANDHRA PRADESH,KURNOOL,OTHERS,5.0-7.5,3,KOWTHALAM,447,2678,2678,0,2678,0,0,0,0,0
ANDHRA PRADESH,KURNOOL,OTHERS,5.0-7.5,4,PEDDA KADUBUR,309,1960,1777,183,1960,0,0,0,0,0
ANDHRA PRADESH,KURNOOL,OTHERS,5.0-7.5,5,YEMMIGANUR,379,2275,2129,29,2158,0,74,0,74,42
ANDHRA PRADESH,KURNOOL,OTHERS,5.0-7.5,6,NANDAVARAM,380,2275,2206,37,2243,2,19,0,21,12
ANDHRA PRADESH,KURNOOL,OTHERS,5.0-7.5,7,C.BELAGAL,123,739,725,14,739,0,0,0,0,0
ANDHRA PRADESH,KURNOOL,OTHERS,5.0-7.5,8,GUDUR,171,1030,838,193,1031,0,0,0,0,0
ANDHRA PRADESH,KURNOOL,OTHERS,5.0-7.5,9,KALLUR,351,2061,2016,45,2061,0,0,0,0,0
ANDHRA PRADESH,KURNOOL,OTHERS,5.0-7.5,10,KURNOOL,458,2743,2712,31,2743,0,0,0,0,0
ANDHRA PRADESH,KURNOOL,OTHERS,5.0-7.5,11,NANDIKOTKUR,214,1274,976,281,1257,8,1,1,10,5
ANDHRA PRADESH,KURNOOL,OTHERS,5.0-7.5,12,PAGIDYALA,82,482,474,8,482,0,0,0,0,0
ANDHRA PRADESH,KURNOOL,OTHERS,5.0-7.5,13,JUPADU BUNGALOW,150,899,416,428,844,0,35,0,35,20
ANDHRA PRADESH,KURNOOL,OTHERS,5.0-7.5,14,KOTHAPALLE,108,636,510,126,636,0,0,0,0,0
ANDHRA PRADESH,KURNOOL,OTHERS,5.0-7.5,15,ATMAKUR,89,524,524,0,524,0,0,0,0,0
ANDHRA PRADESH,KURNOOL,OTHERS,5.0-7.5,16,PAMULAPADU,116,669,634,36,670,0,0,0,0,0
ANDHRA PRADESH,KURNOOL,OTHERS,5.0-7.5,17,MIDTHUR,571,3410,3380,31,3411,0,0,0,0,0
ANDHRA PRADESH,KURNOOL,OTHERS,5.0-7.5,18,ORVAKAL,315,1907,1478,429,1907,0,0,0,0,0
ANDHRA PRADESH,KURNOOL,OTHERS,5.0-7.5,19,KODUMUR,267,1596,1534,62,1596,0,0,0,0,0
ANDHRA PRADESH,KURNOOL,OTHERS,5.0-7.5,20,GONEGANDLA,289,1697,1470,227,1697,0,0,0,0,0
ANDHRA PRADESH,KURNOOL,OTHERS,5.0-7.5,21,ADONI,743,4443,4443,0,4443,0,0,0,0,0
ANDHRA PRADESH,KURNOOL,OTHERS,5.0-7.5,22,HOLAGUNDA,490,2968,1505,1405,2910,0,37,0,37,21
ANDHRA PRADESH,KURNOOL,OTHERS,5.0-7.5,23,HALAHARVI,641,3848,3848,0,3848,0,0,0,0,0
ANDHRA PRADESH,KURNOOL,OTHERS,5.0-7.5,24,ALUR,776,4667,4058,474,4532,0,86,0,86,49
ANDHRA PRADESH,KURNOOL,OTHERS,5.0-7.5,25,ASPARI,912,5405,2993,2412,5405,0,0,0,0,0
ANDHRA PRADESH,KURNOOL,OTHERS,5.0-7.5,26,DEVANAKONDA,568,3377,3059,318,3377,0,0,0,0,0
ANDHRA PRADESH,KURNOOL,OTHERS,5.0-7.5,27,KRISHNAGIRI,549,3301,2784,517,3301,0,0,0,0,0
ANDHRA PRADESH,KURNOOL,OTHERS,5.0-7.5,28,VELDURTHI,299,2060,756,1304,2060,0,0,0,0,0
ANDHRA PRADESH,KURNOOL,OTHERS,5.0-7.5,29,BETHAMCHERLA,186,1118,974,144,1118,0,0,0,0,0
ANDHRA PRADESH,KURNOOL,OTHERS,5.0-7.5,30,PANYAM,257,1540,955,559,1514,0,16,0,16,9
ANDHRA PRADESH,KURNOOL,OTHERS,5.0-7.5,31,GADIVEMULA,189,1143,913,20,933,0,135,0,135,77
ANDHRA PRADESH,KURNOOL,OTHERS,5.0-7.5,32,VELGODE,145,898,895,3,898,0,0,0,0,0
ANDHRA PRADESH,KURNOOL,OTHERS,5.0-7.5,33,BANDI ATMAKUR,197,1167,1100,58,1158,3,3,0,6,2
ANDHRA PRADESH,KURNOOL,OTHERS,5.0-7.5,34,NANDYAL,233,1407,1404,2,1406,0,0,0,0,0
ANDHRA PRADESH,KURNOOL,OTHERS,5.0-7.5,35,MAHANANDI,108,624,582,4,586,0,2,22,24,14
ANDHRA PRADESH,KURNOOL,OTHERS,5.0-7.5,36,SIRVEL,231,1352,676,676,1352,0,0,0,0,0
ANDHRA PRADESH,KURNOOL,OTHERS,5.0-7.5,37,GOSPADU,220,1329,1329,0,1329,0,0,0,0,0
ANDHRA PRADESH,KURNOOL,OTHERS,5.0-7.5,38,BANAGANAPALLE,449,2698,2063,635,2698,0,0,0,0,0
ANDHRA PRADESH,KURNOOL,OTHERS,5.0-7.5,39,DHONE,800,4749,4749,0,4749,0,0,0,0,0
ANDHRA PRADESH,KURNOOL,OTHERS,5.0-7.5,40,PATTIKONDA,452,2732,2229,503,2732,0,0,0,0,0
ANDHRA PRADESH,KURNOOL,OTHERS,5.0-7.5,41,CHIPPAGIRI,904,5399,5360,39,5399,0,0,0,0,0
ANDHRA PRADESH,KURNOOL,OTHERS,5.0-7.5,42,MADDIKERA (EAST),394,2383,2257,126,2383,0,0,0,0,0
ANDHRA PRADESH,KURNOOL,OTHERS,5.0-7.5,43,TUGGALI,621,3716,3500,216,3716,0,0,0,0,0
ANDHRA PRADESH,KURNOOL,OTHERS,5.0-7.5,44,PEAPALLY,273,1639,1499,140,1639,0,0,0,0,0
ANDHRA PRADESH,KURNOOL,OTHERS,5.0-7.5,45,OWK,313,1891,1891,0,1891,0,0,0,0,0
ANDHRA PRADESH,KURNOOL,OTHERS,5.0-7.5,46,KOILKUNTLA,355,2153,2128,25,2153,0,0,0,0,0
ANDHRA PRADESH,KURNOOL,OTHERS,5.0-7.5,47,RUDRAVARAM,314,1885,1741,144,1885,0,0,0,0,0
ANDHRA PRADESH,KURNOOL,OTHERS,5.0-7.5,48,ALLAGADDA,295,1797,1368,429,1797,0,0,0,0,0
ANDHRA PRADESH,KURNOOL,OTHERS,5.0-7.5,49,DORNIPADU,204,1215,1215,0,1215,0,0,0,0,0
ANDHRA PRADESH,KURNOOL,OTHERS,5.0-7.5,50,SANJAMALA,509,3003,3003,0,3003,0,0,0,0,0
ANDHRA PRADESH,KURNOOL,OTHERS,5.0-7.5,51,KOLIMIGUNDLA,310,1860,1860,0,1860,0,0,0,0,0
ANDHRA PRADESH,KURNOOL,OTHERS,5.0-7.5,52,UYYALAWADA,478,2907,2875,32,2907,0,0,0,0,0
ANDHRA PRADESH,KURNOOL,OTHERS,5.0-7.5,53,CHAGALAMARRI,140,852,283,570,853,0,0,0,0,0
ANDHRA PRADESH,KURNOOL,OTHERS,5.0-7.5,54,CHAGALAMARRI,140,852,283,570,853,0,0,0,0,0
ANDHRA PRADESH,KURNOOL,SCHEDULED TRIBES,5.0-7.5,1,MANTRALAYAM,1,5,2,3,5,0,0,0,0,0
ANDHRA PRADESH,KURNOOL,SCHEDULED TRIBES,5.0-7.5,2,KOSIGI,1,6,3,3,6,0,0,0,0,0
ANDHRA PRADESH,KURNOOL,SCHEDULED TRIBES,5.0-7.5,3,KOWTHALAM,4,24,12,12,24,0,0,0,0,0
ANDHRA PRADESH,KURNOOL,SCHEDULED TRIBES,5.0-7.5,4,PEDDA KADUBUR,0,0,0,0,0,0,0,0,0,0
ANDHRA PRADESH,KURNOOL,SCHEDULED TRIBES,5.0-7.5,5,YEMMIGANUR,0,0,0,0,0,0,0,0,0,0
ANDHRA PRADESH,KURNOOL,SCHEDULED TRIBES,5.0-7.5,6,NANDAVARAM,0,0,0,0,0,0,0,0,0,0
ANDHRA PRADESH,KURNOOL,SCHEDULED TRIBES,5.0-7.5,7,C.BELAGAL,0,0,0,0,0,0,0,0,0,0
ANDHRA PRADESH,KURNOOL,SCHEDULED TRIBES,5.0-7.5,8,GUDUR,0,0,0,0,0,0,0,0,0,0
ANDHRA PRADESH,KURNOOL,SCHEDULED TRIBES,5.0-7.5,9,KALLUR,4,23,23,0,23,0,0,0,0,0
ANDHRA PRADESH,KURNOOL,SCHEDULED TRIBES,5.0-7.5,10,KURNOOL,8,44,22,22,44,0,0,0,0,0
ANDHRA PRADESH,KURNOOL,SCHEDULED TRIBES,5.0-7.5,11,NANDIKOTKUR,0,0,0,0,0,0,0,0,0,0
ANDHRA PRADESH,KURNOOL,SCHEDULED TRIBES,5.0-7.5,12,PAGIDYALA,0,0,0,0,0,0,0,0,0,0
ANDHRA PRADESH,KURNOOL,SCHEDULED TRIBES,5.0-7.5,13,JUPADU BUNGALOW,0,0,0,0,0,0,0,0,0,0
ANDHRA PRADESH,KURNOOL,SCHEDULED TRIBES,5.0-7.5,14,KOTHAPALLE,3,17,8,8,16,0,0,0,0,0
ANDHRA PRADESH,KURNOOL,SCHEDULED TRIBES,5.0-7.5,15,ATMAKUR,2,11,5,5,10,0,0,0,0,0
ANDHRA PRADESH,KURNOOL,SCHEDULED TRIBES,5.0-7.5,16,PAMULAPADU,0,0,0,0,0,0,0,0,0,0
ANDHRA PRADESH,KURNOOL,SCHEDULED TRIBES,5.0-7.5,17,MIDTHUR,0,0,0,0,0,0,0,0,0,0
ANDHRA PRADESH,KURNOOL,SCHEDULED TRIBES,5.0-7.5,18,ORVAKAL,2,11,11,0,11,0,0,0,0,0
ANDHRA PRADESH,KURNOOL,SCHEDULED TRIBES,5.0-7.5,19,KODUMUR,0,0,0,0,0,0,0,0,0,0
ANDHRA PRADESH,KURNOOL,SCHEDULED TRIBES,5.0-7.5,20,GONEGANDLA,3,17,8,8,16,0,0,0,0,0
ANDHRA PRADESH,KURNOOL,SCHEDULED TRIBES,5.0-7.5,21,ADONI,0,0,0,0,0,0,0,0,0,0
ANDHRA PRADESH,KURNOOL,SCHEDULED TRIBES,5.0-7.5,22,HOLAGUNDA,3,19,15,4,19,0,0,0,0,0
ANDHRA PRADESH,KURNOOL,SCHEDULED TRIBES,5.0-7.5,23,HALAHARVI,1,7,4,4,8,0,0,0,0,0
ANDHRA PRADESH,KURNOOL,SCHEDULED TRIBES,5.0-7.5,24,ALUR,1,6,6,0,6,0,0,0,0,0
ANDHRA PRADESH,KURNOOL,SCHEDULED TRIBES,5.0-7.5,25,ASPARI,2,12,6,6,12,0,0,0,0,0
ANDHRA PRADESH,KURNOOL,SCHEDULED TRIBES,5.0-7.5,26,DEVANAKONDA,1,6,3,3,6,0,0,0,0,0
ANDHRA PRADESH,KURNOOL,SCHEDULED TRIBES,5.0-7.5,27,KRISHNAGIRI,7,40,40,0,40,0,0,0,0,0
ANDHRA PRADESH,KURNOOL,SCHEDULED TRIBES,5.0-7.5,28,VELDURTHI,1,5,3,2,5,0,0,0,0,0
ANDHRA PRADESH,KURNOOL,SCHEDULED TRIBES,5.0-7.5,29,BETHAMCHERLA,1,5,3,2,5,0,0,0,0,0
ANDHRA PRADESH,KURNOOL,SCHEDULED TRIBES,5.0-7.5,30,PANYAM,0,0,0,0,0,0,0,0,0,0
ANDHRA PRADESH,KURNOOL,SCHEDULED TRIBES,5.0-7.5,31,GADIVEMULA,5,29,15,14,29,0,0,0,0,0
ANDHRA PRADESH,KURNOOL,SCHEDULED TRIBES,5.0-7.5,32,VELGODE,1,5,3,3,6,0,0,0,0,0
ANDHRA PRADESH,KURNOOL,SCHEDULED TRIBES,5.0-7.5,33,BANDI ATMAKUR,0,0,0,0,0,0,0,0,0,0
ANDHRA PRADESH,KURNOOL,SCHEDULED TRIBES,5.0-7.5,34,NANDYAL,0,0,0,0,0,0,0,0,0,0
ANDHRA PRADESH,KURNOOL,SCHEDULED TRIBES,5.0-7.5,35,MAHANANDI,0,0,0,0,0,0,0,0,0,0
ANDHRA PRADESH,KURNOOL,SCHEDULED TRIBES,5.0-7.5,36,SIRVEL,0,0,0,0,0,0,0,0,0,0
ANDHRA PRADESH,KURNOOL,SCHEDULED TRIBES,5.0-7.5,37,GOSPADU,0,0,0,0,0,0,0,0,0,0
ANDHRA PRADESH,KURNOOL,SCHEDULED TRIBES,5.0-7.5,38,BANAGANAPALLE,5,32,16,16,32,0,0,0,0,0
ANDHRA PRADESH,KURNOOL,SCHEDULED TRIBES,5.0-7.5,39,DHONE,23,137,137,0,137,0,0,0,0,0
ANDHRA PRADESH,KURNOOL,SCHEDULED TRIBES,5.0-7.5,40,PATTIKONDA,34,198,99,99,198,0,0,0,0,0
ANDHRA PRADESH,KURNOOL,SCHEDULED TRIBES,5.0-7.5,41,CHIPPAGIRI,5,32,32,0,32,0,0,0,0,0
ANDHRA PRADESH,KURNOOL,SCHEDULED TRIBES,5.0-7.5,42,MADDIKERA (EAST),0,0,0,0,0,0,0,0,0,0
ANDHRA PRADESH,KURNOOL,SCHEDULED TRIBES,5.0-7.5,43,TUGGALI,56,335,322,13,335,0,0,0,0,0
ANDHRA PRADESH,KURNOOL,SCHEDULED TRIBES,5.0-7.5,44,PEAPALLY,1,6,3,3,6,0,0,0,0,0
ANDHRA PRADESH,KURNOOL,SCHEDULED TRIBES,5.0-7.5,45,OWK,9,53,53,0,53,0,0,0,0,0
ANDHRA PRADESH,KURNOOL,SCHEDULED TRIBES,5.0-7.5,46,KOILKUNTLA,0,0,0,0,0,0,0,0,0,0
ANDHRA PRADESH,KURNOOL,SCHEDULED TRIBES,5.0-7.5,47,RUDRAVARAM,4,24,24,0,24,0,0,0,0,0
ANDHRA PRADESH,KURNOOL,SCHEDULED TRIBES,5.0-7.5,48,ALLAGADDA,0,0,0,0,0,0,0,0,0,0
ANDHRA PRADESH,KURNOOL,SCHEDULED TRIBES,5.0-7.5,49,DORNIPADU,1,5,3,3,6,0,0,0,0,0
ANDHRA PRADESH,KURNOOL,SCHEDULED TRIBES,5.0-7.5,50,SANJAMALA,1,6,3,3,6,0,0,0,0,0
ANDHRA PRADESH,KURNOOL,SCHEDULED TRIBES,5.0-7.5,51,KOLIMIGUNDLA,1,6,3,3,6,0,0,0,0,0
ANDHRA PRADESH,KURNOOL,SCHEDULED TRIBES,5.0-7.5,52,UYYALAWADA,0,0,0,0,0,0,0,0,0,0
ANDHRA PRADESH,KURNOOL,SCHEDULED TRIBES,5.0-7.5,53,CHAGALAMARRI,1,7,4,4,8,0,0,0,0,0
ANDHRA PRADESH,KURNOOL,SCHEDULED TRIBES,5.0-7.5,54,CHAGALAMARRI,1,7,4,4,8,0,0,0,0,0
ANDHRA PRADESH,KURNOOL,ALL SOCIAL GROUPS,5.0-7.5,1,MANTRALAYAM,184,1103,624,478,1102,0,0,0,0,0
ANDHRA PRADESH,KURNOOL,ALL SOCIAL GROUPS,5.0-7.5,2,KOSIGI,137,838,661,178,839,0,0,0,0,0
ANDHRA PRADESH,KURNOOL,ALL SOCIAL GROUPS,5.0-7.5,3,KOWTHALAM,472,2828,2816,12,2828,0,0,0,0,0
ANDHRA PRADESH,KURNOOL,ALL SOCIAL GROUPS,5.0-7.5,4,PEDDA KADUBUR,326,2061,1864,197,2061,0,0,0,0,0
ANDHRA PRADESH,KURNOOL,ALL SOCIAL GROUPS,5.0-7.5,5,YEMMIGANUR,385,2312,2166,29,2195,0,74,0,74,42
ANDHRA PRADESH,KURNOOL,ALL SOCIAL GROUPS,5.0-7.5,6,NANDAVARAM,391,2337,2237,67,2304,2,19,0,21,12
ANDHRA PRADESH,KURNOOL,ALL SOCIAL GROUPS,5.0-7.5,7,C.BELAGAL,127,762,748,14,762,0,0,0,0,0
ANDHRA PRADESH,KURNOOL,ALL SOCIAL GROUPS,5.0-7.5,8,GUDUR,172,1036,840,196,1036,0,0,0,0,0
ANDHRA PRADESH,KURNOOL,ALL SOCIAL GROUPS,5.0-7.5,9,KALLUR,368,2160,2092,68,2160,0,0,0,0,0
ANDHRA PRADESH,KURNOOL,ALL SOCIAL GROUPS,5.0-7.5,10,KURNOOL,489,2921,2868,53,2921,0,0,0,0,0
ANDHRA PRADESH,KURNOOL,ALL SOCIAL GROUPS,5.0-7.5,11,NANDIKOTKUR,221,1316,998,303,1301,8,1,1,10,5
ANDHRA PRADESH,KURNOOL,ALL SOCIAL GROUPS,5.0-7.5,12,PAGIDYALA,85,498,482,16,498,0,0,0,0,0
ANDHRA PRADESH,KURNOOL,ALL SOCIAL GROUPS,5.0-7.5,13,JUPADU BUNGALOW,155,928,438,435,873,0,35,0,35,20
ANDHRA PRADESH,KURNOOL,ALL SOCIAL GROUPS,5.0-7.5,14,KOTHAPALLE,127,748,613,135,748,0,0,0,0,0
ANDHRA PRADESH,KURNOOL,ALL SOCIAL GROUPS,5.0-7.5,15,ATMAKUR,100,587,582,5,587,0,0,0,0,0
ANDHRA PRADESH,KURNOOL,ALL SOCIAL GROUPS,5.0-7.5,16,PAMULAPADU,133,764,728,36,764,0,0,0,0,0
ANDHRA PRADESH,KURNOOL,ALL SOCIAL GROUPS,5.0-7.5,17,MIDTHUR,613,3643,3602,41,3643,0,0,0,0,0
ANDHRA PRADESH,KURNOOL,ALL SOCIAL GROUPS,5.0-7.5,18,ORVAKAL,325,1966,1536,429,1965,0,0,0,0,0
ANDHRA PRADESH,KURNOOL,ALL SOCIAL GROUPS,5.0-7.5,19,KODUMUR,272,1624,1554,70,1624,0,0,0,0,0
ANDHRA PRADESH,KURNOOL,ALL SOCIAL GROUPS,5.0-7.5,20,GONEGANDLA,345,2008,1671,337,2008,0,0,0,0,0
ANDHRA PRADESH,KURNOOL,ALL SOCIAL GROUPS,5.0-7.5,21,ADONI,769,4593,4593,0,4593,0,0,0,0,0
ANDHRA PRADESH,KURNOOL,ALL SOCIAL GROUPS,5.0-7.5,22,HOLAGUNDA,516,3119,1571,1487,3058,0,40,0,40,21
ANDHRA PRADESH,KURNOOL,ALL SOCIAL GROUPS,5.0-7.5,23,HALAHARVI,670,4027,3938,90,4028,0,0,0,0,0
ANDHRA PRADESH,KURNOOL,ALL SOCIAL GROUPS,5.0-7.5,24,ALUR,826,4956,4347,474,4821,0,86,0,86,49
ANDHRA PRADESH,KURNOOL,ALL SOCIAL GROUPS,5.0-7.5,25,ASPARI,983,5812,3068,2744,5812,0,0,0,0,0
ANDHRA PRADESH,KURNOOL,ALL SOCIAL GROUPS,5.0-7.5,26,DEVANAKONDA,596,3535,3214,321,3535,0,0,0,0,0
ANDHRA PRADESH,KURNOOL,ALL SOCIAL GROUPS,5.0-7.5,27,KRISHNAGIRI,612,3666,2986,679,3665,0,0,0,0,0
ANDHRA PRADESH,KURNOOL,ALL SOCIAL GROUPS,5.0-7.5,28,VELDURTHI,314,2162,758,1404,2162,0,0,0,0,0
ANDHRA PRADESH,KURNOOL,ALL SOCIAL GROUPS,5.0-7.5,29,BETHAMCHERLA,195,1171,1021,150,1171,0,0,0,0,0
ANDHRA PRADESH,KURNOOL,ALL SOCIAL GROUPS,5.0-7.5,30,PANYAM,269,1610,1025,559,1584,0,16,0,16,9
ANDHRA PRADESH,KURNOOL,ALL SOCIAL GROUPS,5.0-7.5,31,GADIVEMULA,208,1257,970,76,1046,0,135,0,135,77
ANDHRA PRADESH,KURNOOL,ALL SOCIAL GROUPS,5.0-7.5,32,VELGODE,165,1011,1002,9,1011,0,0,0,0,0
ANDHRA PRADESH,KURNOOL,ALL SOCIAL GROUPS,5.0-7.5,33,BANDI ATMAKUR,204,1208,1136,58,1194,4,4,1,9,4
ANDHRA PRADESH,KURNOOL,ALL SOCIAL GROUPS,5.0-7.5,34,NANDYAL,235,1421,1411,9,1420,0,0,0,0,0
ANDHRA PRADESH,KURNOOL,ALL SOCIAL GROUPS,5.0-7.5,35,MAHANANDI,116,667,624,4,628,0,2,23,25,16
ANDHRA PRADESH,KURNOOL,ALL SOCIAL GROUPS,5.0-7.5,36,SIRVEL,238,1394,697,697,1394,0,0,0,0,0
ANDHRA PRADESH,KURNOOL,ALL SOCIAL GROUPS,5.0-7.5,37,GOSPADU,221,1334,1334,0,1334,0,0,0,0,0
ANDHRA PRADESH,KURNOOL,ALL SOCIAL GROUPS,5.0-7.5,38,BANAGANAPALLE,458,2752,2090,662,2752,0,0,0,0,0
ANDHRA PRADESH,KURNOOL,ALL SOCIAL GROUPS,5.0-7.5,39,DHONE,866,5133,5133,0,5133,0,0,0,0,0
ANDHRA PRADESH,KURNOOL,ALL SOCIAL GROUPS,5.0-7.5,40,PATTIKONDA,505,3042,2388,655,3043,0,0,0,0,0
ANDHRA PRADESH,KURNOOL,ALL SOCIAL GROUPS,5.0-7.5,41,CHIPPAGIRI,949,5662,5623,39,5662,0,0,0,0,0
ANDHRA PRADESH,KURNOOL,ALL SOCIAL GROUPS,5.0-7.5,42,MADDIKERA (EAST),402,2433,2307,126,2433,0,0,0,0,0
ANDHRA PRADESH,KURNOOL,ALL SOCIAL GROUPS,5.0-7.5,43,TUGGALI,720,4304,4067,237,4304,0,0,0,0,0
ANDHRA PRADESH,KURNOOL,ALL SOCIAL GROUPS,5.0-7.5,44,PEAPALLY,278,1670,1514,156,1670,0,0,0,0,0
ANDHRA PRADESH,KURNOOL,ALL SOCIAL GROUPS,5.0-7.5,45,OWK,338,2035,2035,0,2035,0,0,0,0,0
ANDHRA PRADESH,KURNOOL,ALL SOCIAL GROUPS,5.0-7.5,46,KOILKUNTLA,360,2184,2159,25,2184,0,0,0,0,0
ANDHRA PRADESH,KURNOOL,ALL SOCIAL GROUPS,5.0-7.5,47,RUDRAVARAM,329,1977,1833,144,1977,0,0,0,0,0
ANDHRA PRADESH,KURNOOL,ALL SOCIAL GROUPS,5.0-7.5,48,ALLAGADDA,302,1841,1412,429,1841,0,0,0,0,0
ANDHRA PRADESH,KURNOOL,ALL SOCIAL GROUPS,5.0-7.5,49,DORNIPADU,212,1261,1238,23,1261,0,0,0,0,0
ANDHRA PRADESH,KURNOOL,ALL SOCIAL GROUPS,5.0-7.5,50,SANJAMALA,519,3062,3059,3,3062,0,0,0,0,0
ANDHRA PRADESH,KURNOOL,ALL SOCIAL GROUPS,5.0-7.5,51,KOLIMIGUNDLA,327,1958,1955,3,1958,0,0,0,0,0
ANDHRA PRADESH,KURNOOL,ALL SOCIAL GROUPS,5.0-7.5,52,UYYALAWADA,487,2960,2928,32,2960,0,0,0,0,0
ANDHRA PRADESH,KURNOOL,ALL SOCIAL GROUPS,5.0-7.5,53,CHAGALAMARRI,173,1076,394,682,1076,0,0,0,0,0
ANDHRA PRADESH,KURNOOL,ALL SOCIAL GROUPS,5.0-7.5,54,CHAGALAMARRI,173,1076,394,682,1076,0,0,0,0,0
ANDHRA PRADESH,KURNOOL,INSTITUTIONAL,4.0-5.0,1,MANTRALAYAM,0,0,0,0,0,0,0,0,0,0
ANDHRA PRADESH,KURNOOL,INSTITUTIONAL,4.0-5.0,2,KOSIGI,0,0,0,0,0,0,0,0,0,0
ANDHRA PRADESH,KURNOOL,INSTITUTIONAL,4.0-5.0,3,KOWTHALAM,0,0,0,0,0,0,0,0,0,0
ANDHRA PRADESH,KURNOOL,INSTITUTIONAL,4.0-5.0,4,PEDDA KADUBUR,0,0,0,0,0,0,0,0,0,0
ANDHRA PRADESH,KURNOOL,INSTITUTIONAL,4.0-5.0,5,YEMMIGANUR,1,4,2,2,4,0,0,0,0,0
ANDHRA PRADESH,KURNOOL,INSTITUTIONAL,4.0-5.0,6,NANDAVARAM,0,0,0,0,0,0,0,0,0,0
ANDHRA PRADESH,KURNOOL,INSTITUTIONAL,4.0-5.0,7,C.BELAGAL,0,0,0,0,0,0,0,0,0,0
ANDHRA PRADESH,KURNOOL,INSTITUTIONAL,4.0-5.0,8,GUDUR,0,0,0,0,0,0,0,0,0,0
ANDHRA PRADESH,KURNOOL,INSTITUTIONAL,4.0-5.0,9,KALLUR,0,0,0,0,0,0,0,0,0,0
ANDHRA PRADESH,KURNOOL,INSTITUTIONAL,4.0-5.0,10,KURNOOL,0,0,0,0,0,0,0,0,0,0
ANDHRA PRADESH,KURNOOL,INSTITUTIONAL,4.0-5.0,11,NANDIKOTKUR,3,14,7,7,14,0,0,0,0,0
ANDHRA PRADESH,KURNOOL,INSTITUTIONAL,4.0-5.0,12,PAGIDYALA,0,0,0,0,0,0,0,0,0,0
ANDHRA PRADESH,KURNOOL,INSTITUTIONAL,4.0-5.0,13,JUPADU BUNGALOW,0,0,0,0,0,0,0,0,0,0
ANDHRA PRADESH,KURNOOL,INSTITUTIONAL,4.0-5.0,14,KOTHAPALLE,0,0,0,0,0,0,0,0,0,0
ANDHRA PRADESH,KURNOOL,INSTITUTIONAL,4.0-5.0,15,ATMAKUR,0,0,0,0,0,0,0,0,0,0
ANDHRA PRADESH,KURNOOL,INSTITUTIONAL,4.0-5.0,16,PAMULAPADU,0,0,0,0,0,0,0,0,0,0
ANDHRA PRADESH,KURNOOL,INSTITUTIONAL,4.0-5.0,17,MIDTHUR,0,0,0,0,0,0,0,0,0,0
ANDHRA PRADESH,KURNOOL,INSTITUTIONAL,4.0-5.0,18,ORVAKAL,0,0,0,0,0,0,0,0,0,0
ANDHRA PRADESH,KURNOOL,INSTITUTIONAL,4.0-5.0,19,KODUMUR,0,0,0,0,0,0,0,0,0,0
ANDHRA PRADESH,KURNOOL,INSTITUTIONAL,4.0-5.0,20,GONEGANDLA,0,0,0,0,0,0,0,0,0,0
ANDHRA PRADESH,KURNOOL,INSTITUTIONAL,4.0-5.0,21,ADONI,0,0,0,0,0,0,0,0,0,0
ANDHRA PRADESH,KURNOOL,INSTITUTIONAL,4.0-5.0,22,HOLAGUNDA,0,0,0,0,0,0,0,0,0,0
ANDHRA PRADESH,KURNOOL,INSTITUTIONAL,4.0-5.0,23,HALAHARVI,0,0,0,0,0,0,0,0,0,0
ANDHRA PRADESH,KURNOOL,INSTITUTIONAL,4.0-5.0,24,ALUR,0,0,0,0,0,0,0,0,0,0
ANDHRA PRADESH,KURNOOL,INSTITUTIONAL,4.0-5.0,25,ASPARI,0,0,0,0,0,0,0,0,0,0
ANDHRA PRADESH,KURNOOL,INSTITUTIONAL,4.0-5.0,26,DEVANAKONDA,0,0,0,0,0,0,0,0,0,0
ANDHRA PRADESH,KURNOOL,INSTITUTIONAL,4.0-5.0,27,KRISHNAGIRI,0,0,0,0,0,0,0,0,0,0
ANDHRA PRADESH,KURNOOL,INSTITUTIONAL,4.0-5.0,28,VELDURTHI,0,0,0,0,0,0,0,0,0,0
ANDHRA PRADESH,KURNOOL,INSTITUTIONAL,4.0-5.0,29,BETHAMCHERLA,0,0,0,0,0,0,0,0,0,0
ANDHRA PRADESH,KURNOOL,INSTITUTIONAL,4.0-5.0,30,PANYAM,2,8,4,4,8,0,0,0,0,0
ANDHRA PRADESH,KURNOOL,INSTITUTIONAL,4.0-5.0,31,GADIVEMULA,0,0,0,0,0,0,0,0,0,0
ANDHRA PRADESH,KURNOOL,INSTITUTIONAL,4.0-5.0,32,VELGODE,0,0,0,0,0,0,0,0,0,0
ANDHRA PRADESH,KURNOOL,INSTITUTIONAL,4.0-5.0,33,BANDI ATMAKUR,0,0,0,0,0,0,0,0,0,0
ANDHRA PRADESH,KURNOOL,INSTITUTIONAL,4.0-5.0,34,NANDYAL,0,0,0,0,0,0,0,0,0,0
ANDHRA PRADESH,KURNOOL,INSTITUTIONAL,4.0-5.0,35,MAHANANDI,0,0,0,0,0,0,0,0,0,0
ANDHRA PRADESH,KURNOOL,INSTITUTIONAL,4.0-5.0,36,SIRVEL,0,0,0,0,0,0,0,0,0,0
ANDHRA PRADESH,KURNOOL,INSTITUTIONAL,4.0-5.0,37,GOSPADU,0,0,0,0,0,0,0,0,0,0
ANDHRA PRADESH,KURNOOL,INSTITUTIONAL,4.0-5.0,38,BANAGANAPALLE,0,0,0,0,0,0,0,0,0,0
ANDHRA PRADESH,KURNOOL,INSTITUTIONAL,4.0-5.0,39,DHONE,0,0,0,0,0,0,0,0,0,0
ANDHRA PRADESH,KURNOOL,INSTITUTIONAL,4.0-5.0,40,PATTIKONDA,0,0,0,0,0,0,0,0,0,0
ANDHRA PRADESH,KURNOOL,INSTITUTIONAL,4.0-5.0,41,CHIPPAGIRI,0,0,0,0,0,0,0,0,0,0
ANDHRA PRADESH,KURNOOL,INSTITUTIONAL,4.0-5.0,42,MADDIKERA (EAST),0,0,0,0,0,0,0,0,0,0
ANDHRA PRADESH,KURNOOL,INSTITUTIONAL,4.0-5.0,43,TUGGALI,0,0,0,0,0,0,0,0,0,0
ANDHRA PRADESH,KURNOOL,INSTITUTIONAL,4.0-5.0,44,PEAPALLY,0,0,0,0,0,0,0,0,0,0
ANDHRA PRADESH,KURNOOL,INSTITUTIONAL,4.0-5.0,45,OWK,0,0,0,0,0,0,0,0,0,0
ANDHRA PRADESH,KURNOOL,INSTITUTIONAL,4.0-5.0,46,KOILKUNTLA,0,0,0,0,0,0,0,0,0,0
ANDHRA PRADESH,KURNOOL,INSTITUTIONAL,4.0-5.0,47,RUDRAVARAM,0,0,0,0,0,0,0,0,0,0
ANDHRA PRADESH,KURNOOL,INSTITUTIONAL,4.0-5.0,48,ALLAGADDA,0,0,0,0,0,0,0,0,0,0
ANDHRA PRADESH,KURNOOL,INSTITUTIONAL,4.0-5.0,49,DORNIPADU,0,0,0,0,0,0,0,0,0,0
ANDHRA PRADESH,KURNOOL,INSTITUTIONAL,4.0-5.0,50,SANJAMALA,0,0,0,0,0,0,0,0,0,0
ANDHRA PRADESH,KURNOOL,INSTITUTIONAL,4.0-5.0,51,KOLIMIGUNDLA,0,0,0,0,0,0,0,0,0,0
ANDHRA PRADESH,KURNOOL,INSTITUTIONAL,4.0-5.0,52,UYYALAWADA,0,0,0,0,0,0,0,0,0,0
ANDHRA PRADESH,KURNOOL,INSTITUTIONAL,4.0-5.0,53,CHAGALAMARRI,0,0,0,0,0,0,0,0,0,0
ANDHRA PRADESH,KURNOOL,INSTITUTIONAL,4.0-5.0,54,CHAGALAMARRI,0,0,0,0,0,0,0,0,0,0
ANDHRA PRADESH,KURNOOL,SCHEDULED CASTE,4.0-5.0,1,MANTRALAYAM,15,65,36,29,65,0,0,0,0,0
ANDHRA PRADESH,KURNOOL,SCHEDULED CASTE,4.0-5.0,2,KOSIGI,3,13,7,7,14,0,0,0,0,0
ANDHRA PRADESH,KURNOOL,SCHEDULED CASTE,4.0-5.0,3,KOWTHALAM,27,119,119,0,119,0,0,0,0,0
ANDHRA PRADESH,KURNOOL,SCHEDULED CASTE,4.0-5.0,4,PEDDA KADUBUR,19,84,68,16,84,0,0,0,0,0
ANDHRA PRADESH,KURNOOL,SCHEDULED CASTE,4.0-5.0,5,YEMMIGANUR,10,44,44,0,44,0,0,0,0,0
ANDHRA PRADESH,KURNOOL,SCHEDULED CASTE,4.0-5.0,6,NANDAVARAM,19,85,82,0,82,1,1,0,2,1
ANDHRA PRADESH,KURNOOL,SCHEDULED CASTE,4.0-5.0,7,C.BELAGAL,6,27,27,0,27,0,0,0,0,0
ANDHRA PRADESH,KURNOOL,SCHEDULED CASTE,4.0-5.0,8,GUDUR,10,44,22,22,44,0,0,0,0,0
ANDHRA PRADESH,KURNOOL,SCHEDULED CASTE,4.0-5.0,9,KALLUR,27,121,121,0,121,0,0,0,0,0
ANDHRA PRADESH,KURNOOL,SCHEDULED CASTE,4.0-5.0,10,KURNOOL,33,153,153,0,153,0,0,0,0,0
ANDHRA PRADESH,KURNOOL,SCHEDULED CASTE,4.0-5.0,11,NANDIKOTKUR,6,27,13,13,26,0,0,0,0,0
ANDHRA PRADESH,KURNOOL,SCHEDULED CASTE,4.0-5.0,12,PAGIDYALA,28,120,71,47,118,0,2,0,2,0
ANDHRA PRADESH,KURNOOL,SCHEDULED CASTE,4.0-5.0,13,JUPADU BUNGALOW,6,26,26,0,26,0,0,0,0,0
ANDHRA PRADESH,KURNOOL,SCHEDULED CASTE,4.0-5.0,14,KOTHAPALLE,24,106,91,15,106,0,0,0,0,0
ANDHRA PRADESH,KURNOOL,SCHEDULED CASTE,4.0-5.0,15,ATMAKUR,10,43,22,22,44,0,0,0,0,0
ANDHRA PRADESH,KURNOOL,SCHEDULED CASTE,4.0-5.0,16,PAMULAPADU,45,204,204,0,204,0,0,0,0,0
ANDHRA PRADESH,KURNOOL,SCHEDULED CASTE,4.0-5.0,17,MIDTHUR,67,304,291,13,304,0,0,0,0,0
ANDHRA PRADESH,KURNOOL,SCHEDULED CASTE,4.0-5.0,18,ORVAKAL,8,34,17,17,34,0,0,0,0,0
ANDHRA PRADESH,KURNOOL,SCHEDULED CASTE,4.0-5.0,19,KODUMUR,7,30,30,0,30,0,0,0,0,0
ANDHRA PRADESH,KURNOOL,SCHEDULED CASTE,4.0-5.0,20,GONEGANDLA,63,268,191,77,268,0,0,0,0,0
ANDHRA PRADESH,KURNOOL,SCHEDULED CASTE,4.0-5.0,21,ADONI,27,121,121,0,121,0,0,0,0,0
ANDHRA PRADESH,KURNOOL,SCHEDULED CASTE,4.0-5.0,22,HOLAGUNDA,10,42,14,28,42,0,0,0,0,0
ANDHRA PRADESH,KURNOOL,SCHEDULED CASTE,4.0-5.0,23,HALAHARVI,39,178,89,89,178,0,0,0,0,0
ANDHRA PRADESH,KURNOOL,SCHEDULED CASTE,4.0-5.0,24,ALUR,74,328,302,19,321,0,8,0,8,0
ANDHRA PRADESH,KURNOOL,SCHEDULED CASTE,4.0-5.0,25,ASPARI,54,242,59,184,243,0,0,0,0,0
ANDHRA PRADESH,KURNOOL,SCHEDULED CASTE,4.0-5.0,26,DEVANAKONDA,43,193,191,2,193,0,0,0,0,0
ANDHRA PRADESH,KURNOOL,SCHEDULED CASTE,4.0-5.0,27,KRISHNAGIRI,33,148,148,0,148,0,0,0,0,0
ANDHRA PRADESH,KURNOOL,SCHEDULED CASTE,4.0-5.0,28,VELDURTHI,22,101,50,50,100,0,0,0,0,0
ANDHRA PRADESH,KURNOOL,SCHEDULED CASTE,4.0-5.0,29,BETHAMCHERLA,6,28,28,0,28,0,0,0,0,0
ANDHRA PRADESH,KURNOOL,SCHEDULED CASTE,4.0-5.0,30,PANYAM,4,17,9,9,18,0,0,0,0,0
ANDHRA PRADESH,KURNOOL,SCHEDULED CASTE,4.0-5.0,31,GADIVEMULA,12,54,27,27,54,0,0,0,0,0
ANDHRA PRADESH,KURNOOL,SCHEDULED CASTE,4.0-5.0,32,VELGODE,53,237,237,0,237,0,0,0,0,0
ANDHRA PRADESH,KURNOOL,SCHEDULED CASTE,4.0-5.0,33,BANDI ATMAKUR,10,46,23,23,46,0,0,0,0,0
ANDHRA PRADESH,KURNOOL,SCHEDULED CASTE,4.0-5.0,34,NANDYAL,10,44,44,0,44,0,0,0,0,0
ANDHRA PRADESH,KURNOOL,SCHEDULED CASTE,4.0-5.0,35,MAHANANDI,13,59,50,3,53,0,0,2,2,4
ANDHRA PRADESH,KURNOOL,SCHEDULED CASTE,4.0-5.0,36,SIRVEL,17,76,38,38,76,0,0,0,0,0
ANDHRA PRADESH,KURNOOL,SCHEDULED CASTE,4.0-5.0,37,GOSPADU,1,4,2,2,4,0,0,0,0,0
ANDHRA PRADESH,KURNOOL,SCHEDULED CASTE,4.0-5.0,38,BANAGANAPALLE,7,31,16,16,32,0,0,0,0,0
ANDHRA PRADESH,KURNOOL,SCHEDULED CASTE,4.0-5.0,39,DHONE,27,123,123,0,123,0,0,0,0,0
ANDHRA PRADESH,KURNOOL,SCHEDULED CASTE,4.0-5.0,40,PATTIKONDA,31,136,69,67,136,0,0,0,0,0
ANDHRA PRADESH,KURNOOL,SCHEDULED CASTE,4.0-5.0,41,CHIPPAGIRI,37,169,169,0,169,0,0,0,0,0
ANDHRA PRADESH,KURNOOL,SCHEDULED CASTE,4.0-5.0,42,MADDIKERA (EAST),6,26,26,0,26,0,0,0,0,0
ANDHRA PRADESH,KURNOOL,SCHEDULED CASTE,4.0-5.0,43,TUGGALI,62,278,278,0,278,0,0,0,0,0
ANDHRA PRADESH,KURNOOL,SCHEDULED CASTE,4.0-5.0,44,PEAPALLY,7,31,15,16,31,0,0,0,0,0
ANDHRA PRADESH,KURNOOL,SCHEDULED CASTE,4.0-5.0,45,OWK,15,66,66,0,66,0,0,0,0,0
ANDHRA PRADESH,KURNOOL,SCHEDULED CASTE,4.0-5.0,46,KOILKUNTLA,9,40,40,0,40,0,0,0,0,0
ANDHRA PRADESH,KURNOOL,SCHEDULED CASTE,4.0-5.0,47,RUDRAVARAM,15,67,67,0,67,0,0,0,0,0
ANDHRA PRADESH,KURNOOL,SCHEDULED CASTE,4.0-5.0,48,ALLAGADDA,4,17,0,17,17,0,0,0,0,0
ANDHRA PRADESH,KURNOOL,SCHEDULED CASTE,4.0-5.0,49,DORNIPADU,8,36,18,18,36,0,0,0,0,0
ANDHRA PRADESH,KURNOOL,SCHEDULED CASTE,4.0-5.0,50,SANJAMALA,9,40,40,0,40,0,0,0,0,0
ANDHRA PRADESH,KURNOOL,SCHEDULED CASTE,4.0-5.0,51,KOLIMIGUNDLA,15,67,67,0,67,0,0,0,0,0
ANDHRA PRADESH,KURNOOL,SCHEDULED CASTE,4.0-5.0,52,UYYALAWADA,10,45,23,23,46,0,0,0,0,0
ANDHRA PRADESH,KURNOOL,SCHEDULED CASTE,4.0-5.0,53,CHAGALAMARRI,12,54,54,0,54,0,0,0,0,0
ANDHRA PRADESH,KURNOOL,SCHEDULED CASTE,4.0-5.0,54,CHAGALAMARRI,12,54,54,0,54,0,0,0,0,0
ANDHRA PRADESH,KURNOOL,OTHERS,4.0-5.0,1,MANTRALAYAM,182,801,507,294,801,0,0,0,0,0
ANDHRA PRADESH,KURNOOL,OTHERS,4.0-5.0,2,KOSIGI,164,726,573,153,726,0,0,0,0,0
ANDHRA PRADESH,KURNOOL,OTHERS,4.0-5.0,3,KOWTHALAM,451,2011,2011,0,2011,0,0,0,0,0
ANDHRA PRADESH,KURNOOL,OTHERS,4.0-5.0,4,PEDDA KADUBUR,221,984,865,119,984,0,0,0,0,0
ANDHRA PRADESH,KURNOOL,OTHERS,4.0-5.0,5,YEMMIGANUR,362,1610,1524,6,1530,0,51,0,51,29
ANDHRA PRADESH,KURNOOL,OTHERS,4.0-5.0,6,NANDAVARAM,398,1767,1715,21,1736,6,14,0,20,11
ANDHRA PRADESH,KURNOOL,OTHERS,4.0-5.0,7,C.BELAGAL,143,625,615,10,625,0,0,0,0,0
ANDHRA PRADESH,KURNOOL,OTHERS,4.0-5.0,8,GUDUR,201,893,793,100,893,0,0,0,0,0
ANDHRA PRADESH,KURNOOL,OTHERS,4.0-5.0,9,KALLUR,360,1610,1569,42,1611,0,0,0,0,0
ANDHRA PRADESH,KURNOOL,OTHERS,4.0-5.0,10,KURNOOL,399,1792,1782,11,1793,0,0,0,0,0
ANDHRA PRADESH,KURNOOL,OTHERS,4.0-5.0,11,NANDIKOTKUR,188,831,659,164,823,1,3,0,4,3
ANDHRA PRADESH,KURNOOL,OTHERS,4.0-5.0,12,PAGIDYALA,172,749,657,89,746,0,1,0,1,1
ANDHRA PRADESH,KURNOOL,OTHERS,4.0-5.0,13,JUPADU BUNGALOW,181,801,556,241,797,0,2,0,2,1
ANDHRA PRADESH,KURNOOL,OTHERS,4.0-5.0,14,KOTHAPALLE,131,580,468,112,580,0,0,0,0,0
ANDHRA PRADESH,KURNOOL,OTHERS,4.0-5.0,15,ATMAKUR,111,489,489,0,489,0,0,0,0,0
ANDHRA PRADESH,KURNOOL,OTHERS,4.0-5.0,16,PAMULAPADU,298,1363,1249,114,1363,0,0,0,0,0
ANDHRA PRADESH,KURNOOL,OTHERS,4.0-5.0,17,MIDTHUR,583,2622,2611,11,2622,0,0,0,0,0
ANDHRA PRADESH,KURNOOL,OTHERS,4.0-5.0,18,ORVAKAL,349,1550,1225,325,1550,0,0,0,0,0
ANDHRA PRADESH,KURNOOL,OTHERS,4.0-5.0,19,KODUMUR,279,1243,1229,14,1243,0,0,0,0,0
ANDHRA PRADESH,KURNOOL,OTHERS,4.0-5.0,20,GONEGANDLA,362,1616,1458,159,1617,0,0,0,0,0
ANDHRA PRADESH,KURNOOL,OTHERS,4.0-5.0,21,ADONI,674,3018,2974,44,3018,0,0,0,0,0
ANDHRA PRADESH,KURNOOL,OTHERS,4.0-5.0,22,HOLAGUNDA,491,2173,1196,961,2157,0,10,0,10,6
ANDHRA PRADESH,KURNOOL,OTHERS,4.0-5.0,23,HALAHARVI,534,2405,2405,0,2405,0,0,0,0,0
ANDHRA PRADESH,KURNOOL,OTHERS,4.0-5.0,24,ALUR,726,3218,2789,345,3134,0,54,0,54,30
ANDHRA PRADESH,KURNOOL,OTHERS,4.0-5.0,25,ASPARI,1081,4670,3366,1304,4670,0,0,0,0,0
ANDHRA PRADESH,KURNOOL,OTHERS,4.0-5.0,26,DEVANAKONDA,561,2480,2384,96,2480,0,0,0,0,0
ANDHRA PRADESH,KURNOOL,OTHERS,4.0-5.0,27,KRISHNAGIRI,581,2595,2307,288,2595,0,0,0,0,0
ANDHRA PRADESH,KURNOOL,OTHERS,4.0-5.0,28,VELDURTHI,302,1348,903,442,1345,1,0,0,1,1
ANDHRA PRADESH,KURNOOL,OTHERS,4.0-5.0,29,BETHAMCHERLA,197,879,746,132,878,0,0,0,0,0
ANDHRA PRADESH,KURNOOL,OTHERS,4.0-5.0,30,PANYAM,279,1240,851,383,1234,0,3,0,3,2
ANDHRA PRADESH,KURNOOL,OTHERS,4.0-5.0,31,GADIVEMULA,205,914,914,0,914,0,0,0,0,0
ANDHRA PRADESH,KURNOOL,OTHERS,4.0-5.0,32,VELGODE,302,1367,1362,5,1367,0,0,0,0,0
ANDHRA PRADESH,KURNOOL,OTHERS,4.0-5.0,33,BANDI ATMAKUR,257,1145,1064,73,1137,2,1,2,5,3
ANDHRA PRADESH,KURNOOL,OTHERS,4.0-5.0,34,NANDYAL,229,1014,1009,6,1015,0,0,0,0,0
ANDHRA PRADESH,KURNOOL,OTHERS,4.0-5.0,35,MAHANANDI,112,504,476,2,478,2,5,11,18,7
ANDHRA PRADESH,KURNOOL,OTHERS,4.0-5.0,36,SIRVEL,315,1405,703,702,1405,0,0,0,0,0
ANDHRA PRADESH,KURNOOL,OTHERS,4.0-5.0,37,GOSPADU,219,981,981,0,981,0,0,0,0,0
ANDHRA PRADESH,KURNOOL,OTHERS,4.0-5.0,38,BANAGANAPALLE,459,2034,1669,365,2034,0,0,0,0,0
ANDHRA PRADESH,KURNOOL,OTHERS,4.0-5.0,39,DHONE,546,2464,2431,33,2464,0,0,0,0,0
ANDHRA PRADESH,KURNOOL,OTHERS,4.0-5.0,40,PATTIKONDA,457,2025,1638,387,2025,0,0,0,0,0
ANDHRA PRADESH,KURNOOL,OTHERS,4.0-5.0,41,CHIPPAGIRI,729,3263,3262,1,3263,0,0,0,0,0
ANDHRA PRADESH,KURNOOL,OTHERS,4.0-5.0,42,MADDIKERA (EAST),452,2006,2004,2,2006,0,0,0,0,0
ANDHRA PRADESH,KURNOOL,OTHERS,4.0-5.0,43,TUGGALI,620,2754,2528,227,2755,0,0,0,0,0
ANDHRA PRADESH,KURNOOL,OTHERS,4.0-5.0,44,PEAPALLY,334,1495,1316,179,1495,0,0,0,0,0
ANDHRA PRADESH,KURNOOL,OTHERS,4.0-5.0,45,OWK,357,1594,1594,0,1594,0,0,0,0,0
ANDHRA PRADESH,KURNOOL,OTHERS,4.0-5.0,46,KOILKUNTLA,342,1520,1520,0,1520,0,0,0,0,0
ANDHRA PRADESH,KURNOOL,OTHERS,4.0-5.0,47,RUDRAVARAM,301,1338,1167,171,1338,0,0,0,0,0
ANDHRA PRADESH,KURNOOL,OTHERS,4.0-5.0,48,ALLAGADDA,179,793,356,437,793,0,0,0,0,0
ANDHRA PRADESH,KURNOOL,OTHERS,4.0-5.0,49,DORNIPADU,230,1021,510,510,1020,0,0,0,0,0
ANDHRA PRADESH,KURNOOL,OTHERS,4.0-5.0,50,SANJAMALA,456,2051,2051,0,2051,0,0,0,0,0
ANDHRA PRADESH,KURNOOL,OTHERS,4.0-5.0,51,KOLIMIGUNDLA,270,1197,1197,0,1197,0,0,0,0,0
ANDHRA PRADESH,KURNOOL,OTHERS,4.0-5.0,52,UYYALAWADA,363,1615,1615,0,1615,0,0,0,0,0
ANDHRA PRADESH,KURNOOL,OTHERS,4.0-5.0,53,CHAGALAMARRI,134,589,464,125,589,0,0,0,0,0
ANDHRA PRADESH,KURNOOL,OTHERS,4.0-5.0,54,CHAGALAMARRI,134,589,464,125,589,0,0,0,0,0
ANDHRA PRADESH,KURNOOL,SCHEDULED TRIBES,4.0-5.0,1,MANTRALAYAM,1,5,2,2,4,0,0,0,0,0
ANDHRA PRADESH,KURNOOL,SCHEDULED TRIBES,4.0-5.0,2,KOSIGI,1,4,2,2,4,0,0,0,0,0
ANDHRA PRADESH,KURNOOL,SCHEDULED TRIBES,4.0-5.0,3,KOWTHALAM,7,31,15,15,30,0,0,0,0,0
ANDHRA PRADESH,KURNOOL,SCHEDULED TRIBES,4.0-5.0,4,PEDDA KADUBUR,1,4,2,2,4,0,0,0,0,0
ANDHRA PRADESH,KURNOOL,SCHEDULED TRIBES,4.0-5.0,5,YEMMIGANUR,0,0,0,0,0,0,0,0,0,0
ANDHRA PRADESH,KURNOOL,SCHEDULED TRIBES,4.0-5.0,6,NANDAVARAM,0,0,0,0,0,0,0,0,0,0
ANDHRA PRADESH,KURNOOL,SCHEDULED TRIBES,4.0-5.0,7,C.BELAGAL,0,0,0,0,0,0,0,0,0,0
ANDHRA PRADESH,KURNOOL,SCHEDULED TRIBES,4.0-5.0,8,GUDUR,0,0,0,0,0,0,0,0,0,0
ANDHRA PRADESH,KURNOOL,SCHEDULED TRIBES,4.0-5.0,9,KALLUR,9,39,39,0,39,0,0,0,0,0
ANDHRA PRADESH,KURNOOL,SCHEDULED TRIBES,4.0-5.0,10,KURNOOL,11,49,0,49,49,0,0,0,0,0
ANDHRA PRADESH,KURNOOL,SCHEDULED TRIBES,4.0-5.0,11,NANDIKOTKUR,0,0,0,0,0,0,0,0,0,0
ANDHRA PRADESH,KURNOOL,SCHEDULED TRIBES,4.0-5.0,12,PAGIDYALA,0,0,0,0,0,0,0,0,0,0
ANDHRA PRADESH,KURNOOL,SCHEDULED TRIBES,4.0-5.0,13,JUPADU BUNGALOW,0,0,0,0,0,0,0,0,0,0
ANDHRA PRADESH,KURNOOL,SCHEDULED TRIBES,4.0-5.0,14,KOTHAPALLE,4,18,9,9,18,0,0,0,0,0
ANDHRA PRADESH,KURNOOL,SCHEDULED TRIBES,4.0-5.0,15,ATMAKUR,3,13,7,7,14,0,0,0,0,0
ANDHRA PRADESH,KURNOOL,SCHEDULED TRIBES,4.0-5.0,16,PAMULAPADU,5,22,11,11,22,0,0,0,0,0
ANDHRA PRADESH,KURNOOL,SCHEDULED TRIBES,4.0-5.0,17,MIDTHUR,0,0,0,0,0,0,0,0,0,0
ANDHRA PRADESH,KURNOOL,SCHEDULED TRIBES,4.0-5.0,18,ORVAKAL,7,30,15,15,30,0,0,0,0,0
ANDHRA PRADESH,KURNOOL,SCHEDULED TRIBES,4.0-5.0,19,KODUMUR,0,0,0,0,0,0,0,0,0,0
ANDHRA PRADESH,KURNOOL,SCHEDULED TRIBES,4.0-5.0,20,GONEGANDLA,20,84,42,42,84,0,0,0,0,0
ANDHRA PRADESH,KURNOOL,SCHEDULED TRIBES,4.0-5.0,21,ADONI,0,0,0,0,0,0,0,0,0,0
ANDHRA PRADESH,KURNOOL,SCHEDULED TRIBES,4.0-5.0,22,HOLAGUNDA,4,18,7,11,18,0,0,0,0,0
ANDHRA PRADESH,KURNOOL,SCHEDULED TRIBES,4.0-5.0,23,HALAHARVI,0,0,0,0,0,0,0,0,0,0
ANDHRA PRADESH,KURNOOL,SCHEDULED TRIBES,4.0-5.0,24,ALUR,11,50,50,0,50,0,0,0,0,0
ANDHRA PRADESH,KURNOOL,SCHEDULED TRIBES,4.0-5.0,25,ASPARI,1,4,2,2,4,0,0,0,0,0
ANDHRA PRADESH,KURNOOL,SCHEDULED TRIBES,4.0-5.0,26,DEVANAKONDA,1,4,2,2,4,0,0,0,0,0
ANDHRA PRADESH,KURNOOL,SCHEDULED TRIBES,4.0-5.0,27,KRISHNAGIRI,9,39,39,0,39,0,0,0,0,0
ANDHRA PRADESH,KURNOOL,SCHEDULED TRIBES,4.0-5.0,28,VELDURTHI,0,0,0,0,0,0,0,0,0,0
ANDHRA PRADESH,KURNOOL,SCHEDULED TRIBES,4.0-5.0,29,BETHAMCHERLA,2,8,6,2,8,0,0,0,0,0
ANDHRA PRADESH,KURNOOL,SCHEDULED TRIBES,4.0-5.0,30,PANYAM,1,4,2,2,4,0,0,0,0,0
ANDHRA PRADESH,KURNOOL,SCHEDULED TRIBES,4.0-5.0,31,GADIVEMULA,10,44,40,4,44,0,0,0,0,0
ANDHRA PRADESH,KURNOOL,SCHEDULED TRIBES,4.0-5.0,32,VELGODE,1,5,2,2,4,0,0,0,0,0
ANDHRA PRADESH,KURNOOL,SCHEDULED TRIBES,4.0-5.0,33,BANDI ATMAKUR,2,9,6,3,9,0,0,0,0,0
ANDHRA PRADESH,KURNOOL,SCHEDULED TRIBES,4.0-5.0,34,NANDYAL,0,0,0,0,0,0,0,0,0,0
ANDHRA PRADESH,KURNOOL,SCHEDULED TRIBES,4.0-5.0,35,MAHANANDI,1,5,2,2,4,0,0,0,0,0
ANDHRA PRADESH,KURNOOL,SCHEDULED TRIBES,4.0-5.0,36,SIRVEL,3,14,7,7,14,0,0,0,0,0
ANDHRA PRADESH,KURNOOL,SCHEDULED TRIBES,4.0-5.0,37,GOSPADU,0,0,0,0,0,0,0,0,0,0
ANDHRA PRADESH,KURNOOL,SCHEDULED TRIBES,4.0-5.0,38,BANAGANAPALLE,13,57,29,29,58,0,0,0,0,0
ANDHRA PRADESH,KURNOOL,SCHEDULED TRIBES,4.0-5.0,39,DHONE,25,110,110,0,110,0,0,0,0,0
ANDHRA PRADESH,KURNOOL,SCHEDULED TRIBES,4.0-5.0,40,PATTIKONDA,63,281,140,140,280,0,0,0,0,0
ANDHRA PRADESH,KURNOOL,SCHEDULED TRIBES,4.0-5.0,41,CHIPPAGIRI,2,9,9,0,9,0,0,0,0,0
ANDHRA PRADESH,KURNOOL,SCHEDULED TRIBES,4.0-5.0,42,MADDIKERA (EAST),2,9,5,5,10,0,0,0,0,0
ANDHRA PRADESH,KURNOOL,SCHEDULED TRIBES,4.0-5.0,43,TUGGALI,44,197,170,27,197,0,0,0,0,0
ANDHRA PRADESH,KURNOOL,SCHEDULED TRIBES,4.0-5.0,44,PEAPALLY,4,18,9,9,18,0,0,0,0,0
ANDHRA PRADESH,KURNOOL,SCHEDULED TRIBES,4.0-5.0,45,OWK,9,40,20,20,40,0,0,0,0,0
ANDHRA PRADESH,KURNOOL,SCHEDULED TRIBES,4.0-5.0,46,KOILKUNTLA,2,9,4,4,8,0,0,0,0,0
ANDHRA PRADESH,KURNOOL,SCHEDULED TRIBES,4.0-5.0,47,RUDRAVARAM,4,17,17,0,17,0,0,0,0,0
ANDHRA PRADESH,KURNOOL,SCHEDULED TRIBES,4.0-5.0,48,ALLAGADDA,0,0,0,0,0,0,0,0,0,0
ANDHRA PRADESH,KURNOOL,SCHEDULED TRIBES,4.0-5.0,49,DORNIPADU,0,0,0,0,0,0,0,0,0,0
ANDHRA PRADESH,KURNOOL,SCHEDULED TRIBES,4.0-5.0,50,SANJAMALA,0,0,0,0,0,0,0,0,0,0
ANDHRA PRADESH,KURNOOL,SCHEDULED TRIBES,4.0-5.0,51,KOLIMIGUNDLA,1,5,2,2,4,0,0,0,0,0
ANDHRA PRADESH,KURNOOL,SCHEDULED TRIBES,4.0-5.0,52,UYYALAWADA,0,0,0,0,0,0,0,0,0,0
ANDHRA PRADESH,KURNOOL,SCHEDULED TRIBES,4.0-5.0,53,CHAGALAMARRI,5,22,22,0,22,0,0,0,0,0
ANDHRA PRADESH,KURNOOL,SCHEDULED TRIBES,4.0-5.0,54,CHAGALAMARRI,5,22,22,0,22,0,0,0,0,0
ANDHRA PRADESH,KURNOOL,ALL SOCIAL GROUPS,4.0-5.0,1,MANTRALAYAM,198,871,546,325,871,0,0,0,0,0
ANDHRA PRADESH,KURNOOL,ALL SOCIAL GROUPS,4.0-5.0,2,KOSIGI,168,744,582,162,744,0,0,0,0,0
ANDHRA PRADESH,KURNOOL,ALL SOCIAL GROUPS,4.0-5.0,3,KOWTHALAM,485,2161,2145,15,2160,0,0,0,0,0
ANDHRA PRADESH,KURNOOL,ALL SOCIAL GROUPS,4.0-5.0,4,PEDDA KADUBUR,241,1071,935,137,1072,0,0,0,0,0
ANDHRA PRADESH,KURNOOL,ALL SOCIAL GROUPS,4.0-5.0,5,YEMMIGANUR,373,1658,1570,8,1578,0,51,0,51,29
ANDHRA PRADESH,KURNOOL,ALL SOCIAL GROUPS,4.0-5.0,6,NANDAVARAM,417,1853,1797,21,1818,7,15,0,22,13
ANDHRA PRADESH,KURNOOL,ALL SOCIAL GROUPS,4.0-5.0,7,C.BELAGAL,149,652,642,10,652,0,0,0,0,0
ANDHRA PRADESH,KURNOOL,ALL SOCIAL GROUPS,4.0-5.0,8,GUDUR,211,937,815,122,937,0,0,0,0,0
ANDHRA PRADESH,KURNOOL,ALL SOCIAL GROUPS,4.0-5.0,9,KALLUR,396,1770,1729,42,1771,0,0,0,0,0
ANDHRA PRADESH,KURNOOL,ALL SOCIAL GROUPS,4.0-5.0,10,KURNOOL,443,1994,1934,59,1993,0,0,0,0,0
ANDHRA PRADESH,KURNOOL,ALL SOCIAL GROUPS,4.0-5.0,11,NANDIKOTKUR,197,872,680,185,865,1,3,0,4,3
ANDHRA PRADESH,KURNOOL,ALL SOCIAL GROUPS,4.0-5.0,12,PAGIDYALA,200,869,729,136,865,0,3,0,3,1
ANDHRA PRADESH,KURNOOL,ALL SOCIAL GROUPS,4.0-5.0,13,JUPADU BUNGALOW,187,827,583,241,824,0,2,0,2,1
ANDHRA PRADESH,KURNOOL,ALL SOCIAL GROUPS,4.0-5.0,14,KOTHAPALLE,159,704,569,135,704,0,0,0,0,0
ANDHRA PRADESH,KURNOOL,ALL SOCIAL GROUPS,4.0-5.0,15,ATMAKUR,124,546,518,28,546,0,0,0,0,0
ANDHRA PRADESH,KURNOOL,ALL SOCIAL GROUPS,4.0-5.0,16,PAMULAPADU,348,1590,1465,125,1590,0,0,0,0,0
ANDHRA PRADESH,KURNOOL,ALL SOCIAL GROUPS,4.0-5.0,17,MIDTHUR,650,2926,2902,25,2927,0,0,0,0,0
ANDHRA PRADESH,KURNOOL,ALL SOCIAL GROUPS,4.0-5.0,18,ORVAKAL,364,1614,1257,357,1614,0,0,0,0,0
ANDHRA PRADESH,KURNOOL,ALL SOCIAL GROUPS,4.0-5.0,19,KODUMUR,286,1273,1259,14,1273,0,0,0,0,0
ANDHRA PRADESH,KURNOOL,ALL SOCIAL GROUPS,4.0-5.0,20,GONEGANDLA,445,1969,1691,278,1969,0,0,0,0,0
ANDHRA PRADESH,KURNOOL,ALL SOCIAL GROUPS,4.0-5.0,21,ADONI,701,3139,3095,44,3139,0,0,0,0,0
ANDHRA PRADESH,KURNOOL,ALL SOCIAL GROUPS,4.0-5.0,22,HOLAGUNDA,505,2233,1217,1000,2217,0,10,0,10,6
ANDHRA PRADESH,KURNOOL,ALL SOCIAL GROUPS,4.0-5.0,23,HALAHARVI,573,2583,2494,89,2583,0,0,0,0,0
ANDHRA PRADESH,KURNOOL,ALL SOCIAL GROUPS,4.0-5.0,24,ALUR,811,3596,3141,364,3505,0,61,0,61,30
ANDHRA PRADESH,KURNOOL,ALL SOCIAL GROUPS,4.0-5.0,25,ASPARI,1136,4916,3427,1490,4917,0,0,0,0,0
ANDHRA PRADESH,KURNOOL,ALL SOCIAL GROUPS,4.0-5.0,26,DEVANAKONDA,605,2678,2577,100,2677,0,0,0,0,0
ANDHRA PRADESH,KURNOOL,ALL SOCIAL GROUPS,4.0-5.0,27,KRISHNAGIRI,623,2782,2493,288,2781,0,0,0,0,0
ANDHRA PRADESH,KURNOOL,ALL SOCIAL GROUPS,4.0-5.0,28,VELDURTHI,324,1448,954,493,1447,1,0,0,1,1
ANDHRA PRADESH,KURNOOL,ALL SOCIAL GROUPS,4.0-5.0,29,BETHAMCHERLA,205,915,781,134,915,0,0,0,0,0
ANDHRA PRADESH,KURNOOL,ALL SOCIAL GROUPS,4.0-5.0,30,PANYAM,286,1270,866,398,1264,0,3,0,3,2
ANDHRA PRADESH,KURNOOL,ALL SOCIAL GROUPS,4.0-5.0,31,GADIVEMULA,227,1012,980,31,1011,0,0,0,0,0
ANDHRA PRADESH,KURNOOL,ALL SOCIAL GROUPS,4.0-5.0,32,VELGODE,356,1609,1602,7,1609,0,0,0,0,0
ANDHRA PRADESH,KURNOOL,ALL SOCIAL GROUPS,4.0-5.0,33,BANDI ATMAKUR,269,1200,1092,99,1191,2,1,2,5,3
ANDHRA PRADESH,KURNOOL,ALL SOCIAL GROUPS,4.0-5.0,34,NANDYAL,239,1058,1053,6,1059,0,0,0,0,0
ANDHRA PRADESH,KURNOOL,ALL SOCIAL GROUPS,4.0-5.0,35,MAHANANDI,126,568,529,8,537,2,5,14,21,11
ANDHRA PRADESH,KURNOOL,ALL SOCIAL GROUPS,4.0-5.0,36,SIRVEL,335,1495,748,747,1495,0,0,0,0,0
ANDHRA PRADESH,KURNOOL,ALL SOCIAL GROUPS,4.0-5.0,37,GOSPADU,220,985,983,2,985,0,0,0,0,0
ANDHRA PRADESH,KURNOOL,ALL SOCIAL GROUPS,4.0-5.0,38,BANAGANAPALLE,479,2122,1714,409,2123,0,0,0,0,0
ANDHRA PRADESH,KURNOOL,ALL SOCIAL GROUPS,4.0-5.0,39,DHONE,598,2697,2664,33,2697,0,0,0,0,0
ANDHRA PRADESH,KURNOOL,ALL SOCIAL GROUPS,4.0-5.0,40,PATTIKONDA,551,2442,1847,595,2442,0,0,0,0,0
ANDHRA PRADESH,KURNOOL,ALL SOCIAL GROUPS,4.0-5.0,41,CHIPPAGIRI,768,3442,3440,1,3441,0,0,0,0,0
ANDHRA PRADESH,KURNOOL,ALL SOCIAL GROUPS,4.0-5.0,42,MADDIKERA (EAST),460,2042,2035,6,2041,0,0,0,0,0
ANDHRA PRADESH,KURNOOL,ALL SOCIAL GROUPS,4.0-5.0,43,TUGGALI,726,3229,2976,253,3229,0,0,0,0,0
ANDHRA PRADESH,KURNOOL,ALL SOCIAL GROUPS,4.0-5.0,44,PEAPALLY,345,1544,1341,203,1544,0,0,0,0,0
ANDHRA PRADESH,KURNOOL,ALL SOCIAL GROUPS,4.0-5.0,45,OWK,381,1701,1680,20,1700,0,0,0,0,0
ANDHRA PRADESH,KURNOOL,ALL SOCIAL GROUPS,4.0-5.0,46,KOILKUNTLA,353,1568,1564,4,1568,0,0,0,0,0
ANDHRA PRADESH,KURNOOL,ALL SOCIAL GROUPS,4.0-5.0,47,RUDRAVARAM,320,1422,1251,171,1422,0,0,0,0,0
ANDHRA PRADESH,KURNOOL,ALL SOCIAL GROUPS,4.0-5.0,48,ALLAGADDA,183,810,356,454,810,0,0,0,0,0
ANDHRA PRADESH,KURNOOL,ALL SOCIAL GROUPS,4.0-5.0,49,DORNIPADU,238,1057,528,528,1056,0,0,0,0,0
ANDHRA PRADESH,KURNOOL,ALL SOCIAL GROUPS,4.0-5.0,50,SANJAMALA,465,2091,2091,0,2091,0,0,0,0,0
ANDHRA PRADESH,KURNOOL,ALL SOCIAL GROUPS,4.0-5.0,51,KOLIMIGUNDLA,286,1269,1267,2,1269,0,0,0,0,0
ANDHRA PRADESH,KURNOOL,ALL SOCIAL GROUPS,4.0-5.0,52,UYYALAWADA,373,1660,1637,23,1660,0,0,0,0,0
ANDHRA PRADESH,KURNOOL,ALL SOCIAL GROUPS,4.0-5.0,53,CHAGALAMARRI,151,664,539,125,664,0,0,0,0,0
ANDHRA PRADESH,KURNOOL,ALL SOCIAL GROUPS,4.0-5.0,54,CHAGALAMARRI,151,664,539,125,664,0,0,0,0,0
